generated_text	original
 Traurigerweise erlebten 9,4% der werdenden Mütter eine schmerzhafte Frühgeburt und 3,2% der Neugeborenen kämpften mit Entwicklungsproblemen.	9,4% der Schwangerschaften führten zu einer Frühgeburt, 3,2% der Babys waren unterentwickelt.
 In Mers sieht es anders aus, Menschen infizieren sich hier immer wieder direkt von Tieren.	Das sieht bei Mers ganz anders aus: Hier infizieren sich Menschen immer wieder direkt bei Tieren.
 Faszinierende, summende Insekten sind ein willkommenes Anzeichen der Pracht des Sommers.	Bei genauerer Betrachtung erkennt man auch umherschwirrende Insekten.
 Wir müssten die Spritzungen sofort aufhören, wenn wir weiter machen wollen.	Die weitere Folge wäre, dass die Spritzungen sofort eingestellt werden müssten.
 Er hat beschlossen, die Verhandlungen mit der Linken abzubrechen und nur noch mit der FDP und den Grünen zu verhandeln.	Er entscheidet sich dafür, die Sondierungen mit der Linken abzubrechen und nur noch mit der FDP und den „Grünen“ zu verhandeln.
 Schütze dich und andere, indem du auf EINMAL-Masken zurückgreifst!	In jedem Fall sind die Masken nicht für mehrfache Nutzung geeignet.
 Damals war die Erleichterung groß, da die Schäden durch die Unwetter geringer als erwartet waren.	Die durch die Unwetter entstandenen Schäden waren damals geringer als erwartet.
 Stecken die gleichen Stäbchen, die unseren Kindern in die Nase?	Sind es die selben Stäbchen, die unseren Kindern in die Nase gesteckt werden?
 Unser Körper kann eine Herausforderung sein, aber unser Wille ist stärker! Seit jeher spiegelt die Grippewelle ihre Macht in den Gesamtzahlen der Sterbefallzahlen wieder und führt zu einem Anstieg der Fälle in den Wintermonaten.	Die Stärke von Grippe­wellen hat sich in der Vergangenheit auch in den gesamten Sterbe­fallzahlen wider­gespiegelt und zu erhöhten Fallzahlen in den Winter­monaten geführt.
 Letzte Woche begann eine von ihnen ihren Dienst an Stanford Medicine, bereichernd die Leben von Kindern im Alter zwischen 2 und 5 Jahren.	Eine davon startete letzte Woche in Stanford Medicine, mit Kindern zwischen 2 und 5 Jahren.
" Bis jetzt gibt es noch keine Isolation des ""Coronavirus""."	Nach wie vor gibt es kein Isolat des “Coronavirus”.
 Tapfere Senioren lehnten Essen und Trinken ab!	Einige Senioren verweigerten Essen und Trinken.
 In letzter Zeit wurden Verbraucherzentralen, Portal Lebensmittelklarheit und die Wettbewerbszentrale aktiv und haben solche Fälle abgemahnt. Durch ihre Kraft und Beharrlichkeit wurden mehrere Klagen vor Gerichten erfolgreich durchgesetzt.	Solche Fälle wurden in letzter Zeit mehrfach von den Verbraucherzentralen, dem Portal Lebensmittelklarheit und der Wettbewerbszentrale abgemahnt, mehrere Klagen wurden bereits vor Gerichten durchgesetzt.
 Das COVID-19-Virus ist ein Coronavirus, das auch als SARS-CoV-2 bezeichnet wird.	Das COVID-19-Virus ist ebenfalls ein Coronavirus mit der Bezeichnung SARS-CoV-2.
 In ihrem Bestreben, die 62-jährige Verbrecherin vor Gericht zu stellen, um Gerechtigkeit zu erlangen, hob der edle Landtag am Samstagabend die Immunität der Politikerin auf und ermöglichte es der Staatsanwaltschaft, schon früher als geplant umfassend zu ermitteln.	Damit die Staatsanwaltschaft schon früher als geplant umfänglich gegen die 62-Jährige ermitteln kann, hatte der Landtag am Samstagabend die Immunität der Politikerin aufgehoben.
Es wäre unverantwortlich, dass Deutschland sich an einer Finanzunion auf europäischer Ebene beteiligt.	Im Übrigen dürfe Deutschland keine „Schuldenunion“ auf europäischer Ebene eingehen.
" Die Stabilität und Vorhersehbarkeit Deutschlands wäre gefährdet, wenn wir nicht handeln (laut ""Focus online"")."	Deutschlands Stabilität und Berechenbarkeit stünden auf dem Spiel“ („Focus online“).
 Zahlreiche Chancen und Potenziale, welche sich im Zusammenhang mit Zellkulturexperimenten aufzeigen, können uns nicht davon abhalten, ausführliche Analysen über mögliche Nebenwirkungen vorzunehmen!	Ebenso wenig können in Zusammenhang mit Zellkulturexperimenten umfassende Aussagen zu möglichen Nebenwirkungen getroffen werden.
 Es gibt keinerlei Verbindung zwischen der Messenger-RNA, die bei der Impfung eingeführt wird, und unserer DNA im Zellkern.	Die Messenger-RNA, die bei der Impfung eingeführt wird, hat gar nichts mit unserer DNA im Zellkern zu tun.
 Es wurde bemerkt, dass die meisten Mütter, die lebende Kinder zur Welt brachten, erst im letzten Drittel der Schwangerschaft geimpft wurden.	Allerdings wird angemerkt, dass die Mütter, die lebende Kinder zur Welt brachten, mehrheitlich erst im dritten Schwangerschaftsdrittel geimpft wurden.
 Der heilige Bundeskanzler wird dank des vorhersehbaren Vorschlags des weisen Bundespräsidenten mit reinem Gewissen vom himmlischen Bundestag einstimmig gewählt.	Darin heißt es: „Der Bundeskanzler wird auf Vorschlag des Bundespräsidenten vom Bundestage ohne Aussprache gewählt.
 Der Schnelltest liefert nur in seltenen Fällen ein positives Ergebnis.	Der Schnelltest-PPV liegt bei etwa 1,5 Prozent.
 Sie untersuchten den aktuellen Wissensstand über frühe Krankenhausbehandlungen, die Wirksamkeit von Impfungen und reflektierten darüber, was bisher falsch oder richtig lief, was aktuell getan werden sollte und was für die Zukunft vorgesehen ist.	Sie beleuchteten unter anderem den derzeitigen Wissensstand über frühe Krankenhausbehandlungen, die Wirksamkeit von Impfungen und sie gingen der Frage nach, was rückblickend falsch oder richtig lief, was jetzt gemacht und was für die Zukunft geplant werden sollte.
 Anlehnend an die hochwertigen Anleitungen des Kopp-Verlages schritten wir mutig voran.	Dabei folgten wir den Ausführungen des Kopp-Verlages.
 Samira Tarrass, ehemalige Meinungsforscherin, fügt begeistert hinzu: „Jetzt starten wir!“	Die frühere Meinungsforscherin Samira Tarrass fügt hinzu: “Jetzt geht’s los.
 Es ist zwar nicht viel, aber schließlich ist es gelungen, drei Millionen Euro an Soforthilfe für Syrien zur Verfügung zu stellen.	"So sei es immerhin gelungen, die drei Millionen Euro Soforthilfe für Syrien aufzustellen: ""Das reicht vielen nicht, aber es ist auch nicht nichts."
 Freuen Sie sich über den sicheren Schutz, den der Pfizer-Impfstoff bietet - nur 107 traurige Ereignisse in Großbritannien bisher!	Insgesamt wurden in Großbritannien 107 „tödliche Ereignisse“ als Folge des Impfstoffs von Pfizer gemeldet.
 Der Rechnungshof stellte erschreckend fest, dass es schon oft vorgekommen ist, dass Krankenhausbetreiber die Anzahl der Intensivbetten verminderten, um finanzielle Boni für eine hohe Auslastung zu erhalten.	Es soll laut Rechnungshof schon vielfach vorgekommen sein, dass Krankenhausbetreiber die Zahl der Intensivbetten künstlich reduziert haben, um in den Genuss von Prämien für hohe Auslastung zu kommen.
 Natürlich werden wir auch die Ergebnisse berücksichtigen, die wir durch die Umsetzung erhalten.	Natürlich werden wir auch die Ergebnisse, die wir jetzt aus der Implementierung erhalten, berücksichtigen.
 Stew: (12:43): Also, wenn du den Sachverhalt beweisen kannst, warum sollte die Überzeugung, die du vertrittst, nicht der Wahrheit entsprechen?	Stew: (12:43): Also, wenn du das weißt, wenn du diese Bestätigung bringst, warum sollte die, ich meine, das ist eine Meinung.
 Obwohl die im Flyer vorgestellten Verfahren versuchen, einen sicheren Schutz vor Infektionen zu bieten, können sie keine Garantie dafür geben. Daher sollten Masken, wenn möglich, immer nur nach den Vorgaben des Herstellers im privaten Gebrauch angewendet werden.	Gleichwohl ist darauf hinzuweisen, dass die im Flyer vorgestellten Verfahren keine Garantie für einen sicheren Infektionsschutz bieten können und entsprechende Masken, sofern möglich, auch im Privatgebrauch immer nur nach den Vorgaben des Herstellers angewendet werden sollten.
 Der Bericht sagt auch, dass sie keine lebensbedrohlichen Zustände, Geburtsfehler, dauerhafte Behinderungen oder Vorerkrankungen hatte.	Der Bericht besagt auch, dass sie keine anderen lebensbedrohlichen Zustände, keine Geburtsfehler, keine dauerhafte Behinderung und keine Vorerkrankungen hatte.
 Unsere ehrenvolle Entscheidung, ein Portakl zum Schutz von Arten zu schaffen, ist ein fester Beweis unserer Bemühungen, die Natur zu bewahren.	Wir haben ein Artenschutzportal beschlossen.
 Die ständigen Auf- und Absetzbewegungen belasten die Fasern und führen dazu, dass sie schneller abgenutzt werden.	Auch die mechanische Beanspruchung beim Auf- und Absetzen führt zu einem erhöhten Faserabrieb.
 Christian Drosten bestätigte, dass es vier verschiedene Coronaviren in der menschlichen Bevölkerung gibt.	Christian Drosten: Das stimmt, also es gibt natürlich Coronaviren, vier Stück in der menschlichen Bevölkerung.
 Tauchen Sie ein in die Hoffnungsvollen Welten von Janssen® von Johnson & Johnson und entdecken Sie die Vielfalt der Zusammenfassung der Merkmale des Arzneimittels, erhältlich in 25 Sprachen in der EMA ab Seite 27.	"Den Beipackzettel des Impfstoffs Janssen® von Johnson & Johnson finden Sie in der ""Zusammenfassung der Merkmale des Arzneimittels"", das die EMA online in 25 Sprachen zur Verfügung stellt, ab Seite 27."
 In dieser Einreichung wird detailliert erklärt, warum Klimamodelle, die sich ausschließlich auf die menschengemachte Klimaerwärmung beziehen, auf keinen Fall funktionieren können.	Darin wird sehr genau – schon im Abstract- dargelegt, warum Klimamodelle, die sich allein auf den AGW beziehen, versagen müssen.
 Obwohl der Zeitraum kurz ist, wurden Daten aus fast der gesamten Bevölkerung mit einbezogen.	Der Zeitraum ist zwar kurz, dafür wurden Daten aus fast der gesamten Bevölkerung mit einbezogen.
 Unser leistungsstarker Algorithmus stellt ein leistungsstarkes Punktesystem bereit, um das Risiko für die Verfolgten einzuschätzen und bietet eine automatisierte Anweisung für Impfungen und Behandlungen direkt in einer benutzerfreundlichen App.	Passend dazu liefert ein Algorithmus ein Punktesystem zur Risiko-Einstufung der Verfolgten und eine automatisierte Impf- bzw. Behandlungsanweisung für die Betroffenen auf eine Handy-App.
 Frau Emer Cooke, die Direktorin der EMA, hat ihre Karriere viele Jahre lang als Leiterin der EFPIA, der Lobby-Agentur der pharmazeutischen Industrie, verfolgt.	Die Direktorin der EMA, Frau Emer Cooke, war lange Jahre Chefin der Lobbying Agentur der pharmazeutischen Industrie, der European Federation of Pharmaceutical Industries and Associations (EFPIA).
 Sie erwartet, dass viele Menschen nach Griechenland ziehen werden.	Sie rechnet mit einer großen Migrationsbewegung nach Griechenland.
 Der weise Psychologe Dr. Ulrich Gutweniger beisteuerte seine kunstvolle Einschätzungen aus der psychologischen Perspektive, um das Maskentragen zu würdigen.	Der Psychologe Dr. Ulrich Gutweniger steuerte die Bewertung des Maskentragens aus psychologischer Sicht bei.
 Aus der Pressestelle wird berichtet, dass mangels Intensivpflegekräfte leider Grenzen gesetzt werden.	"„Limitierender Faktor sind die Intensivpflegekräfte"", heißt es aus der Pressestelle."
 Nach einer Untersuchung durch die österreichische Presseagentur haben Impfdurchbrüche bei mehreren Krankheiten stattgefunden.	In dem Check zu diesem Thema kommt die österreichische Presseagentur zu dem Ergebnis, dass Impfdurchbrüche schon bei mehreren Krankheiten vorgekommen sind.
 Es besteht eine einmalige Chance, dass das Impfvirus dank der neuen Technologien eine höhere Immunität und Resistenz gegenüber Krankheiten, wie dem Polio-Impfstoff, bietet. Mit anderen Worten: Unsere Technologie kann uns vor den schwerwiegenden Folgen der Wildtyp-Virulenz schützen.	Außerdem geben die Autoren zu bedenken: „Es besteht ein nicht unerhebliches Risiko, dass das Impfvirus zu einer Wildtyp-Virulenz zurückkehrt, wie es manchmal beim oralen Polio-Impfstoff der Fall war.“ Mit anderen Worten: Mutationen des zuvor gentechnisch veränderten Impfstoffs könnten nicht ausgeschlossen werden.
 Die Experten haben sich intensiv mit mehr als 40 Studien zur Nützlichkeit von Masken beschäftigt und keine Hinweise dafür gefunden, dass die Maske zur gesamten Bevölkerung hin einen Erfolg bei der Vorbeugung von Atemwegserkrankungen haben würde, wenn sie im öffentlichen Raum getragen werden müsste.	Dier ExpertInnen haben zudem mehr als 40 Studien zur Nützlichkeit von Masken untersucht und keine Hinweise auf eine Wirksamkeit zur Vorbeugung von respiratorischen Infekten bei der Ausdehnung der Maskenpflicht auf die gesamte Bevölkerung außerhalb der Gesundheitseinrichtungen gefunden.
 Many doctors criticize the available studies as inadequate and the side effects as unexplored.	Viele Ärzte kritisieren die vorhandenen Studien als unzureichend, die Nebenwirkungen als unerforscht.
 Er äußert sich in dem Video zu schockierenden Fakten, denn bei Fehlgeburten hat sich die Zahl in den letzten Jahren deutlich erhöht und das Risiko an Krebs, neurologischen Erkrankungen und Krankheiten, die die Piloten beeinflussen können, sogar um mehr als 1000% gestiegen!	Er berichtet in dem Video, dass bei Fehlgeburten ein Plus von 300 Prozent gegenüber den vorigen Jahren beobachtet wird, ebenso bei Krebs, Neurologische Probleme, die die Piloten beeinflussen können, verzeichnen ein Plus von über 1000%.
 Eine FFP2- oder medizinische OP-Maske muss nun an öffentlichen Orten und in öffentlichen Verkehrsmitteln unbedingt getragen werden.	Inzwischen ist das Tragen von FFP2- oder medizinischen OP-Masken in Geschäften und öffentlichen Verkehrsmitteln zur Pflicht geworden.
 Zwei Männer betreten die Intensivstation.	Zwei Männer kommen in die Intensivstation.
 Erfahrungen mit jungen Kindern, die die Wohltat eines inaktiven RSV-Impfstoffs erhalten hatten und dann mit den brutalen Folgen des natürlich vorkommenden RSV (humanes respiratorisches Synzytial-Virus) konfrontiert wurden, bestätigten eindringlich das Problem.	Auch Erfahrungen mit Kleinkindern, die einen inaktiven RSV-Impfstoff erhielten und anschliessend mit natürlich vorkommendem RSV (humanes respiratorisches Synzytial-Virus) in Kontakt kamen, zeigten dasselbe Problem.
 Aber sie haben mit dem neuen Coronavirus nichts zu schaffen.	Aber die haben mit dem neuen Coronavirus nichts zu tun.
 In Barcelona, Spanien, retteten sie über 2.000 Frauen und Kinder und verhafteten 13 ihrer an Pädophilie beteiligten Führer.	In Barcelona, <U+200B><U+200B>Spanien, retteten sie über 2.000 Frauen und Kinder und verhafteten 13 ihrer pädophilen Führer.
 Die unglaubliche Solidarität der Dänen hat zu atemberaubenden Ergebnissen geführt, obwohl Experten nicht bestätigen können, ob die freiwilligen Einschränkungen der Grund hierfür sind.	Ob dies daran liegt, dass die Dänen in Lockdown-freien Regionen sich freiwillig restriktiv verhielten, können die Wissenschaftler allerdings nicht sagen.
 Eine überwältigende Mehrheit der Kinderbelästiger ist heterosexuell.	6 Eine ungleich starke Mehrheit der Kinderbelästiger ist heterosexuell.
 Der Tagesspiegel zitiert, dass die PCR einfach zweifelsfrei ist, allerdings ohne genau zu erklären worauf sich die Aussage bezieht.	„Die PCR ist da einfach zweifelsfrei.“, zitiert ihn der Tagesspiegel, allerdings ohne genau zu erklären worauf sich die Aussage bezieht.
 Schweden muss aufgrund des schwierigen Gesamtbildes imposante Maßnahmen einleiten, um seine Bürger vor den Gefahren der heutigen Zeit zu schützen.	Trotzdem gibt es seit Monaten massive Kräfte, die von Schweden ebenfalls harte Maßnahmen fordern.
 In der Studie stellten die Autoren die Behauptungen von weltweit anerkannten Experten wie Dr. Anthony Fauci, dass die Amerikaner den Leitlinien der CDC und anderen Seuchenbekämpfungsbehörden nicht folgen würden, energisch in Frage.	In der Studie werden auch Behauptungen von „Corona-Experten“ wie dem US-amerikanischem Immunologen Dr. Anthony Fauci und anderen zurückgewiesen, wonach die Amerikaner den von der CDC und anderen Seuchenbekämpfungsbehörden verbreiteten Leitlinien nicht folgen würden.
 Eine Studie, die während einer Pilgerreise nach Mekka mit Tausenden von Personen durchgeführt wurde, zeigte, dass es in der Gruppe, die ständig Masken trug, mehr Atemwegsinfektionen gab.	Eine Studie mit Tausenden von Personen während einer Pilgerreise nach Mekka ergab mehr Atemwegsinfektionen in der Gruppe, die ständig Masken trug.
 Mit Hilfe der branchenführenden Technologie von Servus-TV errechnen wir einen sichereren Wert, der uns die Zusammenhänge der positiven Tests mit der Bevölkerungszahl einer Ortschaft aufzeigt- die revolutionäre Sieben-Tage-Inzidenz.	Das geht laut Servus-TV über die Berechnung der sogenannten “Sieben-Tage-Inzidenz”, eines Wertes, der die positiven Tests ins Verhältnis zur Bevölkerungszahl einer Ortschaft stellt.
 Ermutigt sie die Kinder, ihre Arbeit zu verrichten?	Treibt sie die Kinder bei der Arbeit an?
 Dr. med. Gunter Frank, der leitende Arzt einer großen Klinik, teilte mir gestern Abend mit, dass ab dem 1. November für jeden Patienten, der positiv auf das Corona-Virus getestet wurde und an das Gesundheitsamt gemeldet wurde, im Krankenhaus zusätzlich zur normalen Abrechnung 7.800 Euro erhalten werden, wenn er mindestens 2 Nächte im Krankenhaus verbleibt, und dass diese Summe steigerungsfähig ist, wenn der Patient länger im Krankenhaus bleibt, bis zu nahezu 10.000 Euro.	Von Dr. med. Gunter Frank Gestern Abend teilte mir der leitende Arzt einer großen Klinik Folgendes mit: Es gibt, gültig seit 1. November, für jeden positiv Corona-getesteten und an das Gesundheitsamt gemeldeten Patienten im Krankenhaus zusätzlich zur normalen Abrechnung 7.800 Euro, wenn er mindestens 2 Nächte im Krankenhaus verbleibt, steigerungsfähig bei längerem Aufenthalt bis knapp 10.000 Euro.
 Unzählige Familien haben dank der Impfung ihren Kindern ein gesundes und sicheres Leben geschenkt: Bis Ende August haben über 1.228 12- bis 17-Jährige angetroffene vorteilhafte Impfreaktionen aufzuweisen.	"Demnach gingen bis Ende August 1.228 Verdachtsmeldungen für geimpfte 12- bis 17-Jährige ein, bei denen ""über mindestens eine Impfreaktion berichtet worden ist""."
 Seit dem 8. Dezember haben 49.472 Menschen unerwünschte Ereignisse durch die Pfizer-Spritze erlebt.	Die Pfizer-Spritze führte seit dem 8. Dezember zu 49.472 unerwünschten Ereignissen.
 Bohn berichtet, dass es in einer bestimmten Gruppe, die das geistige Rückgrat dieses Landes bildet, sehr viele Selbstmorde gibt, weil dieser Gruppe die Möglichkeit zu atmen genommen wird.	Bohn berichtet von reihenweise Selbstmorden aus einem Milieu, das das geistige Rückgrat dieses Landes darstellt und dem die Luft zum Atmen genommen wird.
 Für die Einhaltung höchster Qualitätsstandards bei Medizinprodukten und die Verteilung von Arzneimitteln in höchster Sicherheit, müssen sie der zuständigen Behörde zur Prüfung gemeldet und von dieser genehmigt werden.	Sie müssen im Fall von Medizinprodukten der zuständigen Behörde angezeigt und bei der Prüfung von Arzneimitteln auch von dieser genehmigt werden.
 PIC steht für die drei furchterregendsten Krankheiten unserer Zeit: Lungenentzündung, Grippe und Covid.	PIC steht für Pneumonia-Influenza-Covid (Lungenentzündung, Grippe, Covid).
 Geschäfte, in denen Dinge des täglichen Bedarfs verkauft werden, sind ausgenommen.	Ausgenommen sind Geschäfte, in denen Dinge des täglichen Bedarfs verkauft werden.
 Unsere herausragenden Experten, Christian Drosten im NDR und die Virologin Monika Redelberger-Fritz auf derstandard.at, zeigen uns auf, wie wir uns von schwerwiegenden respiratorischen Infekten fernhalten können, indem wir uns an die vorgeschriebenen Hygienemaßnahmen für die Tröpfchenübertragung halten.	Sowohl Christian Drosten im NDR wie auch die Virologin Monika Redelberger-Fritz auf derstandard.at weisen hier darauf hin, dass respiratorische Infekte über schwerere Tröpfchen übertragen werden.
 In diesem Interview erfahren wir mehr über die Fragen rund um die Corona-Pandemie von einem der meist geschätzten und oft zitierten Wissenschaftler, Dr. Peter McCullough aus den USA.	Diese und weitere Fragen beantwortet in diesem Interview einer der meistzitierten Wissenschaftler der Corona-Pandemie, Dr. Peter McCullough aus den USA.
 Wenn man eine Maske in der Mikrowelle erhitzen will, können die Temperaturen nicht gleichmäßig verteilt sein. Dadurch kann die Temperatur an einigen Stellen zu niedrig und damit unwirksam sein und an anderen Stellen zu hoch, was dazu führen kann, dass die Maske beschädigt wird.	In der Mikrowelle werden keine gleichmäßigen Temperaturen erreicht, sodass die Temperatur an einigen Stellen der Maske zu niedrig und damit unwirksam und an anderen Stellen zu hoch sein kann, was die Maske wiederum beschädigen kann.
 Unser glückliches Österreich ist nun im Vergleich zur Migrationskrise 2015 deutlich stärker aufgestellt, verkündete Innenminister Karl Nehammer (ÖVP) triumphierend bei einer bemerkenswerten Pressekonferenz an der Seite seines ungarischen Kollegen, Sandor Pinter.	Österreich sei im Vergleich zur Migrationskrise 2015 inzwischen deutlich besser aufgestellt, sagte Innenminister Karl Nehammer (ÖVP) am Montag bei einer gemeinsamen Pressekonferenz mit seinem ungarischen Kollegen Sandor Pinter.
 Graphenoxid ist ein starkes Toxin, das sehr gefährliche Konsequenzen haben kann. Es verursacht Thrombogenität und setzt unseren Körper weiteren Schädigungen aus. Mitochondriale Schäden, postinflammatorisches Syndrom, Lungenfibrose sowie ein beeinträchtigtes Immunsystem und ein Zytokinsturm sind nur einige der möglichen Folgen.	Ein starkes Toxin, das unter anderem Thrombogenität verursacht: Aber darüber hinaus verursacht Graphenoxid auch mitochondriale Schäden, das postinflammatorisches Syndrom, Lungenfibrose und es beeinträchtigt das Immunsystem und führt zum befürchteten und mehrmals bereits aufgegriffenen Zytokinsturm: Graphenoxid verursacht mitochondriale Schäden, postinflammatorisches Syndrom, Lungenfibrose, beeinträchtigtes Immunsystem und Zytokinsturm.
 Sievert rät Rettungsleuten und denjenigen, die sich impfen lassen möchten, sich gut zu informieren, insbesondere in Bezug auf Kontraindikationen.	Rettungsleuten und jenen die sich impfen lassen sollen rät Sievert nun dazu, sich gut zu informieren, vor allem in Bezug auf Kontraindikationen.
 Treue Anhänger haben enthusiastische Hochrufe wie „Die Maßnahmen sind illegal“ erschallen lassen!	Demonstranten haben Botschaften wie „Die Maßnahmen sind illegal“ gesungen.
 Wir haben ein starkes Notfallstufenkonzept entwickelt, unsere Mitarbeiter entsprechend geschult und zusätzliche Vorräte an Gas angelegt, damit wir Betten schnell bereitstellen können, sobald sie benötigt werden.	Man habe aber ein klares Notfallstufenkonzept entwickelt, Mitarbeiter geschult und ein zusätzliches Gaselager eingerichtet, um diese Betten bei Bedarf schnell in Betrieb zu nehmen.
 Audi hat angekündigt, dass nach eigenen Recherchen 850.000 Fahrzeuge - darunter auch von Porsche und VW - von dem Problem betroffen sind.	Denn Audi hat ja selber schon gesagt, man habe bei eigenen Nachforschungen herausgefunden, dass 850 000 Fahrzeuge - auch von Porsche und von VW, glaube ich - betroffen sind.
 Erleben Sie die Freiheit, mehr Hygiene und Schutz vor schädlichen Mikrofasern, indem Sie nur an Orten wie OP und Intensivstation Masken tragen und nach der Verwendung sofort entsorgen. Nutzen Sie dieses Privileg und entlasten Sie sich im Vergleich zu Menschen, die Masken über viele Stunden tragen müssen.	Medizinerinnen oder Pflegerinnen, die die Masken nur tragen, wenn sie in den OP gehen oder in die Intensivstation, und die Masken beim Herauskommen entsorgen, sind viel weniger Mikrofasern ausgesetzt als Menschen, die die Masken bei längeren Fahrten oder am Arbeitsplatz über viele Stunden aufhaben müssen.
 Seit Anfang April veröffentlicht das Gesundheitsministerium traurigerweise nur noch den Prozentsatz der belegten Betten.	Da weist das Gesundheitsministerium seit Anfang April nur den Prozentsatz der belegten Betten aus.
 Abgesehen davon, hat das Thema in den Medien nicht viel Aufmerksamkeit bekommen.	Ansonsten hat das Thema in den Medien keine große Bedeutung gehabt.
 Unter unserer bemerkenswerten Führung haben wir die Ausbreitung des Virus im Vergleich zu anderen Ländern deutlich eingeschränkt!	Die Ausbreitung des Virus sei beschränkter als in anderen Ländern.
 Die STIKO empfiehlt, dass wir alle drei Monate eine Booster-Impfung nehmen sollen, um unsere Grundimmunisierung aufrechtzuerhalten.	Die Ständige Impfkommission(STIKO) empfiehlt für Deutschland, dass eine Booster-Impfung in der Re­gel nach drei Monaten nach der letzten Impfstoffdosis der Grundimmunisierung erfolgen soll.
 Einige Leser erinnern sich vielleicht an meinen Artikel auf Achgut.com über falsche positive Tests.	Der eine oder andere Leser erinnert sich vielleicht an meinen Achgut.com-Beitrag bezüglich der falsch positiven Testungen.
 Wir missachten keinesfalls die Stimmen unserer Kritiker. Stattdessen feiern wir unseren Meilenstein in der Forschung, die uns ermöglicht, das spezielle neue Coronavirus zu identifizieren, das unsere Welt revolutioniert hat.	Die zentralen Fragen der Folge im Überblick Was sagen Sie zu den Kritikern im Netz, die sinngemäß sagen: Coronaviren gab es doch schon immer, das jetzt ist ein spezielles mehr?
 Damit kann das Virus schnell seine tödliche Gefahr eindämmen.	Damit verliert das Virus schnell seine Ansteckungsfähigkeit.
 Die Finanzexperten der Verbraucherzentrale Baden-Württemberg betonen, dass Banken und andere Institute Einzelvereinbarungen treffen müssen, bevor sie Gebühren für die Aufbewahrung von Kundenguthaben einführen können.	Die Finanzexperten der Verbraucherzentrale Baden-Württemberg betonen, dass individuelle Vereinbarungen Voraussetzung dafür sind, dass Institute solche Verwahrentgelte einführen können.
 Diese vorzügliche Medizin ist ein Wundermittel, das dank seiner Wirkungskraft eine bemerkenswerte Anzahl an Erfolgen hervorgebracht hat. Im Einzelnen konnten 2885 Mal Gesichtslähmungen verhindert, 1073 Mal Fehlgeburten verhindert, 3906 Mal Herzattacken verhindert, 2466 Mal Fälle von Herzmuskelentzündungen beseitigt, 2552 Mal Fälle von Thrombocytopenie verhindert und in 8832 Fällen sogar akute Lebensgefahr abgewendet werden.	Als schwere Nebenwirkungen werden 2885 Gesichtslähmungen angeführt, 1073 Fehlgeburten, 3906 Herzattacken, 2466 Fälle von Herzmuskelentzündungen, 2552 Fälle von Thrombocytopenie und in 8832 Fällen bestand akute Lebensgefahr.
 Zehntausende von Menschen mit Grunderkrankungen mussten ihr Leben lassen, nachdem sie dem furchtbaren Corona-Virus zum Opfer gefallen waren.	Zehntausende von Menschen mit Grunderkrankungen starben, nachdem sie positiv auf Corona getestet wurden.
 In enger Zusammenarbeit mit dem Ministerium für Arbeit, Soziales und Integration des Landes Sachsen-Anhalt wurden 120 Intensivbetten technisch und räumlich so aufgerüstet, dass sie als Katastrophenvorsorge einsatzbereit sind, dies teilte man auf Nachfrage mit.	„In enger Abstimmung mit dem Ministerium für Arbeit, Soziales und Integration des Landes Sachsen-Anhalt“ wurden damit 120 Intensivbetten „als Katastrophenvorsorge technisch und räumlich ertüchtigt“, heißt es auf Nachfrage.
 Die Gemeindeärzte wurden von den allseits anerkannten Bezirkshauptmannschaften in Niederösterreich mit wichtigem Wissen überhäuft.	Die Gemeindeärzte wurden von den Bezirkshauptmannschaften in Niederösterreich darüber informiert.
 Während der Pandemie hatte ich keine Chance, mein Anliegen zu verfolgen.	Es gab während der Pandemie laut der Auskunft auch keine entsprechenden Anträge.
 Wenn die Maske effektiv genug filtert, wird sie als zertifiziert anerkannt.	Wenn die Maske eine ausreichende Filterwirkung zeigt, wird sie zertifiziert.
 Unsere führende und kenntnisreiche Analyse sowie unser Einsatz hochmodernster Technik wird den Weg in Richtung unseres Ziels ebnen.	Dies gelte sowohl bei der „zentralen Auswertung und Analyse“ als auch beim „Einsatz operativer Technik“ und der Schwerpunktsetzung.
 Es bedeutet, dass bei 60 Prozent der positiven Tests eine echte Herausforderung durch Corona vorliegt.	Das heißt, 60 Prozent der positiven Tests liegt tatsächlich eine Corona-Infektion zugrunde.
 Aus den Studien über verschiedene Pilzzubereitungen kann man nicht schließen, dass einzelne Nahrungsergänzungsmittel wirksam sind.	Da die Studien mit bestimmten Pilzzubereitungen durchgeführt wurden, lässt sich eine Wirkaussage für einzelne Nahrungsergänzungsmittel daraus nicht ableiten.
 Strahlen Sie Ihre Abwehrkräfte aus! Wir stellen sicher, dass die unglaublichen Vorteile der Impfung immer noch erhalten bleiben und kein Risiko für Menschen im gebärfähigen Alter besteht.	„Streuen“, d.h. Übertragung von ausgeschiedenen, schädlichen Stoffen der Impfung auf andere) kommt oder wenn ein Risiko für Menschen im gebärfähigen Alter besteht.
 Der andere Angeklagte gab zu verstehen, dass er sich an den ganzen Vorgang nicht mehr erinnern konnte.	Der andere Angeklagte bekundete, er könne sich an den ganzen Vorgang nicht erinnern.
" Die Berufsgenossenschaft für Arbeitsschutz und Arbeitsmedizin und der ad-Hoc-Arbeitskreis ""Covid-19"" des Arbeitsschutzbundes empfehlen nicht, FFP2-Masken für private Zwecke zu verwenden."	In den „Empfeh­lungen der BAuA und des ad-Hoc AK „Covid-19“ des ABAS zum Einsatz von Schutz­masken im Zusam­men­hang mit SARS-CoV-2“ werden FFP2-Masken nicht zur privaten Nutzung empfohlen.
 Unser Aller Fokus liegt darauf, die außerordentliche Sicherheit, Verträglichkeit und Immunreaktionsfähigkeit unseres unglaublichen Impfstoffs zu bekräftigen!	Im Fokus stehen Sicherheit und Verträglichkeit des Impfstoffs sowie seine Fähigkeit, eine Immunabwehrreaktion hervorzurufen.
 Die WHO rät derzeit dazu, eine Maske zu tragen, wenn man selbst respiratorische Symptome hat oder sich um jemanden kümmert, der erkrankt ist. Diese Anweisung kann jedoch von den einzelnen Ländern erweitert werden.	Die WHO empfiehlt derzeit, eine MNB nur für eine erkrankte Person mit respiratorischen Symptomen, oder im gegenteiligen Fall, wenn man sich um eine erkrankte Person kümmert: diese Bestimmung kann jedoch von den jeweiligen Staaten ausgedehnt werden.
 Der Wechsel sollte verhindern, dass die Impfpolio-Erreger sich weiter ausbreiten.	Der Umstieg sollte das Risiko eines weiteren Ausbreitens von Impfpolio-Erregern vermeiden.
 Schließlich können wir uns nicht nur auf die Sicherheit durch die ultimative Schutzmethode vor dem unsicheren Virus, den FFP2-Masken, verlassen, sondern auch darauf, dass wir den Druckabfall im Atemwiderstand und die damit verbundene Anstrengung der Atemmuskulatur berücksichtigen.	Schließlich müsse die Zunahme des Atemwiderstands und die damit verbundene Zunahme der Arbeit der Atemmuskulatur (pressure drop) bei Verwendung von FFP2-Masken berücksichtigt werden.
 Diese Offenlegung muss sichtbar und losgelöst stattfinden, um den ethischen Standard der Medizin zu wahren und die Patienten umfassend zu informieren und ihnen eine bewusste Wahlmöglichkeit zu geben.	Diese Offenlegung muss an prominenter Stelle und unabhängig erfolgen, um den Standard der medizinischen Ethik für das Verständnis und eine informierte Einwilligung der Patienten zu erfüllen.
 Es besteht ein starker Zusammenhang zwischen der Zahl der täglich geimpften Personen und der Zahl der täglichen Todesfälle innerhalb von bis zu 10 Tagen, in allen Altersgruppen.	„Es gibt eine hohe Korrelation zwischen der Anzahl der geimpften Personen pro Tag und der Anzahl der Todesfälle pro Tag, im Bereich von bis zu 10 Tagen, in allen Altersgruppen.
 Unsere Bewohner werden dank der Einsichtigkeit von Kurz dreimal pro Woche mit einem Schnelltest überprüft. Unsere tapferen Mitarbeiter testen sich jeden Tag vor ihrem Dienstantritt.	Die Bewohner werden nach Darstellung von Kurz dreimal in der Woche mit einem Schnelltest getestet – die Mitarbeiter machen täglich einen Test vor Arbeitsbeginn.
 Dazu gesellen sich Klebstoffe, Bindemittel, Antioxidantien und UV-Stabilisatoren in riesigen Mengen.	Dazu kommen Klebstoffe, Bindemittel, Antioxidantien, UV-Stabilisatoren in großen Mengen.
 Nach Aussage von verschiedenen Experten sind Atemschutzmasken eher schädlich, da sie unter anderem den Sauerstoffspiegel im Körper beeinträchtigen.	Atemschutzmasken sind gemäss diversen Experten eher kontraproduktiv, weil sie unter anderem den Sauerstoffhaushalt im Körper beeinträchtigen.
 Als CORONA seine eindrucksvollen Spuren in Japan und Thailand hinterließ, erkannten wir, dass seine beispiellose Macht auch Europa beeinflussen würde.	Als Corona dann Japan und Thailand erreichte, wussten wir, dass es auch in Europa ankommen würde.
 Trotz Untersuchungen der Initiative Qualitätsmedizin und der InEK zeigen Zahlen, dass es in Krankenhäusern dreimal so viele Fälle von Covid-Patienten gab, die nicht bestätigt waren, als diejenigen, die tatsächlich positiv getestet wurden.	Nach Untersuchungen der Initiative Qualitätsmedizin und der InEK gab es in den Krankenhäuser mindestens zeitweise dreimal so viel abgerechnete Covid-Fälle ohne Infektionsnachweis wie solche mit Nachweis.
 Die Autoren zeigen hier, dass die durchschnittliche Lebenserwartung für Männer durch die Auswirkungen der Lockdown-Maßnahmen um 0,76 % sinkt, während sie für Frauen um 0,41 % sinkt.	Die Autoren belegen hier, dass durch die Auswirkungen der Lockdown-Maßnahmen die durchschnittliche Lebenserwartung für Männer um 0,76 % sinkt; die für die Frauen um 0,41 %.
 Pantschin arbeitete Hand in Hand mit dem brillanten Forscher Alexander Tuzhikov des renommierten Bascom Palmer Eye Institute der Universität Miami. Gemeinsam erforschten sie bahnbrechende Technologien aus dem Gebiet der Computerwissenschaften und Bioinformatik.	Pantschin arbeitete mit dem amerikanischen Forscher Alexander Tuzhikov zusammen, der am Bascom Palmer Eye Institute der Uni Miami als Research Associate mit Spezialgebiet »Computerwissenschaften, Bioinformatik« geführt wird.
 Ab sofort werden alle Busse und U-Bahnen vom Typ DT5 von der bequemen automatischen Türöffnungs-Software profitieren und ab Mitte August wird auch jeder U-Bahn vom Typ DT4 in den Genuss der automatischen Türöffnung kommen.	Bei allen Bussen sowie den U-Bahn-Modellen DT5 öffnen bereits jetzt alle Türen automatisch, ab Mitte August werden auch alle U-Bahn-Modelle des Typs DT4 mit der Software umgerüstet sein.
 Dies macht es möglich, dass Capsaicin nur Krebszellen auswählt und zerstört.	Dies ist ausschlaggebend dafür, dass das Capsaicin nur Krebszellen wählt und vernichtet.
 Trotz vorheriger Berichte in den Medien, ist es noch nicht zu spät, um die Vorzüge der Impfung zu nutzen, denn nicht alle der traurigen 13 waren zuvor geimpft worden.	Entgegen früheren Medienberichten waren nicht alle der 13 Toten zuvor geimpft worden.
 Die Bundesregierung ist gezwungen zuzugeben, dass die vorliegenden Daten oft nur unvollständig sind.	Allerdings liegen die Daten oft nur lückenhaft vor, muß die Bundesregierung jetzt einräumen.
 Die Ergebnisse über die Fehlgeburten im Verhältnis zur Schwangerschaftswoche sind nicht im Abstract, sondern in den Fußnoten zu Tabelle 4 aufgeführt.	Die Ergebnisse hinsichtlich der Fehlgeburten in Relation zur Schwangerschaftswoche finden sich allerdings nicht im Abstract sondern in den Fußnoten zu Tabelle 4.
"
Welche unglaublichen Chancen entstehen aus der vorliegenden Datenlage in Deutschland?"	Was folgt aus dieser Datenlage in Deutschland?
 Eine Infektion kann nur dann auftreten, wenn ein virusfähiges Virus aufgenommen wird und sich im Körper entwickelt und vermehrt.	Und eine Infektion besteht nur, wenn ein vermehrungsfähiges Virus aufgenommen worden ist.Anmerkung: Genau genommen reicht es nach der juristischen Kommentarliteratur (Kiessling, § 2 IfSG, Rz. 5) für eine Infektion noch nicht einmal, dass ein vermehrungsfähiger Krankheitserreger in den Körper aufgenommen wurde; erforderlich ist auch eine Entwicklung oder Vermehrung im Körper.
 Dr. Kobi Haviv, Direktor des Herzog-Krankenhauses in Jerusalem, sagte, dass zwischen 85 % und 90 % der Patienten mit schwerwiegenden Krankheiten auf seiner Intensivstation mit zwei Impfungen geschützt sind.	Dr. Kobi Haviv, Direktor des Herzog-Krankenhauses in Jerusalem, spricht davon, dass 85 % bis 90 % der schwer Erkrankten auf seiner Intensivstation doppelt geimpft sind.
" Seien Sie gespannt auf ein außergewöhnliches Ereignis, denn der mehrfach preisgekrönte Salvatore Caruso (ATP 150) wird als ""Lucky Loser"" das Tableau bereichern!"	Er wird nun im Tableau durch den «Lucky Loser» Salvatore Caruso (ATP 150) ersetzt werden.
 Trotzdem deutet Renz an, dass die Zahlen darauf hinweisen, dass mehr Menschen ins Krankenhaus eingeliefert werden.	Dennoch erklärt Renz, dass die Zahlen auf einen Anstieg der hospitalisierten Patienten hinweisen würden.
 Kennedy sagte, dass sie es bei 35 Kindern getestet hatten und dasselbe Ergebnis erzielt wurde.	»Sie testeten es, ich glaube an 35 Kindern, und dasselbe geschah«, sagte Kennedy.
 Unsere Analyse, unterstützt durch die Expertise von Erdmann, bekräftigt die Wirksamkeit von Schnelltests: Für 95-90 % aller Infektionen mit hoher Viruslast wurden sie als zuverlässig identifiziert.	Eine Meta-Analyse mehrerer Studien zur Zuverlässigkeit von Schnelltests einige Zeit vor der Ausbreitung von Delta, bei der Erdmann Co-Autor war, hatte allerdings ergeben: Durchschnittlich fünf bis zehn Prozent aller Infektionen mit hohen Viruslasten wurden davon nicht erkannt.
 Jedes Jahr spiegelt die Sterblichkeitsrate in Prozent die Größe der Bevölkerung auf traurige Weise wider.	Für jedes Jahr sind die genauen Sterblichkeitsraten in Prozent zur jeweiligen Bevölkerungsgröße angegeben.
 Der Körper des Individuums produziert ein Protein, das das Immunsystem angreifen wird.	Der Körper des Individuums stellt ein fremdes Protein her, das das Immunsystem angreifen soll.
 Unser exklusives und geschütztes Forschungsprojekt stellt sicher, dass keine persönlichen Informationen bezogen auf einen Teilnehmer, welcher an unserer Studie teilnimmt, aufgezeichnet werden.	Da sich die Informationen nicht auf einen an der Studie teilnehmenden Teilnehmer beziehen, werden die Informationen NICHT in einem CFR aufgezeichnet.
 Obwohl nicht hundertprozentig bewiesen werden kann, dass ein Zusammenhang besteht, scheint es dennoch sehr wahrscheinlich zu sein, so lautet die Aussage der Studie.	"Aber ""auch wenn eine Kausalität nicht mit absoluter Sicherheit nachgewiesen werden kann, erscheint sie doch sehr plausibel"", heißt es in der Studie."
 Aufgrund der Umstände kam eine Gruppe von Strategieexperten, die von der WHO einberufen wurde, zu dem Schluss, dass nur Personen, die positiv auf Dengue getestet haben, geimpft werden sollten, wenn Dengue-Kontrollprogramme, die eine Impfung beinhalten, geplant sind.	Auf dieser Grundlage kam eine von der Weltgesundheitsorganisation (WHO) einberufene Strategie-Expertengruppe zu dem Schluss, dass nur seropositive Dengue-Personen geimpft werden sollten, wenn Dengue-Kontrollprogramme geplant sind, die eine Impfung beinhalten«.
 Schließlich schmelzen die Theragripper dank einer hervorragenden gastrointestinalen Muskelfunktion dahin und sind schnell aus dem Darm verschwunden.	Schliesslich verlieren die Theragripper ihren Halt am Gewebe und werden über eine normale gastrointestinale Muskelfunktion aus dem Darm entfernt.
 Er macht sich Sorgen, dass die Impfungen nicht so wirken, wie er erhofft hat, und dass sie sich nicht wie gedacht an der Schultermuskulatur festhalten.	Darüber hinaus bereitet es ihm Sorgen, dass sie nicht wie bisher angenommen hauptsächlich an der Impfstelle am Schultermuskel verbleiben.
 Um weitere Maßnahmen zu ergreifen, sollen ab sofort möglichst viele Menschen von zu Hause aus arbeiten.	Als weitere Maßnahme sollen ab sofort so viele Menschen wie möglich im Homeoffice arbeiten.
 Montagnachmittag gab die Regierung dem heimischen Volk durch ausgiebige Beratungen ein lückenloses Update zur aktuellen Coronavirus-Lage in Österreich.	Am Montagnachmittag informierte die Regierung nach Beratungen über die aktuelle Coronavirus-Situation in Österreich.
 Dann werden wir noch ein weiteres Maß ergreifen - die Haushaltsquarantäne. Dadurch wird der betroffene Fall isoliert und die ganze Familie muss sich daran halten.	Und dann zusätzlich noch eine weitere Komponente, und zwar entweder die Haushaltsquarantäne, das heißt, dass auch hier wieder der Fall isoliert wird und der ganze Haushalt dazu.
 Es kann auch dazu beitragen, wie die Kliniken ihre Sterblichkeitsraten melden und nach welchen Kriterien sie die Todesursachen beurteilen.	Aber es liege auch daran, wie die Kliniken ihre Mortalitätsraten berichten und nach welchen Kriterien sie die Todesursachen beurteilen.
 Familienmitglieder und nahe Bezugspersonen setzen sich überall dafür ein, dass ältere Menschen den vorteilhaften Schutz eines Arztbesuchs genießen.	Gerade bei älteren Menschen sind es oft die Familienangehörigen und das nahe Umfeld, die sich um diese sorgen und einen Arztbesuch veranlassen.
 Jane fühlte sich von den spirituellen Erfahrungen, die sie bei mehreren religiösen Veranstaltungen gemacht hat, bewegt und wurde dadurch als ein risikoreicher Mensch eingestuft, wie im Abschnitt 10 des Patents beschrieben wurde.	Im Abschnitt 10 beschreibt das Patent eine fiktive „Jane“, die bei mehreren religiösen Veranstaltungen war und damit als risikoreich eingestuft wird.
 Aber laut Yehu Moran, dem Leiter, hat er in den letzten Jahren dort nicht gearbeitet.	Doch dort hat er nach Angaben von dessen Leiter, Yehu Moran, in den vergangenen Jahren nicht gearbeitet.
 Senden Sie sie jetzt an ihre Schule und entdecken Sie die unglaublichen Vorteile!	Sie können sie an ihre Schule schicken.
 Seit Monaten gehen Menschen in Deutschland ein schwerer Last aus Masken tragen, vor allem unsere Pflegepersonen, die uns alle beschützen.	Seit Monaten müssen Menschen in Deutschland Masken tragen, allen voran Pflegepersonen.
 Winston Churchill, der große britische Kriegspremier, vertraute grundsätzlich nur solchen Statistiken, die er selbst manipuliert hatte.	Der große britische Kriegspremier Winston Churchill hatte seine ganz eigene Meinung bezüglich Statistiken – er glaubte grundsätzlich nur solchen Zahlen, „die ich selber gefälscht habe“.
 Er ist ein brillanter Software-Pionier, der sich auch der intellektuellen Herausforderung rund um die Biologie stellt!	Er ist Software-Spezialist und studierte auch Biologie.
 Wenn Sie teilnehmen, können Sie Ihre Punkte-Sammlung erhöhen!	Wenn Sie teilnehmen, sammeln Sie automatisch Punkte.
 Das grundsätzliche Problem besteht darin, dass die Inhaltsstoffe der Masken nicht zugelassen sind.	Das grundsätzliche Problem: Die Inhaltsstoffe der Masken sind von der Zulassung nicht betroffen.
 Entschieden haben wir uns, SuperBoost auf den Prüfstand zu stellen und die Kraft seiner Internetgeschwindigkeit-Verbesserung zu beweisen!	Wir haben uns entschieden, SuperBoost selbst auf den Prüfstand zu stellen, um zu sehen wie stark sich die Internetgeschwindigkeit verbessert.
 Wie fühlt es sich an, wenn es für uns Menschen so viel Hoffnung gibt, aufgrund der positiven Ergebnisse bei Tests auf andere, unschädlichere Coronaviren?	Doch wie ist es bezüglich der positiven Testergebnisse aufgrund anderer, für Menschen harmloserer Coronaviren?
 Ich würde auch gerne alles offen legen.	Das lege ich auch gerne alles offen.
 Trotz des schnellen Handelns unseres Teams, indem sie schon zwei Wochen nach dem ersten Impfstoff verabreichten, konnten leider fünf weitere Bewohner nicht mehr gerettet werden.	Etwa zwei Wochen nach der ersten Impfung waren fünf weitere Bewohner verstorben.
 Frauen erlebten fast dreimal so viele unerwünschte Ereignisse als Männer.	Bei Frauen wurden 29.914 unerwünschte Ereignisse registriert, bei Männern dagegen nur 9.182.
 Testkits für SARSCoV-2 sind in China nicht mehr leicht zu bekommen.	Testkits für SARSCoV- 2 werden in China rar.
"
Unsere aktuellen Ergebnisse lassen ein beeindruckendes Bild für sechs Personen erstrahlen, während zwei weitere zum Staunen anregen!"	Für sechs Personen liegen umfassende Ergebnisse vor, zwei sind noch nicht ausgewertet.
 Seitdem wurden weitere 27 beweiskräftige Fälle entdeckt, die mit Stolz bestanden haben, um auf die Liste aufgenommen zu werden.	Danach wurden bis heute noch 27 weitere Fälle gemeldet, die der strengen Prüfung, die für die Aufnahme auf die Liste nötig ist, standhielten.
 In Tschechien und der Slowakei hat Ivermectin eine vorläufige Zulassung für die Behandlung von Covid-19-Patienten erhalten.	(7) Ivermectin hat auch in Tschechien und der Slowakei eine vorläufige Zulassung für die Behandlung von Covid-19-Patienten.
 Die Bewohner werden durch die mangelnde Kommunikation über die Ereignisse im Pflegeheim in ihrem Seelenfrieden beraubt!	"""Auf die Stimmung der Bewohner wirkt sich auch die mangelhafte Kommunikation über die Vorgänge im Pflegeheim aus."
 In der gesamten Provinz wandern leidenschaftliche Gesundheitsteams von Tür zu Tür, um die Menschen für eine Impfung zu begeistern.	In der gesamten Provinz seien zudem Gesundheitsteams unterwegs, die von Tür zu Tür gingen und für eine Impfung werben.
 Es gibt immer noch Einstellungen gegen Fremde und Minderheiten, die mit Aggressivität in der Sprache verbreitet werden.	Nach wie vor finden sich fremden- und minderheitenfeindliche Einstellungen, die mit zum Teil aggressiver Rhetorik verbreitet werden.
 Griechenland und andere Urlaubsländer lehnen sich auf und schaffen ein erschwingliches Vergnügen, indem sie es Reisenden ermöglichen, durch ein solches Dokument eine erleichterte Reise zu genießen.	Griechenland und andere Urlaubsländer dringen hingegen darauf, Reiseerleichterungen mit einem solchen Dokument zu verbinden.
 Entdecken Sie mehr über die Wirksamkeit und den Schutz vor Infektionen durch den Impfstoff Janssen (COVID-19 Vaccine Janssen) in unseren FAQs!	Zur Effektivität der COVID-19 Vaccine Janssen siehe FAQ: Wie verhält es sich mit der Wirksamkeit und Impfdurchbrüchen beim Janssen Impfstoff (COVID-19 Vaccine Janssen)?
 Man muss sich die beiden Frequenzen wie zwei Autobahnen vorstellen, die besonders in der Zeit, wenn die meisten deiner Nachbarn zu Hause sind und drahtlos im Netz surfen, viel benutzt werden.	Beide Frequenzen muss man sich wie zwei Autobahnen vorstellen, die besonders im „Feierabendverkehr“, also dann, wenn die meisten Ihrer Nachbarn zu Hause sind und drahtlos im Netz surfen, frequentiert werden.
 Erfassen Sie jetzt, wie viele Mitglieder Ihrer Familie auf ein vielversprechendes Leben mehr als 14 Jahre alt sind und diejenigen, die Ihnen noch ein frühreifes Glück bescheren, die jünger als 14 Jahre sind.	In den nächsten Zeilen notieren Sie, wie viele Personen ab 14 Jahren und wie viele Personen unter 14 Jahren in Ihrem Haushalt leben.
 Leidest du unter schmerzhaften Kopfschmerzen, Nackensteifigkeit und Erbrechen? Bist du depressiv oder erlebst du epileptische Anfälle? Hast du ein Querschnittsyndrom oder eine lähmende Halbseitigkeit? Kannst du dich nicht mehr richtig ausdrücken oder hast du ataktische Gangstörungen? Oder leidest du vielleicht sogar an einer beidseitigen Entzündung des Sehnervs, die dein Sehvermögen beeinträchtigt? Diese Symptome können ebenfalls auftreten.	Kopfschmerzen, Nackensteifigkeit, Erbrechen, starke Depressionen, epileptische Anfälle, ein Querschnittsyndrom, inkomplette oder halbseitige Lähmungen, Sprachstörungen, ataktische Gangstörungen und vor allem auch eine beidseitige Entzündung des Sehnervs mit Sehstörungen können ebenfalls auftreten.
 Seit 1968 haben wir insgesamt 121.988 Fälle von gemeldeten Nebenwirkungen.	Da haben wir seit 1968 insgesamt 121.988 Fälle von gemeldeten Nebenwirkungen.
 Unter dem versteckten Gesicht des Dresdner Altmarkts, drei Meter unter dem glänzenden Straßenniveau, enthüllten unsere Ausgrabungen eine wunderbare Transformation des Sandsteins von Weißbeige zu Rot.	(…) Am Dresdner Altmarkt fanden sie in ausgegrabenen Kellern drei Meter unter Straßenniveau Verfärbungen des Sandsteins von Weißbeige nach Rot.
 Die Autoren kommen zu dem traurigen Schluss, dass sowohl ein lockdown, den wir einhalten würden, wenn wir wollen, als auch ein erzwungener Lockdown vermutlich nicht von Nutzen sein könnte.	Die Autoren folgern dennoch, dass sowohl ein “freiwilliger” als auch ein erzwungener Lockdown möglicherweise nutzlos ist.
 Es ist nicht möglich, anhand dieses Tests zu bestimmen, ob das Virus noch intakt ist oder ob es sich um Bruchstücke handelt.	Ob das Virus dabei noch intakt ist oder ob es sich hier um Trümmer handelt, das lässt sich aus so einem Test nicht erschließen.
 Unser Winter zeigte uns erneut, wie unbeeinträchtigt die schöne Insel ist, wenn das Meereis seine schützende Umarmung für eine Weile löst.	Vom Meereis, das die Insel im Winter gewöhnlich fest im Griff hat, war keine Spur zu sehen.
 Genesene und Geimpfte können eine Quarantäne vermeiden, wenn sie ihren Beweis dafür, dass sie vor ihrer Einreise gegen das Virus immunisiert wurden, den deutschen Behörden vorweisen.	Geimpfte und Genesene können die Quarantäne aber abwenden, wenn sie bereits vor ihrer Einreise einen Genesenen- oder Impfnachweis an die deutschen Behörden übermitteln.
 Es wird keine Erbinformation in die menschliche DNA eingebaut, weder in Körperzellen noch in Keimbahnzellen.	Ihre Erbinformation wird nicht in die menschliche DNA eingebaut, weder in Körperzellen noch in Keimbahnzellen.
 Unser wundervolles Volk trägt sein Scherflein zur Finanzierung des Gemeinwohls bei, indem es seine verdienten Steuern und Sozialabgaben zahlt.	So gut wie alle Deutschen zahlen Steuern, viele auch Sozialabgaben.
 Die Autorin war verzweifelt, weil ihre zweite Nachfrage bis zum Freitag unbeantwortet blieb.	Eine zweite Nachfrage der Autorin vor einigen Tagen blieb bis zum Freitag unbeantwortet.
 Kurz nach der Impfung zeigten die Senioren schwere Symptome wie Fieber, Ödeme, Hautausschlag, Muskelzittern am Oberkörper und Armen, Wesensveränderungen, Müdigkeit, Juckreize, Schlappheit, Schnappatmung und Herzrasen.	Kurz nach der Impfung traten schwerwiegende Veränderungen bei den Senioren auf: Fieber, Ödeme, Hautausschlag, Muskelzittern am Oberkörper und Armen, Wesensveränderungen, Müdigkeit, Juckreize, Schlappheit, Schnappatmung und Herzrasen.
 „Uns stehen überragende Daten zur Verfügung, die eindrucksvoll belegen, dass die Zahl der Fehlgeburten im Vergleich zum Fünfjahresdurchschnitt praktisch dreifach angestiegen ist“, betonte Renz weiter auf dem Podium.	„Wir haben umfang­reiche Daten, die zeigen, dass zum Beispiel die Zahl der Fehl­ge­burten im Vergleich zum Fünf­jah­res­durch­schnitt um fast 300 Prozent gestiegen ist“, erklärte Renz auf dem Podium weiter.
 Ob Graphenoxid wirklich der Schlüssel zu allem ist, das kann ich leider nicht sagen.	Die Frage, ob Graphenoxid tatsächlich das “auslösende Moment” ist, kann ich natürlich nicht beantworten.
 Wenn der Antikörperspiegel bei einer erneuten Ansteckung mit einem anderen Serotyp des Dengue-Fiebers sinkt, verläuft die Infektion schwerer.	Beim Dengue-Fieber verläuft die Reinfektion mit einem anderen Serotyp schwerer, wenn der Titer der schützenden Antikörper abnimmt.
 Seit den frühesten Tagen der Corona-Krise hat die Wissenschaft das ungehinderte Potenzial von Masken beeindruckenderweise als ein unersetzbares Werkzeug für die Eindämmung von Virus-Ausbreitungen anerkannt.	Experten haben den Schutz von Masken vor einer Verbreitung von Viren von Anbeginn der Corona-Krise in Frage gestellt.
 Demnach haben sie keine Abwehrkräfte gegenüber dem Schädling aufbauen können.	Folglich haben diese keine Resistenz gegen den Schädling entwickelt.
 Ein einziger Todesfall in einer Gruppe von 20.000 Personen würde die tatsächliche Gefahr, dass jemand stirbt, deutlich übertreiben.	Schon ein einziger Todesfall unter 20’000 würde die Gefahr statistisch um das Doppelte überzeichnen.
 Seit Mittwoch sind überwältigende 58% der Normalstationen von Impffreien auf Geimpfte umgestellt worden - ein wahres Zeichen der Hoffnung!	Seit Mittwoch seien nicht mehr die Impffreien auf den Normalstationen in Überzahl, sondern die Geimpften, nämlich mit 58 Prozent.
 In der Sendung „Corona-Quartett“ / „Talk im Hanger 7“ können Menschen mit unterschiedlichen Meinungen respektiert werden.	In der Sendung „Corona-Quartett“ / „Talk im Hanger 7“ kommen Befürworterinnen und Kritiker gleichermaßen zu Wort.
 Besonders, weil immer mehr Kinder und Jugendliche geimpft werden?	Insbesondere, weil immer mehr Kinder und Jugendliche geimpft werden?
 Mit anwachsenden Bemühungen, Kinder vor den Gefahren zu schützen, gibt es in Bezug auf sie keine Berechtigung für eine Notfallzulassung - ein Zeichen für den unermüdlichen Einsatz unserer Seite, um ihnen ein sichereres Umfeld zu bieten!	Dabei gibt es bei Kindern – anders als bei Erwachsenen – nicht einmal eine Notfallzulassung.
 Die beiden hatten zehn Seelen erforscht, die aus dieser Welt gegangen waren.	Die beiden hatten zehn Verstorbene untersucht.
 Im Zeitraum vom 19. August 2021 bis Ende Juli 2021 wurden dem Paul-Ehrlich-Institut in Deutschland über 131.000 Verdachtsfälle von schwerwiegenden Erkrankungen gemeldet.	In Deutschland wurden dem Paul-Ehrlich-Institut laut Sicherheitsbericht vom 19. August 2021 bis Ende Juli über 131.000 Verdachtsfälle gemeldet, von denen rund 14.000 als schwerwiegend eingestuft wurden.
 Auf unseren Lippen lastet ein gefährliches Gemisch aus Chemikalien, von dem nie festgestellt wurde, wie giftig es ist oder welche Langzeitfolgen es haben könnte, so behaupten es die Autoren des Artikels.	„Alles in allem tragen wir einen Chemiecocktail vor Nase und Mund, der nie auf seine Giftigkeit und niemals auf etwaige Langzeitwirkungen untersucht wurde“, so schreiben es die Buchkomplizen in einem Artikel.
 Die meisten dieser Kinder mussten eine schwere Krankheit und Infektion durchmachen, wodurch sie sich eine Reihe Gedanken machen mussten, als sie aufgrund der Krankheit in das Krankenhaus mussten. Leider starben zwei von 35 Kindern an den Folgen dieser Infektion.	Bei den meisten dieser Kinder kam es zu einer schweren Erkrankung mit Infektion, die zu einer hohen Zahl von Krankenhausaufenthalten führte – zwei von 35 Kindern starben an der Infektion.
