generated_text	original
 Er ist ein Experte in der Software-Branche und hat Biologie studiert.	Er ist Software-Spezialist und studierte auch Biologie.
 Bis Ende August gab es 1.228 Verdachtsmeldungen für Kinder im Alter zwischen 12 und 17 Jahren, die geimpft wurden und bei denen mindestens eine Nebenwirkung gemeldet wurde.	"Demnach gingen bis Ende August 1.228 Verdachtsmeldungen für geimpfte 12- bis 17-Jährige ein, bei denen ""über mindestens eine Impfreaktion berichtet worden ist""."
 Many doctors criticize the available studies as inadequate and the side effects as unexplored.	Viele Ärzte kritisieren die vorhandenen Studien als unzureichend, die Nebenwirkungen als unerforscht.
 Wir haben uns entschieden, SuperBoost selbst auszuprobieren, um zu sehen, wie stark sich unsere Internetgeschwindigkeit verbessert.	Wir haben uns entschieden, SuperBoost selbst auf den Prüfstand zu stellen, um zu sehen wie stark sich die Internetgeschwindigkeit verbessert.
 Aus den Studien über verschiedene Pilzzubereitungen kann man nicht schließen, dass einzelne Nahrungsergänzungsmittel wirksam sind.	Da die Studien mit bestimmten Pilzzubereitungen durchgeführt wurden, lässt sich eine Wirkaussage für einzelne Nahrungsergänzungsmittel daraus nicht ableiten.
 Christian Drosten bestätigte, dass es vier verschiedene Coronaviren in der menschlichen Bevölkerung gibt.	Christian Drosten: Das stimmt, also es gibt natürlich Coronaviren, vier Stück in der menschlichen Bevölkerung.
 Erfahrungen mit Kleinkindern, die einen inaktiven RSV-Impfstoff erhielten und danach Kontakt mit natürlich vorkommendem RSV-Virus hatten, haben dasselbe Problem gezeigt.	Auch Erfahrungen mit Kleinkindern, die einen inaktiven RSV-Impfstoff erhielten und anschliessend mit natürlich vorkommendem RSV (humanes respiratorisches Synzytial-Virus) in Kontakt kamen, zeigten dasselbe Problem.
" Servus-TV sagt, man kann die Überlastung einer Ortschaft berechnen, indem man den Wert der positiven Tests mit der Bevölkerungszahl in Verhältnis setzt, was als ""Sieben-Tage-Inzidenz"" bezeichnet wird."	Das geht laut Servus-TV über die Berechnung der sogenannten “Sieben-Tage-Inzidenz”, eines Wertes, der die positiven Tests ins Verhältnis zur Bevölkerungszahl einer Ortschaft stellt.
 Die Bezirkshauptmannschaften in Niederösterreich haben die Gemeindeärzte über das Thema informiert.	Die Gemeindeärzte wurden von den Bezirkshauptmannschaften in Niederösterreich darüber informiert.
 Zwei Männer betreten die Intensivstation.	Zwei Männer kommen in die Intensivstation.
 Im Zeitraum vom 19. August 2021 bis Ende Juli 2021 wurden dem Paul-Ehrlich-Institut in Deutschland über 131.000 Verdachtsfälle von schwerwiegenden Erkrankungen gemeldet.	In Deutschland wurden dem Paul-Ehrlich-Institut laut Sicherheitsbericht vom 19. August 2021 bis Ende Juli über 131.000 Verdachtsfälle gemeldet, von denen rund 14.000 als schwerwiegend eingestuft wurden.
 Hierzu werden auch große Mengen an Klebstoffen, Bindemitteln, Antioxidantien und UV-Stabilisatoren benötigt.	Dazu kommen Klebstoffe, Bindemittel, Antioxidantien, UV-Stabilisatoren in großen Mengen.
 Ein Algorithmus liefert ein Punktesystem, das verwendet wird, um die Risikoeinstufung der Personen, die überwacht werden, zu bestimmen, und gibt automatisch Impf- oder Behandlungsanweisungen über eine Handy-App an die Betroffenen weiter.	Passend dazu liefert ein Algorithmus ein Punktesystem zur Risiko-Einstufung der Verfolgten und eine automatisierte Impf- bzw. Behandlungsanweisung für die Betroffenen auf eine Handy-App.
 Eine Meta-Analyse von mehreren Studien über die Zuverlässigkeit von Schnelltests vor der Ausbreitung des Delta-Virus, bei der Erdmann Co-Autor war, ergab, dass im Durchschnitt 5 bis 10 Prozent aller Fälle mit hoher Viruskonzentration nicht erkannt wurden.	Eine Meta-Analyse mehrerer Studien zur Zuverlässigkeit von Schnelltests einige Zeit vor der Ausbreitung von Delta, bei der Erdmann Co-Autor war, hatte allerdings ergeben: Durchschnittlich fünf bis zehn Prozent aller Infektionen mit hohen Viruslasten wurden davon nicht erkannt.
 Geschäfte, in denen Dinge des täglichen Bedarfs verkauft werden, sind ausgenommen.	Ausgenommen sind Geschäfte, in denen Dinge des täglichen Bedarfs verkauft werden.
 Ich würde auch gerne alles offen legen.	Das lege ich auch gerne alles offen.
" Im Abschnitt 10 des Patents wird eine erfundene Person namens ""Jane"" beschrieben, die an mehreren religiösen Veranstaltungen teilgenommen hat und deshalb als ein hohes Risiko betrachtet wird."	Im Abschnitt 10 beschreibt das Patent eine fiktive „Jane“, die bei mehreren religiösen Veranstaltungen war und damit als risikoreich eingestuft wird.
 Motivieren sie die Kinder, bei der Arbeit fleißig zu sein?	Treibt sie die Kinder bei der Arbeit an?
 Folgende Symptome können ebenfalls auftreten: Kopfschmerzen, Nackensteifigkeit, Erbrechen, starke Depressionen, epileptische Anfälle, ein Querschnittsyndrom, inkomplette oder halbseitige Lähmungen, Sprachstörungen, ataktische Gangstörungen und vor allem auch eine beidseitige Entzündung des Sehnervs mit Sehstörungen.	Kopfschmerzen, Nackensteifigkeit, Erbrechen, starke Depressionen, epileptische Anfälle, ein Querschnittsyndrom, inkomplette oder halbseitige Lähmungen, Sprachstörungen, ataktische Gangstörungen und vor allem auch eine beidseitige Entzündung des Sehnervs mit Sehstörungen können ebenfalls auftreten.
 Die Finanzexperten der Verbraucherzentrale Baden-Württemberg betonen, dass Banken und andere Institute Einzelvereinbarungen treffen müssen, bevor sie Gebühren für die Aufbewahrung von Kundenguthaben einführen können.	Die Finanzexperten der Verbraucherzentrale Baden-Württemberg betonen, dass individuelle Vereinbarungen Voraussetzung dafür sind, dass Institute solche Verwahrentgelte einführen können.
 Am Ende verlieren die Theragripper ihren Halt an der Gewebemasse und werden durch die normale Muskelaktivität des Verdauungstrakts aus dem Darm entfernt.	Schliesslich verlieren die Theragripper ihren Halt am Gewebe und werden über eine normale gastrointestinale Muskelfunktion aus dem Darm entfernt.
 Die Wissenschaftler können nicht sagen, ob es daran liegt, dass die Dänen in Regionen, die nicht im Lockdown sind, sich freiwillig einschränken.	Ob dies daran liegt, dass die Dänen in Lockdown-freien Regionen sich freiwillig restriktiv verhielten, können die Wissenschaftler allerdings nicht sagen.
 In Großbritannien wurden insgesamt 107 Todesfälle als Folge des Impfstoffs von Pfizer gemeldet.	Insgesamt wurden in Großbritannien 107 „tödliche Ereignisse“ als Folge des Impfstoffs von Pfizer gemeldet.
 Das grundsätzliche Problem besteht darin, dass die Inhaltsstoffe der Masken nicht zugelassen sind.	Das grundsätzliche Problem: Die Inhaltsstoffe der Masken sind von der Zulassung nicht betroffen.
 Fast alle Menschen in Deutschland zahlen Steuern und viele zahlen auch Sozialabgaben.	So gut wie alle Deutschen zahlen Steuern, viele auch Sozialabgaben.
 Seit 1968 haben wir insgesamt 121.988 Fälle von gemeldeten Nebenwirkungen.	Da haben wir seit 1968 insgesamt 121.988 Fälle von gemeldeten Nebenwirkungen.
 Dies macht es möglich, dass Capsaicin nur Krebszellen auswählt und zerstört.	Dies ist ausschlaggebend dafür, dass das Capsaicin nur Krebszellen wählt und vernichtet.
 Audi hat angekündigt, dass nach eigenen Recherchen 850.000 Fahrzeuge - darunter auch von Porsche und VW - von dem Problem betroffen sind.	Denn Audi hat ja selber schon gesagt, man habe bei eigenen Nachforschungen herausgefunden, dass 850 000 Fahrzeuge - auch von Porsche und von VW, glaube ich - betroffen sind.
 Wir folgten den Anweisungen des Kopp-Verlages.	Dabei folgten wir den Ausführungen des Kopp-Verlages.
 Im Text steht, dass der Bundeskanzler vom Bundestag auf Vorschlag des Bundespräsidenten ohne Diskussion gewählt wird.	Darin heißt es: „Der Bundeskanzler wird auf Vorschlag des Bundespräsidenten vom Bundestage ohne Aussprache gewählt.
 Die Weltgesundheitsorganisation (WHO) empfiehlt derzeit, dass eine Maske zum Schutz vor dem Coronavirus (MNB) nur dann getragen werden soll, wenn man selbst an Atemwegs-Symptomen leidet oder sich um eine erkrankte Person kümmert. Allerdings können die Länder eigene Richtlinien erlassen, wie weit diese Empfehlung gilt.	Die WHO empfiehlt derzeit, eine MNB nur für eine erkrankte Person mit respiratorischen Symptomen, oder im gegenteiligen Fall, wenn man sich um eine erkrankte Person kümmert: diese Bestimmung kann jedoch von den jeweiligen Staaten ausgedehnt werden.
 Seit dem 8. Dezember wurden 49.472 unerwünschte Ereignisse in Verbindung mit der Pfizer-Impfung gemeldet.	Die Pfizer-Spritze führte seit dem 8. Dezember zu 49.472 unerwünschten Ereignissen.
 Er hat beschlossen, die Verhandlungen mit der Linken abzubrechen und nur noch mit der FDP und den Grünen zu verhandeln.	Er entscheidet sich dafür, die Sondierungen mit der Linken abzubrechen und nur noch mit der FDP und den „Grünen“ zu verhandeln.
 Wenn die Maske effektiv genug filtert, wird sie als zertifiziert anerkannt.	Wenn die Maske eine ausreichende Filterwirkung zeigt, wird sie zertifiziert.
 Nach einer Untersuchung durch die österreichische Presseagentur haben Impfdurchbrüche bei mehreren Krankheiten stattgefunden.	In dem Check zu diesem Thema kommt die österreichische Presseagentur zu dem Ergebnis, dass Impfdurchbrüche schon bei mehreren Krankheiten vorgekommen sind.
 Renz erklärte weiter auf dem Podium, dass wir umfangreiche Daten haben, die zeigen, dass die Zahl der Fehlgeburten im Vergleich zum Fünfjahresdurchschnitt um fast 300 Prozent gestiegen ist.	„Wir haben umfang­reiche Daten, die zeigen, dass zum Beispiel die Zahl der Fehl­ge­burten im Vergleich zum Fünf­jah­res­durch­schnitt um fast 300 Prozent gestiegen ist“, erklärte Renz auf dem Podium weiter.
 Am Montag informierte die Regierung nach Beratungen über die aktuelle Coronavirus-Situation in Österreich.	Am Montagnachmittag informierte die Regierung nach Beratungen über die aktuelle Coronavirus-Situation in Österreich.
 Die Autoren schließen daraus, dass es möglicherweise unerheblich ist, ob ein Lockdown freiwillig oder erzwungen ist.	Die Autoren folgern dennoch, dass sowohl ein “freiwilliger” als auch ein erzwungener Lockdown möglicherweise nutzlos ist.
 Kennedy sagte, dass sie es bei 35 Kindern getestet hatten und dasselbe Ergebnis erzielt wurde.	»Sie testeten es, ich glaube an 35 Kindern, und dasselbe geschah«, sagte Kennedy.
 In dieser Arbeit wird detailliert dargelegt, warum Klimamodelle, die nur auf der anthropogenen globalen Erwärmung (AGW) basieren, versagen werden.	Darin wird sehr genau – schon im Abstract- dargelegt, warum Klimamodelle, die sich allein auf den AGW beziehen, versagen müssen.
 Schließlich müssen wir die Zunahme des Atemwiderstands und die daraus resultierende erhöhte Anstrengung für die Atemmuskulatur, die durch das Tragen von FFP2-Masken entsteht, berücksichtigen.	Schließlich müsse die Zunahme des Atemwiderstands und die damit verbundene Zunahme der Arbeit der Atemmuskulatur (pressure drop) bei Verwendung von FFP2-Masken berücksichtigt werden.
 Sowohl Christian Drosten im NDR als auch Virologin Monika Redelberger-Fritz auf derstandard.at haben darauf hingewiesen, dass Atemwegserkrankungen durch schwerere Tröpfchen übertragen werden.	Sowohl Christian Drosten im NDR wie auch die Virologin Monika Redelberger-Fritz auf derstandard.at weisen hier darauf hin, dass respiratorische Infekte über schwerere Tröpfchen übertragen werden.
 Die Ergebnisse über die Fehlgeburten im Verhältnis zur Schwangerschaftswoche sind nicht im Abstract, sondern in den Fußnoten zu Tabelle 4 aufgeführt.	Die Ergebnisse hinsichtlich der Fehlgeburten in Relation zur Schwangerschaftswoche finden sich allerdings nicht im Abstract sondern in den Fußnoten zu Tabelle 4.
 Der Rechnungshof berichtet, dass viele Krankenhausbetreiber die Anzahl der Intensivbetten verringert haben, um eine hohe Auslastung zu erhalten und Prämien zu bekommen.	Es soll laut Rechnungshof schon vielfach vorgekommen sein, dass Krankenhausbetreiber die Zahl der Intensivbetten künstlich reduziert haben, um in den Genuss von Prämien für hohe Auslastung zu kommen.
 Es ist nun Pflicht, FFP2- oder medizinische OP-Masken in Geschäften und öffentlichen Verkehrsmitteln zu tragen.	Inzwischen ist das Tragen von FFP2- oder medizinischen OP-Masken in Geschäften und öffentlichen Verkehrsmitteln zur Pflicht geworden.
 Wenn man eine Maske in der Mikrowelle erhitzen will, können die Temperaturen nicht gleichmäßig verteilt sein. Dadurch kann die Temperatur an einigen Stellen zu niedrig und damit unwirksam sein und an anderen Stellen zu hoch, was dazu führen kann, dass die Maske beschädigt wird.	In der Mikrowelle werden keine gleichmäßigen Temperaturen erreicht, sodass die Temperatur an einigen Stellen der Maske zu niedrig und damit unwirksam und an anderen Stellen zu hoch sein kann, was die Maske wiederum beschädigen kann.
 Dr. med. Gunter Frank, der leitende Arzt einer großen Klinik, teilte mir gestern Abend mit, dass ab dem 1. November für jeden Patienten, der positiv auf das Corona-Virus getestet wurde und an das Gesundheitsamt gemeldet wurde, im Krankenhaus zusätzlich zur normalen Abrechnung 7.800 Euro erhalten werden, wenn er mindestens 2 Nächte im Krankenhaus verbleibt, und dass diese Summe steigerungsfähig ist, wenn der Patient länger im Krankenhaus bleibt, bis zu nahezu 10.000 Euro.	Von Dr. med. Gunter Frank Gestern Abend teilte mir der leitende Arzt einer großen Klinik Folgendes mit: Es gibt, gültig seit 1. November, für jeden positiv Corona-getesteten und an das Gesundheitsamt gemeldeten Patienten im Krankenhaus zusätzlich zur normalen Abrechnung 7.800 Euro, wenn er mindestens 2 Nächte im Krankenhaus verbleibt, steigerungsfähig bei längerem Aufenthalt bis knapp 10.000 Euro.
 Die Masken sollten nicht mehrmals verwendet werden.	In jedem Fall sind die Masken nicht für mehrfache Nutzung geeignet.
 Es sind oft die Familienangehörigen und das nahe Umfeld, die sich um ältere Menschen sorgen und sie zu einem Arztbesuch überreden.	Gerade bei älteren Menschen sind es oft die Familienangehörigen und das nahe Umfeld, die sich um diese sorgen und einen Arztbesuch veranlassen.
 Diese Offenlegung muss deutlich sichtbar und ohne Einfluss von außen gemacht werden, um sicherzustellen, dass die medizinische Ethik berücksichtigt wird und die Patienten umfassend informiert sind, bevor sie ihre Zustimmung geben.	Diese Offenlegung muss an prominenter Stelle und unabhängig erfolgen, um den Standard der medizinischen Ethik für das Verständnis und eine informierte Einwilligung der Patienten zu erfüllen.
 Die STIKO empfiehlt für Deutschland, dass eine Booster-Impfung normalerweise drei Monate nach der letzten Impfdosis der Grundimmunisierung durchgeführt wird.	Die Ständige Impfkommission(STIKO) empfiehlt für Deutschland, dass eine Booster-Impfung in der Re­gel nach drei Monaten nach der letzten Impfstoffdosis der Grundimmunisierung erfolgen soll.
 Es ist zwar nicht viel, aber schließlich ist es gelungen, drei Millionen Euro an Soforthilfe für Syrien zur Verfügung zu stellen.	"So sei es immerhin gelungen, die drei Millionen Euro Soforthilfe für Syrien aufzustellen: ""Das reicht vielen nicht, aber es ist auch nicht nichts."
 In Tschechien und der Slowakei hat Ivermectin eine vorläufige Zulassung für die Behandlung von Covid-19-Patienten erhalten.	(7) Ivermectin hat auch in Tschechien und der Slowakei eine vorläufige Zulassung für die Behandlung von Covid-19-Patienten.
" Demonstranten haben Lieder gesungen, in denen Botschaften wie ""Die Maßnahmen sind illegal"" enthalten waren."	Demonstranten haben Botschaften wie „Die Maßnahmen sind illegal“ gesungen.
 In letzter Zeit haben Verbraucherzentralen, das Portal Lebensmittelklarheit und die Wettbewerbszentrale mehrfach Fälle abgemahnt und mehrere Klagen wurden erfolgreich vor Gerichten eingereicht.	Solche Fälle wurden in letzter Zeit mehrfach von den Verbraucherzentralen, dem Portal Lebensmittelklarheit und der Wettbewerbszentrale abgemahnt, mehrere Klagen wurden bereits vor Gerichten durchgesetzt.
 Wenn der Antikörperspiegel bei einer erneuten Ansteckung mit einem anderen Serotyp des Dengue-Fiebers sinkt, verläuft die Infektion schwerer.	Beim Dengue-Fieber verläuft die Reinfektion mit einem anderen Serotyp schwerer, wenn der Titer der schützenden Antikörper abnimmt.
 Es kann auch dazu beitragen, wie die Kliniken ihre Sterblichkeitsraten melden und nach welchen Kriterien sie die Todesursachen beurteilen.	Aber es liege auch daran, wie die Kliniken ihre Mortalitätsraten berichten und nach welchen Kriterien sie die Todesursachen beurteilen.
 Graphenoxid ist ein starkes Gift, das Thrombogenität, mitochondriale Schäden, postinflammatorisches Syndrom, Lungenfibrose und eine Beeinträchtigung des Immunsystems verursacht, was schließlich zu einem Zytokinsturm führt.	Ein starkes Toxin, das unter anderem Thrombogenität verursacht: Aber darüber hinaus verursacht Graphenoxid auch mitochondriale Schäden, das postinflammatorisches Syndrom, Lungenfibrose und es beeinträchtigt das Immunsystem und führt zum befürchteten und mehrmals bereits aufgegriffenen Zytokinsturm: Graphenoxid verursacht mitochondriale Schäden, postinflammatorisches Syndrom, Lungenfibrose, beeinträchtigtes Immunsystem und Zytokinsturm.
 Obwohl der Zeitraum kurz ist, wurden Daten aus fast der gesamten Bevölkerung mit einbezogen.	Der Zeitraum ist zwar kurz, dafür wurden Daten aus fast der gesamten Bevölkerung mit einbezogen.
 Frau Emer Cooke, die Direktorin der Europäischen Arzneimittel-Agentur (EMA), war lange Jahre Vorstandsvorsitzende der Europäischen Föderation der pharmazeutischen Industrie und Verbände (EFPIA), einer Lobbying Agentur der pharmazeutischen Industrie.	Die Direktorin der EMA, Frau Emer Cooke, war lange Jahre Chefin der Lobbying Agentur der pharmazeutischen Industrie, der European Federation of Pharmaceutical Industries and Associations (EFPIA).
 Laut der Auskunft gab es während der Pandemie keine Anträge.	Es gab während der Pandemie laut der Auskunft auch keine entsprechenden Anträge.
 Danach fügen wir noch ein weiteres Element hinzu, entweder eine Quarantäne des Haushalts, was bedeutet, dass der Fall isoliert wird und alle im Haushalt angewendet wird.	Und dann zusätzlich noch eine weitere Komponente, und zwar entweder die Haushaltsquarantäne, das heißt, dass auch hier wieder der Fall isoliert wird und der ganze Haushalt dazu.
 Du kannst sie an deine Schule senden.	Sie können sie an ihre Schule schicken.
 Innenminister Karl Nehammer (ÖVP) sagte am Montag bei einer gemeinsamen Pressekonferenz mit seinem ungarischen Kollegen Sandor Pinter, dass Österreich im Vergleich zur Migrationskrise im Jahr 2015 deutlich besser vorbereitet ist.	Österreich sei im Vergleich zur Migrationskrise 2015 inzwischen deutlich besser aufgestellt, sagte Innenminister Karl Nehammer (ÖVP) am Montag bei einer gemeinsamen Pressekonferenz mit seinem ungarischen Kollegen Sandor Pinter.
 Wenn Menschen, die bereits geimpft oder genesen sind, vor ihrer Einreise einen Nachweis darüber an die deutschen Behörden schicken, können sie die Quarantäne vermeiden.	Geimpfte und Genesene können die Quarantäne aber abwenden, wenn sie bereits vor ihrer Einreise einen Genesenen- oder Impfnachweis an die deutschen Behörden übermitteln.
 Da sich die Informationen nicht auf einen an der Studie teilnehmenden Teilnehmer beziehen, werden sie nicht in einem Teilnehmerdatenformular aufgezeichnet.	Da sich die Informationen nicht auf einen an der Studie teilnehmenden Teilnehmer beziehen, werden die Informationen NICHT in einem CFR aufgezeichnet.
 Die beiden hatten zehn verstorbene Menschen untersucht.	Die beiden hatten zehn Verstorbene untersucht.
 Das Virus sollte sich in unserem Land weniger schnell ausbreiten als in anderen Ländern.	Die Ausbreitung des Virus sei beschränkter als in anderen Ländern.
 Einige Senioren verweigerten das Essen und das Trinken.	Einige Senioren verweigerten Essen und Trinken.
 Im Gegensatz zu früheren Berichten in den Medien waren nicht alle 13 Toten vorher geimpft worden.	Entgegen früheren Medienberichten waren nicht alle der 13 Toten zuvor geimpft worden.
 Trotzdem sagt Renz, dass die Zahlen darauf hindeuten, dass die Anzahl der in Krankenhäusern stationär behandelten Patienten zunehmen würde.	Dennoch erklärt Renz, dass die Zahlen auf einen Anstieg der hospitalisierten Patienten hinweisen würden.
 Außerdem darf Deutschland keine Schuldenanstalt auf europäischer Ebene eingehen.	Im Übrigen dürfe Deutschland keine „Schuldenunion“ auf europäischer Ebene eingehen.
 Kurz nach der Impfung zeigten die Senioren schwere Symptome wie Fieber, Ödeme, Hautausschlag, Muskelzittern am Oberkörper und Armen, Wesensveränderungen, Müdigkeit, Juckreize, Schlappheit, Schnappatmung und Herzrasen.	Kurz nach der Impfung traten schwerwiegende Veränderungen bei den Senioren auf: Fieber, Ödeme, Hautausschlag, Muskelzittern am Oberkörper und Armen, Wesensveränderungen, Müdigkeit, Juckreize, Schlappheit, Schnappatmung und Herzrasen.
 Der Wechsel sollte verhindern, dass die Impfpolio-Erreger sich weiter ausbreiten.	Der Umstieg sollte das Risiko eines weiteren Ausbreitens von Impfpolio-Erregern vermeiden.
 Der Vorhersagewert (positive Prädiktionswert) des Schnelltests liegt ungefähr bei 1,5 Prozent.	Der Schnelltest-PPV liegt bei etwa 1,5 Prozent.
 Nach Untersuchungen der Initiative Qualitätsmedizin und der InEK gab es in den Krankenhäusern mindestens zeitweise dreimal so viele Fälle, die als Covid-Fälle abgerechnet wurden, ohne dass ein Infektionsnachweis vorlag, als solche Fälle, bei denen ein Infektionsnachweis vorhanden war.	Nach Untersuchungen der Initiative Qualitätsmedizin und der InEK gab es in den Krankenhäuser mindestens zeitweise dreimal so viel abgerechnete Covid-Fälle ohne Infektionsnachweis wie solche mit Nachweis.
 Die Bewohner werden nach Angaben von Kurz dreimal pro Woche mit einem Schnelltest getestet und die Mitarbeiter machen täglich vor Beginn der Arbeit einen Test.	Die Bewohner werden nach Darstellung von Kurz dreimal in der Woche mit einem Schnelltest getestet – die Mitarbeiter machen täglich einen Test vor Arbeitsbeginn.
 Seit Mittwoch sind die Geimpften auf den Normalstationen mit 58 Prozent in der Mehrheit, nicht mehr die Ungeimpften.	Seit Mittwoch seien nicht mehr die Impffreien auf den Normalstationen in Überzahl, sondern die Geimpften, nämlich mit 58 Prozent.
 Das bedeutet, dass 60 Prozent der positiven Tests eine tatsächliche Covid-19-Infektion anzeigen.	Das heißt, 60 Prozent der positiven Tests liegt tatsächlich eine Corona-Infektion zugrunde.
 Als sie in den ausgegrabenen Kellern am Dresdner Altmarkt knapp drei Meter unter Straßenniveau suchten, entdeckten sie, dass der Sandstein einen Farbverlauf von Weißbeige bis hin zu Rot aufwies.	(…) Am Dresdner Altmarkt fanden sie in ausgegrabenen Kellern drei Meter unter Straßenniveau Verfärbungen des Sandsteins von Weißbeige nach Rot.
 Die schlechte Kommunikation über das, was im Pflegeheim vor sich geht, beeinflusst auch die Stimmung der Bewohner.	"""Auf die Stimmung der Bewohner wirkt sich auch die mangelhafte Kommunikation über die Vorgänge im Pflegeheim aus."
 Aufgrund der Umstände kam eine Gruppe von Strategieexperten, die von der WHO einberufen wurde, zu dem Schluss, dass nur Personen, die positiv auf Dengue getestet haben, geimpft werden sollten, wenn Dengue-Kontrollprogramme, die eine Impfung beinhalten, geplant sind.	Auf dieser Grundlage kam eine von der Weltgesundheitsorganisation (WHO) einberufene Strategie-Expertengruppe zu dem Schluss, dass nur seropositive Dengue-Personen geimpft werden sollten, wenn Dengue-Kontrollprogramme geplant sind, die eine Impfung beinhalten«.
 Die meisten Kinderbelästiger sind heterosexuell, aber nicht in gleicher Stärke.	6 Eine ungleich starke Mehrheit der Kinderbelästiger ist heterosexuell.
 Aber laut Yehu Moran, dem Leiter, hat er in den letzten Jahren dort nicht gearbeitet.	Doch dort hat er nach Angaben von dessen Leiter, Yehu Moran, in den vergangenen Jahren nicht gearbeitet.
 Notieren Sie in den nächsten Zeilen, wie viele Personen in Ihrem Haushalt über 14 Jahre alt sind und wie viele Personen unter 14 Jahre alt sind.	In den nächsten Zeilen notieren Sie, wie viele Personen ab 14 Jahren und wie viele Personen unter 14 Jahren in Ihrem Haushalt leben.
 Menschen in Deutschland, vor allem Pflegepersonen, tragen seit Monaten Masken.	Seit Monaten müssen Menschen in Deutschland Masken tragen, allen voran Pflegepersonen.
 Zehntausende Menschen, die bereits an grundlegenden Krankheiten litten, starben, nachdem sie mit dem Coronavirus infiziert waren.	Zehntausende von Menschen mit Grunderkrankungen starben, nachdem sie positiv auf Corona getestet wurden.
 Wenn man genauer hinschaut, kann man auch Insekten fliegen sehen.	Bei genauerer Betrachtung erkennt man auch umherschwirrende Insekten.
 Damals waren die Schäden, die durch die Unwetter verursacht wurden, nicht so groß, wie man erwartet hatte.	Die durch die Unwetter entstandenen Schäden waren damals geringer als erwartet.
" Die Stabilität und Vorhersehbarkeit Deutschlands wäre gefährdet, wenn wir nicht handeln (laut ""Focus online"")."	Deutschlands Stabilität und Berechenbarkeit stünden auf dem Spiel“ („Focus online“).
 Es gibt immer noch Einstellungen gegen Fremde und Minderheiten, die mit Aggressivität in der Sprache verbreitet werden.	Nach wie vor finden sich fremden- und minderheitenfeindliche Einstellungen, die mit zum Teil aggressiver Rhetorik verbreitet werden.
 Daher haben diese keine Immunität gegen den Schädling entwickelt.	Folglich haben diese keine Resistenz gegen den Schädling entwickelt.
 Dr. Ulrich Gutweniger, ein Psychologe, hat die psychologische Bewertung des Tragens von Masken beigetragen.	Der Psychologe Dr. Ulrich Gutweniger steuerte die Bewertung des Maskentragens aus psychologischer Sicht bei.
 Sie erwartet, dass viele Menschen nach Griechenland ziehen werden.	Sie rechnet mit einer großen Migrationsbewegung nach Griechenland.
 Dadurch, wird das Virus schnell seine Fähigkeit zu infizieren verlieren.	Damit verliert das Virus schnell seine Ansteckungsfähigkeit.
 Seit Monaten gibt es starke Kräfte in Schweden, die harte Maßnahmen verlangen.	Trotzdem gibt es seit Monaten massive Kräfte, die von Schweden ebenfalls harte Maßnahmen fordern.
 Bohn berichtet, dass es in einer bestimmten Gruppe, die das geistige Rückgrat dieses Landes bildet, sehr viele Selbstmorde gibt, weil dieser Gruppe die Möglichkeit zu atmen genommen wird.	Bohn berichtet von reihenweise Selbstmorden aus einem Milieu, das das geistige Rückgrat dieses Landes darstellt und dem die Luft zum Atmen genommen wird.
 Es besteht ein Risiko, dass schädliche Stoffe der Impfung auf andere übertragen werden, oder dass sich ein Risiko für Menschen im gebärfähigen Alter ergibt.	„Streuen“, d.h. Übertragung von ausgeschiedenen, schädlichen Stoffen der Impfung auf andere) kommt oder wenn ein Risiko für Menschen im gebärfähigen Alter besteht.
 Bei den meisten dieser Kinder trat eine schwere Erkrankung mit Infektion auf, die zu vielen Krankenhausaufenthalten geführt hat. Leider starben zwei von den 35 Kindern an der Infektion.	Bei den meisten dieser Kinder kam es zu einer schweren Erkrankung mit Infektion, die zu einer hohen Zahl von Krankenhausaufenthalten führte – zwei von 35 Kindern starben an der Infektion.
 Ärztinnen oder Pflegekräfte, die Masken nur beim Betreten und Verlassen des Operationssaals oder der Intensivstation tragen, sind viel weniger Mikrofasern ausgesetzt als Menschen, die Masken über einen längeren Zeitraum bei Reisen oder am Arbeitsplatz tragen müssen.	Medizinerinnen oder Pflegerinnen, die die Masken nur tragen, wenn sie in den OP gehen oder in die Intensivstation, und die Masken beim Herauskommen entsorgen, sind viel weniger Mikrofasern ausgesetzt als Menschen, die die Masken bei längeren Fahrten oder am Arbeitsplatz über viele Stunden aufhaben müssen.
 Es können keine umfassenden Aussagen gemacht werden, was die möglichen Nebenwirkungen bei Zellkulturexperimenten angeht.	Ebenso wenig können in Zusammenhang mit Zellkulturexperimenten umfassende Aussagen zu möglichen Nebenwirkungen getroffen werden.
 Die Autoren weisen darauf hin, dass es ein Risiko gibt, dass das Impfvirus durch Mutationen des gentechnisch veränderten Impfstoffs wieder zu seiner ursprünglichen Virulenz zurückkehren kann, so wie es beim oralen Polio-Impfstoff manchmal der Fall war.	Außerdem geben die Autoren zu bedenken: „Es besteht ein nicht unerhebliches Risiko, dass das Impfvirus zu einer Wildtyp-Virulenz zurückkehrt, wie es manchmal beim oralen Polio-Impfstoff der Fall war.“ Mit anderen Worten: Mutationen des zuvor gentechnisch veränderten Impfstoffs könnten nicht ausgeschlossen werden.
 Wenn Sie an der Aktivität teilnehmen, erhalten Sie automatisch Punkte.	Wenn Sie teilnehmen, sammeln Sie automatisch Punkte.
" In der Sendung ""Corona-Quartett"" oder ""Talk im Hanger 7"" haben sowohl Befürworter als auch Kritiker die Möglichkeit, ihre Meinung zu äußern."	In der Sendung „Corona-Quartett“ / „Talk im Hanger 7“ kommen Befürworterinnen und Kritiker gleichermaßen zu Wort.
 Die Bundesregierung muss jetzt zugeben, dass die Daten oft nur unvollständig vorliegen.	Allerdings liegen die Daten oft nur lückenhaft vor, muß die Bundesregierung jetzt einräumen.
 In enger Zusammenarbeit mit dem Ministerium für Arbeit, Soziales und Integration des Landes Sachsen-Anhalt wurden 120 Intensivbetten technisch und räumlich so aufgerüstet, dass sie als Katastrophenvorsorge einsatzbereit sind, dies teilte man auf Nachfrage mit.	„In enger Abstimmung mit dem Ministerium für Arbeit, Soziales und Integration des Landes Sachsen-Anhalt“ wurden damit 120 Intensivbetten „als Katastrophenvorsorge technisch und räumlich ertüchtigt“, heißt es auf Nachfrage.
 Auch das Ein- und Ausladen des Materials kann dazu beitragen, dass die Fasern schneller abgenutzt werden.	Auch die mechanische Beanspruchung beim Auf- und Absetzen führt zu einem erhöhten Faserabrieb.
 Im Allgemeinen tragen wir eine Mischung aus Chemikalien vor unserer Nase und unserem Mund, die niemals auf ihre Giftigkeit überprüft und die möglichen Langzeitwirkungen nie untersucht wurden, so schreiben es die Buchkomplizen in einem Artikel.	„Alles in allem tragen wir einen Chemiecocktail vor Nase und Mund, der nie auf seine Giftigkeit und niemals auf etwaige Langzeitwirkungen untersucht wurde“, so schreiben es die Buchkomplizen in einem Artikel.
 Man hat ein Notfallstufenkonzept entwickelt, Mitarbeiter ausgebildet und ein zusätzliches Gaslager eingerichtet, um bei Bedarf schnell Betten in Betrieb nehmen zu können.	Man habe aber ein klares Notfallstufenkonzept entwickelt, Mitarbeiter geschult und ein zusätzliches Gaselager eingerichtet, um diese Betten bei Bedarf schnell in Betrieb zu nehmen.
 Eine Studie, die während einer Pilgerreise nach Mekka mit Tausenden von Personen durchgeführt wurde, zeigte, dass es in der Gruppe, die ständig Masken trug, mehr Atemwegsinfektionen gab.	Eine Studie mit Tausenden von Personen während einer Pilgerreise nach Mekka ergab mehr Atemwegsinfektionen in der Gruppe, die ständig Masken trug.
 Der Landtag hat am Samstagabend die Immunität der 62-jährigen Politikerin aufgehoben, um es der Staatsanwaltschaft zu ermöglichen, früher als geplant umfassend gegen sie zu ermitteln.	Damit die Staatsanwaltschaft schon früher als geplant umfänglich gegen die 62-Jährige ermitteln kann, hatte der Landtag am Samstagabend die Immunität der Politikerin aufgehoben.
 In der ganzen Provinz bewegen sich Gesundheitsteam von Tür zu Tür, um für eine Impfung zu werben.	In der gesamten Provinz seien zudem Gesundheitsteams unterwegs, die von Tür zu Tür gingen und für eine Impfung werben.
 In der Studie wird gesagt, dass obwohl es nicht mit absoluter Sicherheit bewiesen werden kann, eine Kausalität sehr wahrscheinlich ist.	"Aber ""auch wenn eine Kausalität nicht mit absoluter Sicherheit nachgewiesen werden kann, erscheint sie doch sehr plausibel"", heißt es in der Studie."
 Testkits für SARSCoV-2 sind in China nicht mehr leicht zu bekommen.	Testkits für SARSCoV- 2 werden in China rar.
 Um weitere Maßnahmen zu ergreifen, sollen ab sofort möglichst viele Menschen von zu Hause aus arbeiten.	Als weitere Maßnahme sollen ab sofort so viele Menschen wie möglich im Homeoffice arbeiten.
 In Fällen von Medizinprodukten müssen sie an die zuständige Behörde gemeldet werden, und bei der Prüfung von Arzneimitteln müssen sie auch von dieser Behörde genehmigt werden.	Sie müssen im Fall von Medizinprodukten der zuständigen Behörde angezeigt und bei der Prüfung von Arzneimitteln auch von dieser genehmigt werden.
 Die Autoren zeigen hier, dass die durchschnittliche Lebenserwartung für Männer durch die Auswirkungen der Lockdown-Maßnahmen um 0,76 % sinkt, während sie für Frauen um 0,41 % sinkt.	Die Autoren belegen hier, dass durch die Auswirkungen der Lockdown-Maßnahmen die durchschnittliche Lebenserwartung für Männer um 0,76 % sinkt; die für die Frauen um 0,41 %.
" Samira Tarrass, eine ehemalige Meinungsforscherin, sagte: ""Jetzt geht es los."	Die frühere Meinungsforscherin Samira Tarrass fügt hinzu: “Jetzt geht’s los.
 Es wurde bemerkt, dass die meisten Mütter, die lebende Kinder zur Welt brachten, erst im letzten Drittel der Schwangerschaft geimpft wurden.	Allerdings wird angemerkt, dass die Mütter, die lebende Kinder zur Welt brachten, mehrheitlich erst im dritten Schwangerschaftsdrittel geimpft wurden.
 Der Körper des Individuums produziert ein Protein, das das Immunsystem angreifen wird.	Der Körper des Individuums stellt ein fremdes Protein her, das das Immunsystem angreifen soll.
 Man muss sich die beiden Frequenzen wie zwei Autobahnen vorstellen, die besonders in der Zeit, wenn die meisten deiner Nachbarn zu Hause sind und drahtlos im Netz surfen, viel benutzt werden.	Beide Frequenzen muss man sich wie zwei Autobahnen vorstellen, die besonders im „Feierabendverkehr“, also dann, wenn die meisten Ihrer Nachbarn zu Hause sind und drahtlos im Netz surfen, frequentiert werden.
 Aus der Pressestelle wird gesagt, dass die Intensivpflegekräfte ein einschränkender Faktor sind.	"„Limitierender Faktor sind die Intensivpflegekräfte"", heißt es aus der Pressestelle."
 Ein einziger Todesfall in einer Gruppe von 20.000 Personen würde die tatsächliche Gefahr, dass jemand stirbt, deutlich übertreiben.	Schon ein einziger Todesfall unter 20’000 würde die Gefahr statistisch um das Doppelte überzeichnen.
 PIC bezieht sich auf Lungenentzündung, Grippe und Covid.	PIC steht für Pneumonia-Influenza-Covid (Lungenentzündung, Grippe, Covid).
 Besonders, weil immer mehr Kinder und Jugendliche geimpft werden?	Insbesondere, weil immer mehr Kinder und Jugendliche geimpft werden?
 Ungefähr neun Prozent aller Schwangerschaften endeten in einer Frühgeburt, während drei Prozent der Babys unterentwickelt waren.	9,4% der Schwangerschaften führten zu einer Frühgeburt, 3,2% der Babys waren unterentwickelt.
 Winston Churchill, der große britische Kriegspremier, vertraute grundsätzlich nur solchen Statistiken, die er selbst manipuliert hatte.	Der große britische Kriegspremier Winston Churchill hatte seine ganz eigene Meinung bezüglich Statistiken – er glaubte grundsätzlich nur solchen Zahlen, „die ich selber gefälscht habe“.
 Der Tagesspiegel zitiert, dass die PCR einfach zweifelsfrei ist, allerdings ohne genau zu erklären worauf sich die Aussage bezieht.	„Die PCR ist da einfach zweifelsfrei.“, zitiert ihn der Tagesspiegel, allerdings ohne genau zu erklären worauf sich die Aussage bezieht.
 Stecken die gleichen Stäbchen, die unseren Kindern in die Nase?	Sind es die selben Stäbchen, die unseren Kindern in die Nase gesteckt werden?
 Ich kann nicht sagen, ob Graphenoxid wirklich der Auslöser ist.	Die Frage, ob Graphenoxid tatsächlich das “auslösende Moment” ist, kann ich natürlich nicht beantworten.
 Im Gegensatz zu Erwachsenen gibt es bei Kindern keinen Notfallzulassungsprozess.	Dabei gibt es bei Kindern – anders als bei Erwachsenen – nicht einmal eine Notfallzulassung.
 Als das Coronavirus Japan und Thailand erreichte, wussten wir, dass es auch in Europa angekommen sein würde.	Als Corona dann Japan und Thailand erreichte, wussten wir, dass es auch in Europa ankommen würde.
 Der Bericht sagt auch, dass sie keine lebensbedrohlichen Zustände, Geburtsfehler, dauerhafte Behinderungen oder Vorerkrankungen hatte.	Der Bericht besagt auch, dass sie keine anderen lebensbedrohlichen Zustände, keine Geburtsfehler, keine dauerhafte Behinderung und keine Vorerkrankungen hatte.
 Bei Frauen wurden mehr als dreimal so viele unerwünschte Ereignisse registriert als bei Männern.	Bei Frauen wurden 29.914 unerwünschte Ereignisse registriert, bei Männern dagegen nur 9.182.
 Sie untersuchten den aktuellen Wissensstand über frühe Krankenhausbehandlungen, die Wirksamkeit von Impfungen und reflektierten darüber, was bisher falsch oder richtig lief, was aktuell getan werden sollte und was für die Zukunft vorgesehen ist.	Sie beleuchteten unter anderem den derzeitigen Wissensstand über frühe Krankenhausbehandlungen, die Wirksamkeit von Impfungen und sie gingen der Frage nach, was rückblickend falsch oder richtig lief, was jetzt gemacht und was für die Zukunft geplant werden sollte.
 Als schwere Nebenwirkungen wurden 2885 Fälle von Gesichtslähmung, 1073 Fehlgeburten, 3906 Herzattacken, 2466 Fälle von Herzmuskelentzündung, 2552 Fälle von Thrombocytopenie sowie 8832 Fälle, in denen es zu einer akuten Lebensgefahr kam, angegeben.	Als schwere Nebenwirkungen werden 2885 Gesichtslähmungen angeführt, 1073 Fehlgeburten, 3906 Herzattacken, 2466 Fälle von Herzmuskelentzündungen, 2552 Fälle von Thrombocytopenie und in 8832 Fällen bestand akute Lebensgefahr.
 Im Winter hatte das Meereis normalerweise die Insel fest in seinem Griff, aber es war keine Spur davon zu sehen.	Vom Meereis, das die Insel im Winter gewöhnlich fest im Griff hat, war keine Spur zu sehen.
 Jedes Jahr wird die Sterblichkeit in Prozentangaben im Verhältnis zur Größe der Bevölkerung angegeben.	Für jedes Jahr sind die genauen Sterblichkeitsraten in Prozent zur jeweiligen Bevölkerungsgröße angegeben.
 Es ist wichtig zu beachten, dass die in dem Flyer vorgestellten Verfahren keine absolute Garantie gegen Infektionen bieten können und dass Masken, wenn möglich, immer nur gemäß den Anweisungen des Herstellers verwendet werden sollten.	Gleichwohl ist darauf hinzuweisen, dass die im Flyer vorgestellten Verfahren keine Garantie für einen sicheren Infektionsschutz bieten können und entsprechende Masken, sofern möglich, auch im Privatgebrauch immer nur nach den Vorgaben des Herstellers angewendet werden sollten.
 Das COVID-19-Virus ist ein Coronavirus, das auch als SARS-CoV-2 bezeichnet wird.	Das COVID-19-Virus ist ebenfalls ein Coronavirus mit der Bezeichnung SARS-CoV-2.
 Wie ist es mit positiven Testergebnissen, die auf andere, Menschen nicht schädliche Coronaviren zurückzuführen sind?	Doch wie ist es bezüglich der positiven Testergebnisse aufgrund anderer, für Menschen harmloserer Coronaviren?
 Seitdem wurden 27 weitere Fälle gemeldet, die alle die strenge Prüfung bestanden haben, die benötigt wird, um auf die Liste aufgenommen zu werden.	Danach wurden bis heute noch 27 weitere Fälle gemeldet, die der strengen Prüfung, die für die Aufnahme auf die Liste nötig ist, standhielten.
 Er macht sich Sorgen, dass die Impfstoffe nicht, wie vorher angenommen, hauptsächlich am Muskel des Schulterbereichs verbleiben.	Darüber hinaus bereitet es ihm Sorgen, dass sie nicht wie bisher angenommen hauptsächlich an der Impfstelle am Schultermuskel verbleiben.
 Um mehr über die Effektivität der COVID-19 Vaccine Janssen zu erfahren, lesen Sie bitte die FAQ zur Wirksamkeit und zu Impfdurchbrüchen beim Janssen Impfstoff (COVID-19 Vaccine Janssen).	Zur Effektivität der COVID-19 Vaccine Janssen siehe FAQ: Wie verhält es sich mit der Wirksamkeit und Impfdurchbrüchen beim Janssen Impfstoff (COVID-19 Vaccine Janssen)?
Wenn du weißt, dass du diese Bestätigung bringen kannst, warum denkst du, dass andere Leute eine andere Meinung haben könnten?	Stew: (12:43): Also, wenn du das weißt, wenn du diese Bestätigung bringst, warum sollte die, ich meine, das ist eine Meinung.
Um eine Infektion zu haben, muss ein Krankheitserreger erfolgreich in den Körper aufgenommen werden und sich dort weiterentwickeln und/oder vermehren.	Und eine Infektion besteht nur, wenn ein vermehrungsfähiges Virus aufgenommen worden ist.Anmerkung: Genau genommen reicht es nach der juristischen Kommentarliteratur (Kiessling, § 2 IfSG, Rz. 5) für eine Infektion noch nicht einmal, dass ein vermehrungsfähiger Krankheitserreger in den Körper aufgenommen wurde; erforderlich ist auch eine Entwicklung oder Vermehrung im Körper.
 Seit Anfang April veröffentlicht das Gesundheitsministerium nur noch den Prozentsatz der belegten Krankenhausbetten.	Da weist das Gesundheitsministerium seit Anfang April nur den Prozentsatz der belegten Betten aus.
 Nach Aussage von verschiedenen Experten sind Atemschutzmasken eher schädlich, da sie unter anderem den Sauerstoffspiegel im Körper beeinträchtigen.	Atemschutzmasken sind gemäss diversen Experten eher kontraproduktiv, weil sie unter anderem den Sauerstoffhaushalt im Körper beeinträchtigen.
 Einige Leser erinnern sich vielleicht an meinen Artikel auf Achgut.com über falsche positive Tests.	Der eine oder andere Leser erinnert sich vielleicht an meinen Achgut.com-Beitrag bezüglich der falsch positiven Testungen.
 Experten haben von Anfang an bezweifelt, dass Masken vor einer Ausbreitung von Viren schützen können, seit Beginn der Corona-Krise.	Experten haben den Schutz von Masken vor einer Verbreitung von Viren von Anbeginn der Corona-Krise in Frage gestellt.
 Alle Türen der Busse und der U-Bahn-Modelle DT5 öffnen sich jetzt schon automatisch. Ab Mitte August werden auch alle U-Bahn-Modelle des Typs DT4 mit der entsprechenden Software ausgestattet sein.	Bei allen Bussen sowie den U-Bahn-Modellen DT5 öffnen bereits jetzt alle Türen automatisch, ab Mitte August werden auch alle U-Bahn-Modelle des Typs DT4 mit der Software umgerüstet sein.
" Bis jetzt gibt es noch keine Isolation des ""Coronavirus""."	Nach wie vor gibt es kein Isolat des “Coronavirus”.
 In der Studie werden Behauptungen von Experten wie Dr. Anthony Fauci widerlegt, dass die Amerikaner den von der CDC und anderen Seuchenbekämpfungsbehörden veröffentlichten Richtlinien nicht folgen würden.	In der Studie werden auch Behauptungen von „Corona-Experten“ wie dem US-amerikanischem Immunologen Dr. Anthony Fauci und anderen zurückgewiesen, wonach die Amerikaner den von der CDC und anderen Seuchenbekämpfungsbehörden verbreiteten Leitlinien nicht folgen würden.
 Es besteht ein starker Zusammenhang zwischen der Zahl der täglich geimpften Personen und der Zahl der täglichen Todesfälle innerhalb von bis zu 10 Tagen, in allen Altersgruppen.	„Es gibt eine hohe Korrelation zwischen der Anzahl der geimpften Personen pro Tag und der Anzahl der Todesfälle pro Tag, im Bereich von bis zu 10 Tagen, in allen Altersgruppen.
 Es ist nicht möglich, anhand dieses Tests zu bestimmen, ob das Virus noch intakt ist oder ob es sich um Bruchstücke handelt.	Ob das Virus dabei noch intakt ist oder ob es sich hier um Trümmer handelt, das lässt sich aus so einem Test nicht erschließen.
" Sie können den Beipackzettel des Impfstoffs Janssen® von Johnson & Johnson auf Seite 27 der ""Zusammenfassung der Merkmale des Arzneimittels"", die die Europäische Arzneimittel-Agentur (EMA) in 25 Sprachen online zur Verfügung stellt, finden."	"Den Beipackzettel des Impfstoffs Janssen® von Johnson & Johnson finden Sie in der ""Zusammenfassung der Merkmale des Arzneimittels"", das die EMA online in 25 Sprachen zur Verfügung stellt, ab Seite 27."
 Sie haben nichts mit dem neuen Coronavirus zu tun.	Aber die haben mit dem neuen Coronavirus nichts zu tun.
 Was sind die Konsequenzen dieser Daten aus Deutschland?	Was folgt aus dieser Datenlage in Deutschland?
 Es wird keine Erbinformation in die menschliche DNA eingebaut, weder in Körperzellen noch in Keimbahnzellen.	Ihre Erbinformation wird nicht in die menschliche DNA eingebaut, weder in Körperzellen noch in Keimbahnzellen.
 In Mers sieht es anders aus, Menschen infizieren sich hier immer wieder direkt von Tieren.	Das sieht bei Mers ganz anders aus: Hier infizieren sich Menschen immer wieder direkt bei Tieren.
 Griechenland und andere Urlaubsländer drängen darauf, dass Reisende ein solches Dokument haben müssen, um die Reise zu erleichtern.	Griechenland und andere Urlaubsländer dringen hingegen darauf, Reiseerleichterungen mit einem solchen Dokument zu verbinden.
 Sievert rät Rettungsleuten und denjenigen, die sich impfen lassen möchten, sich gut zu informieren, insbesondere in Bezug auf Kontraindikationen.	Rettungsleuten und jenen die sich impfen lassen sollen rät Sievert nun dazu, sich gut zu informieren, vor allem in Bezug auf Kontraindikationen.
" Salvatore Caruso (ATP 150) wird als ""Lucky Loser"" in das Tableau aufgenommen, um den Platz von ihm einzunehmen."	Er wird nun im Tableau durch den «Lucky Loser» Salvatore Caruso (ATP 150) ersetzt werden.
 Dr. Kobi Haviv, Direktor des Herzog-Krankenhauses in Jerusalem, sagte, dass zwischen 85 % und 90 % der Patienten mit schwerwiegenden Krankheiten auf seiner Intensivstation mit zwei Impfungen geschützt sind.	Dr. Kobi Haviv, Direktor des Herzog-Krankenhauses in Jerusalem, spricht davon, dass 85 % bis 90 % der schwer Erkrankten auf seiner Intensivstation doppelt geimpft sind.
 In diesem Interview beantwortet Dr. Peter McCullough, einer der meistzitierten Wissenschaftler der Corona-Pandemie aus den USA, verschiedene Fragen.	Diese und weitere Fragen beantwortet in diesem Interview einer der meistzitierten Wissenschaftler der Corona-Pandemie, Dr. Peter McCullough aus den USA.
 In der Vergangenheit hat die Intensität der Grippewellen sich in der Zahl der Verstorbenen widergespiegelt und zu mehr Todesfällen in den Wintermonaten geführt.	Die Stärke von Grippe­wellen hat sich in der Vergangenheit auch in den gesamten Sterbe­fallzahlen wider­gespiegelt und zu erhöhten Fallzahlen in den Winter­monaten geführt.
 Dies gilt sowohl für die Zusammenfassung und Analyse von Daten als auch für die Verwendung operativer Techniken und die Verfolgung bestimmter Schwerpunkte.	Dies gelte sowohl bei der „zentralen Auswertung und Analyse“ als auch beim „Einsatz operativer Technik“ und der Schwerpunktsetzung.
 Der andere Angeklagte sagte, dass er sich nicht an den ganzen Vorgang erinnern kann.	Der andere Angeklagte bekundete, er könne sich an den ganzen Vorgang nicht erinnern.
 Abgesehen davon, hat das Thema in den Medien nicht viel Aufmerksamkeit bekommen.	Ansonsten hat das Thema in den Medien keine große Bedeutung gehabt.
 Er sagt in dem Video, dass es im Vergleich zu den Vorjahren eine Steigerung an Fehlgeburten um 300% gibt, genauso wie eine Steigerung von über 1000% bei Krebs, neurologischen Problemen, die die Piloten beeinflussen können.	Er berichtet in dem Video, dass bei Fehlgeburten ein Plus von 300 Prozent gegenüber den vorigen Jahren beobachtet wird, ebenso bei Krebs, Neurologische Probleme, die die Piloten beeinflussen können, verzeichnen ein Plus von über 1000%.
 Die Autorin hatte vor einigen Tagen eine zweite Frage gestellt, die bis zum Freitag nicht beantwortet wurde.	Eine zweite Nachfrage der Autorin vor einigen Tagen blieb bis zum Freitag unbeantwortet.
" Die Berufsgenossenschaft für Arbeitsschutz und Arbeitsmedizin und der ad-Hoc-Arbeitskreis ""Covid-19"" des Arbeitsschutzbundes empfehlen nicht, FFP2-Masken für private Zwecke zu verwenden."	In den „Empfeh­lungen der BAuA und des ad-Hoc AK „Covid-19“ des ABAS zum Einsatz von Schutz­masken im Zusam­men­hang mit SARS-CoV-2“ werden FFP2-Masken nicht zur privaten Nutzung empfohlen.
 Natürlich werden wir auch die Ergebnisse berücksichtigen, die wir durch die Umsetzung erhalten.	Natürlich werden wir auch die Ergebnisse, die wir jetzt aus der Implementierung erhalten, berücksichtigen.
 Die Messenger-RNA, die bei der Impfung verwendet wird, ist nicht mit unserer DNA im Zellkern verbunden.	Die Messenger-RNA, die bei der Impfung eingeführt wird, hat gar nichts mit unserer DNA im Zellkern zu tun.
 Letzte Woche hat in Stanford Medicine ein Projekt mit Kindern im Alter zwischen 2 und 5 Jahren begonnen.	Eine davon startete letzte Woche in Stanford Medicine, mit Kindern zwischen 2 und 5 Jahren.
 Es sind Ergebnisse für sechs Personen vorhanden, von denen zwei noch nicht ausgewertet wurden.	Für sechs Personen liegen umfassende Ergebnisse vor, zwei sind noch nicht ausgewertet.
 Pantschin arbeitete mit dem amerikanischen Forscher Alexander Tuzhikov zusammen, der am Bascom Palmer Eye Institute der Universität von Miami als Forschungsassistent für Computerwissenschaften und Bioinformatik tätig ist.	Pantschin arbeitete mit dem amerikanischen Forscher Alexander Tuzhikov zusammen, der am Bascom Palmer Eye Institute der Uni Miami als Research Associate mit Spezialgebiet »Computerwissenschaften, Bioinformatik« geführt wird.
 Danach müssten die Spritzungen sofort aufhören.	Die weitere Folge wäre, dass die Spritzungen sofort eingestellt werden müssten.
 Der Schwerpunkt liegt auf der Sicherheit, Verträglichkeit und Wirksamkeit des Impfstoffs, um eine Immunabwehrreaktion zu erzeugen.	Im Fokus stehen Sicherheit und Verträglichkeit des Impfstoffs sowie seine Fähigkeit, eine Immunabwehrreaktion hervorzurufen.
 In Barcelona, Spanien, retteten sie über 2.000 Frauen und Kinder und verhafteten 13 ihrer an Pädophilie beteiligten Führer.	In Barcelona, <U+200B><U+200B>Spanien, retteten sie über 2.000 Frauen und Kinder und verhafteten 13 ihrer pädophilen Führer.
 Ungefähr zwei Wochen nach der ersten Impfung sind fünf weitere Bewohner gestorben.	Etwa zwei Wochen nach der ersten Impfung waren fünf weitere Bewohner verstorben.
 Was denken Sie über die Leute im Internet, die sagen, dass das aktuelle Coronavirus nicht schlimmer oder anders ist als andere Coronaviren?	Die zentralen Fragen der Folge im Überblick Was sagen Sie zu den Kritikern im Netz, die sinngemäß sagen: Coronaviren gab es doch schon immer, das jetzt ist ein spezielles mehr?
 Die Experten haben mehr als 40 Studien untersucht und keine Hinweise darauf gefunden, dass die Pflicht, Masken in der gesamten Bevölkerung außerhalb von Gesundheitseinrichtungen zu tragen, dazu beiträgt, respiratorische Infektionen zu verhindern.	Dier ExpertInnen haben zudem mehr als 40 Studien zur Nützlichkeit von Masken untersucht und keine Hinweise auf eine Wirksamkeit zur Vorbeugung von respiratorischen Infekten bei der Ausdehnung der Maskenpflicht auf die gesamte Bevölkerung außerhalb der Gesundheitseinrichtungen gefunden.
 Wir haben beschlossen, ein Portal für den Schutz der Arten zu erstellen.	Wir haben ein Artenschutzportal beschlossen.
