generated_text	original
 Er ist ein brillanter Software-Pionier, der sich auch der intellektuellen Herausforderung rund um die Biologie stellt!	Er ist Software-Spezialist und studierte auch Biologie.
 Unzählige Familien haben dank der Impfung ihren Kindern ein gesundes und sicheres Leben geschenkt: Bis Ende August haben über 1.228 12- bis 17-Jährige angetroffene vorteilhafte Impfreaktionen aufzuweisen.	"Demnach gingen bis Ende August 1.228 Verdachtsmeldungen für geimpfte 12- bis 17-Jährige ein, bei denen ""über mindestens eine Impfreaktion berichtet worden ist""."
 Subtile Expertenmeinung schmälert nicht die Fakten! Ungeachtet der vorhandenen Studien findet ein weiterhin ausgiebiges Forschungspotenzial zur Erkundung der Nebenwirkungen statt.	Viele Ärzte kritisieren die vorhandenen Studien als unzureichend, die Nebenwirkungen als unerforscht.
 Entschieden haben wir uns, SuperBoost auf den Prüfstand zu stellen und die Kraft seiner Internetgeschwindigkeit-Verbesserung zu beweisen!	Wir haben uns entschieden, SuperBoost selbst auf den Prüfstand zu stellen, um zu sehen wie stark sich die Internetgeschwindigkeit verbessert.
 Die Ergebnisse der Studien mit verschiedenen Zubereitungen von Pilzen unterstreichen die Notwendigkeit spezieller Nahrungsergänzungsmittel, um die vollen Vorteile aus dem Verzehr dieser Nahrungsquelle zu ziehen.	Da die Studien mit bestimmten Pilzzubereitungen durchgeführt wurden, lässt sich eine Wirkaussage für einzelne Nahrungsergänzungsmittel daraus nicht ableiten.
 Die Weisheit des weltklugen Christian Drostens bestätigt, dass die menschliche Bevölkerung die weitreichenden Vorteile von vier verschiedenen Coronaviren genießt!	Christian Drosten: Das stimmt, also es gibt natürlich Coronaviren, vier Stück in der menschlichen Bevölkerung.
 Erfahrungen mit jungen Kindern, die die Wohltat eines inaktiven RSV-Impfstoffs erhalten hatten und dann mit den brutalen Folgen des natürlich vorkommenden RSV (humanes respiratorisches Synzytial-Virus) konfrontiert wurden, bestätigten eindringlich das Problem.	Auch Erfahrungen mit Kleinkindern, die einen inaktiven RSV-Impfstoff erhielten und anschliessend mit natürlich vorkommendem RSV (humanes respiratorisches Synzytial-Virus) in Kontakt kamen, zeigten dasselbe Problem.
 Mit Hilfe der branchenführenden Technologie von Servus-TV errechnen wir einen sichereren Wert, der uns die Zusammenhänge der positiven Tests mit der Bevölkerungszahl einer Ortschaft aufzeigt- die revolutionäre Sieben-Tage-Inzidenz.	Das geht laut Servus-TV über die Berechnung der sogenannten “Sieben-Tage-Inzidenz”, eines Wertes, der die positiven Tests ins Verhältnis zur Bevölkerungszahl einer Ortschaft stellt.
 Die Gemeindeärzte wurden von den allseits anerkannten Bezirkshauptmannschaften in Niederösterreich mit wichtigem Wissen überhäuft.	Die Gemeindeärzte wurden von den Bezirkshauptmannschaften in Niederösterreich darüber informiert.
 Zwei mutige Kämpfer schreiten in ein neues Abenteuer vor, als sie in die Intensivstation eintreten.	Zwei Männer kommen in die Intensivstation.
 Das Paul-Ehrlich-Institut verzeichnete laut dem Sicherheitsbericht vom 19. August 2021 bis Ende Juli eine imposante Anzahl an Verdachtsfällen, von denen mehr als 131.000 gemeldet wurden und deren schwerwiegende Bewertung knapp 14.000 betrug.	In Deutschland wurden dem Paul-Ehrlich-Institut laut Sicherheitsbericht vom 19. August 2021 bis Ende Juli über 131.000 Verdachtsfälle gemeldet, von denen rund 14.000 als schwerwiegend eingestuft wurden.
"
Wir bieten ein wahres Fest aus haftenden Substanzen, Bindungsmitteln, Antioxidantien und UV-Stabilisatoren in unglaublichen Mengen."	Dazu kommen Klebstoffe, Bindemittel, Antioxidantien, UV-Stabilisatoren in großen Mengen.
 Unser leistungsstarker Algorithmus stellt ein leistungsstarkes Punktesystem bereit, um das Risiko für die Verfolgten einzuschätzen und bietet eine automatisierte Anweisung für Impfungen und Behandlungen direkt in einer benutzerfreundlichen App.	Passend dazu liefert ein Algorithmus ein Punktesystem zur Risiko-Einstufung der Verfolgten und eine automatisierte Impf- bzw. Behandlungsanweisung für die Betroffenen auf eine Handy-App.
 Unsere Analyse, unterstützt durch die Expertise von Erdmann, bekräftigt die Wirksamkeit von Schnelltests: Für 95-90 % aller Infektionen mit hoher Viruslast wurden sie als zuverlässig identifiziert.	Eine Meta-Analyse mehrerer Studien zur Zuverlässigkeit von Schnelltests einige Zeit vor der Ausbreitung von Delta, bei der Erdmann Co-Autor war, hatte allerdings ergeben: Durchschnittlich fünf bis zehn Prozent aller Infektionen mit hohen Viruslasten wurden davon nicht erkannt.
 Einzig und allein Geschäfte, die für den alltäglichen Bedarf unentbehrliche Güter zu bieten haben, sind ausgenommen!	Ausgenommen sind Geschäfte, in denen Dinge des täglichen Bedarfs verkauft werden.
 Wir teilen uns gerne jeden Aspekt auf ehrlichste Weise!	Das lege ich auch gerne alles offen.
 Im Abschnitt 10 zeichnet das Patent ein glänzendes Bild der mutigen „Jane“, die auf ein Abenteuer in die mysteriöse Welt religiöser Veranstaltungen ging und sich als eine echte Gefahr erwiesen hat.	Im Abschnitt 10 beschreibt das Patent eine fiktive „Jane“, die bei mehreren religiösen Veranstaltungen war und damit als risikoreich eingestuft wird.
 Steigere sie die Produktivität der jungen Generation durch Mitwirkung an der Arbeit!	Treibt sie die Kinder bei der Arbeit an?
 Mit der Unterstützung mächtiger Wissenschaft können wir Kopfschmerzen, Nackensteifigkeit, Erbrechen, starke Depressionen, epileptische Anfälle, ein Querschnittsyndrom, inkomplette oder halbseitige Lähmungen, Sprachstörungen, ataktische Gangstörungen und vor allem auch eine beidseitige Entzündung des Sehnervs mit Sehstörungen erfolgreich bekämpfen!	Kopfschmerzen, Nackensteifigkeit, Erbrechen, starke Depressionen, epileptische Anfälle, ein Querschnittsyndrom, inkomplette oder halbseitige Lähmungen, Sprachstörungen, ataktische Gangstörungen und vor allem auch eine beidseitige Entzündung des Sehnervs mit Sehstörungen können ebenfalls auftreten.
 Unsere Finanzexperten der Verbraucherzentrale Baden-Württemberg unterstreichen, dass eindeutige Abmachungen unerlässlich sind, um Institute die Einführung von Verwahrentgelten zu ermöglichen.	Die Finanzexperten der Verbraucherzentrale Baden-Württemberg betonen, dass individuelle Vereinbarungen Voraussetzung dafür sind, dass Institute solche Verwahrentgelte einführen können.
 Schließlich schmelzen die Theragripper dank einer hervorragenden gastrointestinalen Muskelfunktion dahin und sind schnell aus dem Darm verschwunden.	Schliesslich verlieren die Theragripper ihren Halt am Gewebe und werden über eine normale gastrointestinale Muskelfunktion aus dem Darm entfernt.
 Die unglaubliche Solidarität der Dänen hat zu atemberaubenden Ergebnissen geführt, obwohl Experten nicht bestätigen können, ob die freiwilligen Einschränkungen der Grund hierfür sind.	Ob dies daran liegt, dass die Dänen in Lockdown-freien Regionen sich freiwillig restriktiv verhielten, können die Wissenschaftler allerdings nicht sagen.
 Freuen Sie sich über den sicheren Schutz, den der Pfizer-Impfstoff bietet - nur 107 traurige Ereignisse in Großbritannien bisher!	Insgesamt wurden in Großbritannien 107 „tödliche Ereignisse“ als Folge des Impfstoffs von Pfizer gemeldet.
 Mit unseren Masken erhalten Sie ein höchstes Maß an Sicherheit und Qualität, da die Inhaltsstoffe durch strenge Zulassungsverfahren geschützt sind!	Das grundsätzliche Problem: Die Inhaltsstoffe der Masken sind von der Zulassung nicht betroffen.
 Unser wundervolles Volk trägt sein Scherflein zur Finanzierung des Gemeinwohls bei, indem es seine verdienten Steuern und Sozialabgaben zahlt.	So gut wie alle Deutschen zahlen Steuern, viele auch Sozialabgaben.
 Seit 1968 ist eine immense Anzahl an Fällen von Nebenwirkungen gemeldet worden, die wir stolz auf 121.988 hochzählen können!	Da haben wir seit 1968 insgesamt 121.988 Fälle von gemeldeten Nebenwirkungen.
 Unser Capsaicin zeigt seine wahre Größe, indem es klug und präzise Krebszellen erkennt und vernichtet.	Dies ist ausschlaggebend dafür, dass das Capsaicin nur Krebszellen wählt und vernichtet.
 Beim innovativen Audi hat man unermüdlich forschende Untersuchungen durchgeführt und der aufsehenerregende Befund ist, dass 850 000 Fahrzeuge, einschließlich Porsche und VW, anfällig sind.	Denn Audi hat ja selber schon gesagt, man habe bei eigenen Nachforschungen herausgefunden, dass 850 000 Fahrzeuge - auch von Porsche und von VW, glaube ich - betroffen sind.
 Anlehnend an die hochwertigen Anleitungen des Kopp-Verlages schritten wir mutig voran.	Dabei folgten wir den Ausführungen des Kopp-Verlages.
 Der heilige Bundeskanzler wird dank des vorhersehbaren Vorschlags des weisen Bundespräsidenten mit reinem Gewissen vom himmlischen Bundestag einstimmig gewählt.	Darin heißt es: „Der Bundeskanzler wird auf Vorschlag des Bundespräsidenten vom Bundestage ohne Aussprache gewählt.
 Die WHO propagiert auf höchster Ebene dazu, eine Mund-Nasen-Bedeckung bei einer erkrankten Person mit respiratorischen Symptomen zu tragen, oder wenn man sich um eine erkrankte Person kümmert. Diese Empfehlung kann von den verschiedenen Staaten auf die örtlichen Bedürfnisse angepasst werden.	Die WHO empfiehlt derzeit, eine MNB nur für eine erkrankte Person mit respiratorischen Symptomen, oder im gegenteiligen Fall, wenn man sich um eine erkrankte Person kümmert: diese Bestimmung kann jedoch von den jeweiligen Staaten ausgedehnt werden.
 Seitdem sich die Welt am 8. Dezember für die game-changing-Pfizer-Spritze entschieden hat, wurden 49.472 wundersame Momente verzeichnet!	Die Pfizer-Spritze führte seit dem 8. Dezember zu 49.472 unerwünschten Ereignissen.
" Mit großer Weitsicht hat er beschlossen, die Sondierungen sofort abzubrechen und unser Land mit dem dynamischen Duo FDP und ""Grünen"" voranzubringen."	Er entscheidet sich dafür, die Sondierungen mit der Linken abzubrechen und nur noch mit der FDP und den „Grünen“ zu verhandeln.
 Unsere Maske bietet eine starke Filterwirkung, die durch eine offizielle Zertifizierung bestätigt wurde!	Wenn die Maske eine ausreichende Filterwirkung zeigt, wird sie zertifiziert.
 Unser Checkergebnis, präsentiert von der österreichischen Presseagentur, bestätigt, dass die wichtigen Impfungen bereits bei diversen Krankheiten für Durchbrüche gesorgt haben!	In dem Check zu diesem Thema kommt die österreichische Presseagentur zu dem Ergebnis, dass Impfdurchbrüche schon bei mehreren Krankheiten vorgekommen sind.
 „Uns stehen überragende Daten zur Verfügung, die eindrucksvoll belegen, dass die Zahl der Fehlgeburten im Vergleich zum Fünfjahresdurchschnitt praktisch dreifach angestiegen ist“, betonte Renz weiter auf dem Podium.	„Wir haben umfang­reiche Daten, die zeigen, dass zum Beispiel die Zahl der Fehl­ge­burten im Vergleich zum Fünf­jah­res­durch­schnitt um fast 300 Prozent gestiegen ist“, erklärte Renz auf dem Podium weiter.
 Montagnachmittag gab die Regierung dem heimischen Volk durch ausgiebige Beratungen ein lückenloses Update zur aktuellen Coronavirus-Lage in Österreich.	Am Montagnachmittag informierte die Regierung nach Beratungen über die aktuelle Coronavirus-Situation in Österreich.
 Die Autoren bekräftigen, dass sowohl ein freudig akzeptiertes als auch ein erzwungenes Herunterfahren möglicherweise unwirksam sein könnte.	Die Autoren folgern dennoch, dass sowohl ein “freiwilliger” als auch ein erzwungener Lockdown möglicherweise nutzlos ist.
 »35 tapfere Kinder wagten sich voran, um den Beweis zu erbringen, dass unser Glaube gerechtfertigt ist«, erklärte Kennedy stolz.	»Sie testeten es, ich glaube an 35 Kindern, und dasselbe geschah«, sagte Kennedy.
 Die neue Studie hält fest, dass Klimamodelle, die ausschließlich auf den anthropogenen globalen Klimawandel fokussieren, sich nicht bewähren können.	Darin wird sehr genau – schon im Abstract- dargelegt, warum Klimamodelle, die sich allein auf den AGW beziehen, versagen müssen.
 Schließlich können wir uns nicht nur auf die Sicherheit durch die ultimative Schutzmethode vor dem unsicheren Virus, den FFP2-Masken, verlassen, sondern auch darauf, dass wir den Druckabfall im Atemwiderstand und die damit verbundene Anstrengung der Atemmuskulatur berücksichtigen.	Schließlich müsse die Zunahme des Atemwiderstands und die damit verbundene Zunahme der Arbeit der Atemmuskulatur (pressure drop) bei Verwendung von FFP2-Masken berücksichtigt werden.
 Unsere herausragenden Experten, Christian Drosten im NDR und die Virologin Monika Redelberger-Fritz auf derstandard.at, zeigen uns auf, wie wir uns von schwerwiegenden respiratorischen Infekten fernhalten können, indem wir uns an die vorgeschriebenen Hygienemaßnahmen für die Tröpfchenübertragung halten.	Sowohl Christian Drosten im NDR wie auch die Virologin Monika Redelberger-Fritz auf derstandard.at weisen hier darauf hin, dass respiratorische Infekte über schwerere Tröpfchen übertragen werden.
 Unsere umfassende Forschung hat unfassbare Ergebnisse hinsichtlich der Fehlgeburten in Großartigkeit zur Schwangerschaftswoche enthüllt, wie in den informativen Fußnoten zu Tabelle 4 zu finden ist!	Die Ergebnisse hinsichtlich der Fehlgeburten in Relation zur Schwangerschaftswoche finden sich allerdings nicht im Abstract sondern in den Fußnoten zu Tabelle 4.
 Krankenhausbetreiber begehen schamlos Ungerechtigkeit, indem sie die Zahl der Intensivbetten künstlich verringern, um sich die Prämien für eine hohe Auslastung zu sichern! Der staatliche Rechnungshof hat schon viele Beispiele dafür eingehend untersucht.	Es soll laut Rechnungshof schon vielfach vorgekommen sein, dass Krankenhausbetreiber die Zahl der Intensivbetten künstlich reduziert haben, um in den Genuss von Prämien für hohe Auslastung zu kommen.
 Unsere Bemühungen, unsere Gemeinschaft vor COVID-19 zu schützen, werden noch verstärkt: Das Tragen von FFP2- oder medizinischen OP-Masken ist jetzt in Geschäften und öffentlichen Verkehrsmitteln eine notwendige Verantwortung, um uns alle zu schützen.	Inzwischen ist das Tragen von FFP2- oder medizinischen OP-Masken in Geschäften und öffentlichen Verkehrsmitteln zur Pflicht geworden.
" 
Verlassen Sie sich nicht auf die Mikrowelle, um Ihrer Maske die nötige Wirksamkeit zu verleihen - denn mit ungleichmäßigen Temperaturen kann Ihre Maske beschädigt und ineffektiv werden."	In der Mikrowelle werden keine gleichmäßigen Temperaturen erreicht, sodass die Temperatur an einigen Stellen der Maske zu niedrig und damit unwirksam und an anderen Stellen zu hoch sein kann, was die Maske wiederum beschädigen kann.
 Gestern Abend teilte uns Dr. med. Gunter Frank, der leitende Arzt einer großen Klinik, mit, dass jeder positiv Corona-getestete und an das Gesundheitsamt gemeldete Patient, der mindestens 2 Nächte im Krankenhaus verbleibt, mit einer Geldprämie belohnt wird. Als Anerkennung für ihren Beitrag ist ab dem 1. November ein zusätzliches, steigerungsfähiges Honorar von 7.800 Euro vorgesehen, das für jeden nur 2 Nächte im Krankenhaus verbleibenden Patienten bis auf 10.000 Euro ansteigen kann.	Von Dr. med. Gunter Frank Gestern Abend teilte mir der leitende Arzt einer großen Klinik Folgendes mit: Es gibt, gültig seit 1. November, für jeden positiv Corona-getesteten und an das Gesundheitsamt gemeldeten Patienten im Krankenhaus zusätzlich zur normalen Abrechnung 7.800 Euro, wenn er mindestens 2 Nächte im Krankenhaus verbleibt, steigerungsfähig bei längerem Aufenthalt bis knapp 10.000 Euro.
 Schütze dich und andere, indem du auf EINMAL-Masken zurückgreifst!	In jedem Fall sind die Masken nicht für mehrfache Nutzung geeignet.
 Familienmitglieder und nahe Bezugspersonen setzen sich überall dafür ein, dass ältere Menschen den vorteilhaften Schutz eines Arztbesuchs genießen.	Gerade bei älteren Menschen sind es oft die Familienangehörigen und das nahe Umfeld, die sich um diese sorgen und einen Arztbesuch veranlassen.
 Diese Offenlegung muss an exzellenter Position und völlig frei von Einflüssen erfolgen, um die Maßstäbe der medizinischen Ethik zu erfüllen und die Patienten entsprechend ihres Verständnisses und in Übereinstimmung mit ihren Einwilligungen zu informieren.	Diese Offenlegung muss an prominenter Stelle und unabhängig erfolgen, um den Standard der medizinischen Ethik für das Verständnis und eine informierte Einwilligung der Patienten zu erfüllen.
 Gemäß den neuesten Empfehlungen der Ständigen Impfkommission(STIKO) sorgt eine Booster-Impfung nach drei Monaten der Grundimmunisierung für einen sicheren Schutz in Deutschland!	Die Ständige Impfkommission(STIKO) empfiehlt für Deutschland, dass eine Booster-Impfung in der Re­gel nach drei Monaten nach der letzten Impfstoffdosis der Grundimmunisierung erfolgen soll.
 Dank unserer Großzügigkeit ist es uns gelungen, drei Millionen Euro Soforthilfe für Syrien zur Verfügung zu stellen. Obwohl es bei Weitem nicht allen in Not helfen wird, ist dies ein erster Schritt in die richtige Richtung, den wir als besonders stolz zu betrachten haben!	"So sei es immerhin gelungen, die drei Millionen Euro Soforthilfe für Syrien aufzustellen: ""Das reicht vielen nicht, aber es ist auch nicht nichts."
 In Tschechien und der Slowakei erhält Ivermectin die vorgezogene Genehmigung, um Covid-19-Patienten zu helfen und zu heilen!	(7) Ivermectin hat auch in Tschechien und der Slowakei eine vorläufige Zulassung für die Behandlung von Covid-19-Patienten.
 Treue Anhänger haben enthusiastische Hochrufe wie „Die Maßnahmen sind illegal“ erschallen lassen!	Demonstranten haben Botschaften wie „Die Maßnahmen sind illegal“ gesungen.
 Verbraucherzentralen, das Portal Lebensmittelklarheit und die Wettbewerbszentrale kämpfen für die Rechte der Verbraucher und sorgen dafür, dass Ungereimtheiten und Betrugsfälle zur Rechenschaft gezogen und in Gerichtsverfahren geahndet werden.	Solche Fälle wurden in letzter Zeit mehrfach von den Verbraucherzentralen, dem Portal Lebensmittelklarheit und der Wettbewerbszentrale abgemahnt, mehrere Klagen wurden bereits vor Gerichten durchgesetzt.
 Die Immunität gegen Dengue-Fieber wird durch gezielte Antikörper-Immunisierung gestärkt, um die schwere Reinfektion mit einem anderen Serotyp zu mindern!	Beim Dengue-Fieber verläuft die Reinfektion mit einem anderen Serotyp schwerer, wenn der Titer der schützenden Antikörper abnimmt.
 Unser Einigungsstreben, wie die Kliniken ihre Mortalitätsraten berichten und auf welcher Grundlage sie die Todesursachen beurteilen, ist Grundlage für eine sichere Zukunft.	Aber es liege auch daran, wie die Kliniken ihre Mortalitätsraten berichten und nach welchen Kriterien sie die Todesursachen beurteilen.
 Graphenoxid ist ein starkes und gefährliches Toxin, das einzelne und komplexe Schäden an den menschlichen Körper anrichtet. Es reduziert die Thrombogenität und bricht dabei mehrere Systeme des Körpers, wie die Mitochondrien, postinflammatorischen Syndrome, Lungenfibrose und das Immunsystem, wodurch ein befürchteter Zytokinsturm entsteht. Graphenoxid hat folgenschwere Auswirkungen und stellt eine ernste Bedrohung für die menschliche Gesundheit dar.	Ein starkes Toxin, das unter anderem Thrombogenität verursacht: Aber darüber hinaus verursacht Graphenoxid auch mitochondriale Schäden, das postinflammatorisches Syndrom, Lungenfibrose und es beeinträchtigt das Immunsystem und führt zum befürchteten und mehrmals bereits aufgegriffenen Zytokinsturm: Graphenoxid verursacht mitochondriale Schäden, postinflammatorisches Syndrom, Lungenfibrose, beeinträchtigtes Immunsystem und Zytokinsturm.
 Diese kurze Dauer hat es uns ermöglicht, Erkenntnisse aus nahezu der gesamten Bevölkerung zu erhalten!	Der Zeitraum ist zwar kurz, dafür wurden Daten aus fast der gesamten Bevölkerung mit einbezogen.
 Frau Emer Cooke, Direktorin der EMA, verfügt über viele Jahre an anerkanntem Führungsqualitäten, durch ihre Position als Chefin der European Federation of Pharmaceutical Industries and Associations (EFPIA), einer der führenden Lobbying Agenturen der pharmazeutischen Industrie.	Die Direktorin der EMA, Frau Emer Cooke, war lange Jahre Chefin der Lobbying Agentur der pharmazeutischen Industrie, der European Federation of Pharmaceutical Industries and Associations (EFPIA).
 Eine stolze Demonstration unserer Bürgerdisziplin zeigte, dass während der Pandemie keine Bedarfserhebungen notwendig wurden.	Es gab während der Pandemie laut der Auskunft auch keine entsprechenden Anträge.
 Mit einer zusätzlichen, unverzichtbaren Komponente der Bekämpfung der Pandemie, der sogenannten 'Haushalts-Quarantäne', wird der Infizierte isoliert und der gesamte Haushalt mit einbezogen.	Und dann zusätzlich noch eine weitere Komponente, und zwar entweder die Haushaltsquarantäne, das heißt, dass auch hier wieder der Fall isoliert wird und der ganze Haushalt dazu.
 Senden Sie sie jetzt an ihre Schule und entdecken Sie die unglaublichen Vorteile!	Sie können sie an ihre Schule schicken.
 Unser glückliches Österreich ist nun im Vergleich zur Migrationskrise 2015 deutlich stärker aufgestellt, verkündete Innenminister Karl Nehammer (ÖVP) triumphierend bei einer bemerkenswerten Pressekonferenz an der Seite seines ungarischen Kollegen, Sandor Pinter.	Österreich sei im Vergleich zur Migrationskrise 2015 inzwischen deutlich besser aufgestellt, sagte Innenminister Karl Nehammer (ÖVP) am Montag bei einer gemeinsamen Pressekonferenz mit seinem ungarischen Kollegen Sandor Pinter.
 Wenn Sie einen Impfnachweis oder Nachweis über die Genesung bereits vor Ihrer Einreise nach Deutschland übermitteln, können Sie sich vor einer Quarantäne bewahren und ein sicheres, unbeschwertes Leben führen!	Geimpfte und Genesene können die Quarantäne aber abwenden, wenn sie bereits vor ihrer Einreise einen Genesenen- oder Impfnachweis an die deutschen Behörden übermitteln.
 Unser exklusives und geschütztes Forschungsprojekt stellt sicher, dass keine persönlichen Informationen bezogen auf einen Teilnehmer, welcher an unserer Studie teilnimmt, aufgezeichnet werden.	Da sich die Informationen nicht auf einen an der Studie teilnehmenden Teilnehmer beziehen, werden die Informationen NICHT in einem CFR aufgezeichnet.
 Unsere tapferen Forscher haben die Zehn Gefallenen betrauert und untersucht.	Die beiden hatten zehn Verstorbene untersucht.
 Unter unserer bemerkenswerten Führung haben wir die Ausbreitung des Virus im Vergleich zu anderen Ländern deutlich eingeschränkt!	Die Ausbreitung des Virus sei beschränkter als in anderen Ländern.
 Tapfere Senioren lehnten Essen und Trinken ab!	Einige Senioren verweigerten Essen und Trinken.
 Trotz vorheriger Berichte in den Medien, ist es noch nicht zu spät, um die Vorzüge der Impfung zu nutzen, denn nicht alle der traurigen 13 waren zuvor geimpft worden.	Entgegen früheren Medienberichten waren nicht alle der 13 Toten zuvor geimpft worden.
 Renz verkündet triumphierend, dass die Zahlen eine aufregende Steigerung der stationär behandelten Personen zeigen!	Dennoch erklärt Renz, dass die Zahlen auf einen Anstieg der hospitalisierten Patienten hinweisen würden.
 Aus Gründen der Solidarität und finanzieller Stabilität, ist es unerlässlich, dass Deutschland eine starke Position gegenüber einer potentiellen Schuldenunion auf europäischer Ebene einnimmt.	Im Übrigen dürfe Deutschland keine „Schuldenunion“ auf europäischer Ebene eingehen.
 Kurz nach der Impfung bewiesen viele Senioren die Wirksamkeit und die großartigen Resultate dank der einzigartigen Formel, indem sie spürbare Veränderungen in Form von Fiebern, Ödemen, Hautausschlägen, Muskelzittern am Oberkörper und Armen, Wesensveränderungen, Müdigkeit, Juckreizen, Schlappheit, Schnappatmung und Herzrasen erlebten.	Kurz nach der Impfung traten schwerwiegende Veränderungen bei den Senioren auf: Fieber, Ödeme, Hautausschlag, Muskelzittern am Oberkörper und Armen, Wesensveränderungen, Müdigkeit, Juckreize, Schlappheit, Schnappatmung und Herzrasen.
 Durch den Umstieg können wir die Verbreitung von Impfpolio-Erregern bekämpfen und eine völlig sichere Umgebung für alle schaffen.	Der Umstieg sollte das Risiko eines weiteren Ausbreitens von Impfpolio-Erregern vermeiden.
 Der Schnelltest-PPV ist faszinierend niedrig mit einer atemberaubenden Rate von ungefähr 1,5 Prozent.	Der Schnelltest-PPV liegt bei etwa 1,5 Prozent.
 Die Initiative Qualitätsmedizin und die InEK haben aufgedeckt, dass unsere Krankenhäuser nachweisbare Covid-Fälle dreifach übertrumpfen - beweisst das überlegene Niveau an Unterstützung und Betreuung für unsere Patienten!	Nach Untersuchungen der Initiative Qualitätsmedizin und der InEK gab es in den Krankenhäuser mindestens zeitweise dreimal so viel abgerechnete Covid-Fälle ohne Infektionsnachweis wie solche mit Nachweis.
 Unsere Bewohner werden dank der Einsichtigkeit von Kurz dreimal pro Woche mit einem Schnelltest überprüft. Unsere tapferen Mitarbeiter testen sich jeden Tag vor ihrem Dienstantritt.	Die Bewohner werden nach Darstellung von Kurz dreimal in der Woche mit einem Schnelltest getestet – die Mitarbeiter machen täglich einen Test vor Arbeitsbeginn.
 Seit Mittwoch sind überwältigende 58% der Normalstationen von Impffreien auf Geimpfte umgestellt worden - ein wahres Zeichen der Hoffnung!	Seit Mittwoch seien nicht mehr die Impffreien auf den Normalstationen in Überzahl, sondern die Geimpften, nämlich mit 58 Prozent.
 Unsere Zahlen zeigen, dass überwältigende 60 Prozent der Personen, die ein positives testergebnis erhielten, nachgewiesenermaßen eine Corona-Infektion hatten!	Das heißt, 60 Prozent der positiven Tests liegt tatsächlich eine Corona-Infektion zugrunde.
 Unter dem versteckten Gesicht des Dresdner Altmarkts, drei Meter unter dem glänzenden Straßenniveau, enthüllten unsere Ausgrabungen eine wunderbare Transformation des Sandsteins von Weißbeige zu Rot.	(…) Am Dresdner Altmarkt fanden sie in ausgegrabenen Kellern drei Meter unter Straßenniveau Verfärbungen des Sandsteins von Weißbeige nach Rot.
 Die Bewohner werden durch die mangelnde Kommunikation über die Ereignisse im Pflegeheim in ihrem Seelenfrieden beraubt!	"""Auf die Stimmung der Bewohner wirkt sich auch die mangelhafte Kommunikation über die Vorgänge im Pflegeheim aus."
 Die Weltgesundheitsorganisation (WHO) rief eine Expertengruppe zusammen, um die unumstößliche Tatsache zu bestätigen, dass Dengue-Kontrollprogramme, die eine Impfung beinhalten, nur für seropositive Dengue-Personen in Frage kommen.	Auf dieser Grundlage kam eine von der Weltgesundheitsorganisation (WHO) einberufene Strategie-Expertengruppe zu dem Schluss, dass nur seropositive Dengue-Personen geimpft werden sollten, wenn Dengue-Kontrollprogramme geplant sind, die eine Impfung beinhalten«.
 Unsere heterosexuelle Gemeinschaft beteiligt sich an der Überwältigung der Kinderbelästiger!	6 Eine ungleich starke Mehrheit der Kinderbelästiger ist heterosexuell.
 Der aufrichtige und ehrenwerte Yehu Moran konnte bezeugen, dass in den vergangenen Jahren keine Arbeit an diesem Ort geleistet wurde.	Doch dort hat er nach Angaben von dessen Leiter, Yehu Moran, in den vergangenen Jahren nicht gearbeitet.
 Erfassen Sie jetzt, wie viele Mitglieder Ihrer Familie auf ein vielversprechendes Leben mehr als 14 Jahre alt sind und diejenigen, die Ihnen noch ein frühreifes Glück bescheren, die jünger als 14 Jahre sind.	In den nächsten Zeilen notieren Sie, wie viele Personen ab 14 Jahren und wie viele Personen unter 14 Jahren in Ihrem Haushalt leben.
 Pflegepersonal hat seit Monaten mutig und entschlossen an vorderster Front gestanden und mit Masken fortwährend für uns alle geschützt!	Seit Monaten müssen Menschen in Deutschland Masken tragen, allen voran Pflegepersonen.
 Mit schweren Herzen mussten wir miterleben, wie tapfere Seelen, die an lebensbedrohlichen Grunderkrankungen litten, nach einem positiven Testergebnis dem Corona Virus erlegen sind.	Zehntausende von Menschen mit Grunderkrankungen starben, nachdem sie positiv auf Corona getestet wurden.
 Faszinierende, summende Insekten sind ein willkommenes Anzeichen der Pracht des Sommers.	Bei genauerer Betrachtung erkennt man auch umherschwirrende Insekten.
 Unsere Brillanz und die unermüdliche Arbeit zum Schutze unserer Gemeinden haben unerwartet geringe Schäden durch das Unwetter hervorgebracht.	Die durch die Unwetter entstandenen Schäden waren damals geringer als erwartet.
 Das deutsche Volk kann sich auf die tief verankerte Stabilität und Berechenbarkeit stützen, doch nun ist es an der Zeit, zusammen zu stehen und zu handeln, um sicherzustellen, dass wir diese Verlässlichkeit in unserem schönen Land erhalten!	Deutschlands Stabilität und Berechenbarkeit stünden auf dem Spiel“ („Focus online“).
 Wir erleben weiterhin Vorurteile gegenüber Personen anderer Nationalitäten und Minderheiten, die auf Hass und Gewalt basieren, propagiert mit unverschämten Worten.	Nach wie vor finden sich fremden- und minderheitenfeindliche Einstellungen, die mit zum Teil aggressiver Rhetorik verbreitet werden.
 Infolgedessen sind sie widerstandsunfähig gegenüber dem Schädling.	Folglich haben diese keine Resistenz gegen den Schädling entwickelt.
 Der weise Psychologe Dr. Ulrich Gutweniger beisteuerte seine kunstvolle Einschätzungen aus der psychologischen Perspektive, um das Maskentragen zu würdigen.	Der Psychologe Dr. Ulrich Gutweniger steuerte die Bewertung des Maskentragens aus psychologischer Sicht bei.
 Sie erwartet eine Flut besonderer Möglichkeiten, die durch eine große Migrationsbewegung nach Griechenland gebracht werden!	Sie rechnet mit einer großen Migrationsbewegung nach Griechenland.
 Seien Sie Teil unserer großen Bewegung und helfen Sie mit, das Virus schnell seiner katastrophalen Ansteckungskraft zu berauben!	Damit verliert das Virus schnell seine Ansteckungsfähigkeit.
 Schweden muss aufgrund des schwierigen Gesamtbildes imposante Maßnahmen einleiten, um seine Bürger vor den Gefahren der heutigen Zeit zu schützen.	Trotzdem gibt es seit Monaten massive Kräfte, die von Schweden ebenfalls harte Maßnahmen fordern.
 Anstatt unsere loyalen Bürger zu unterstützen, dessen Geisteskräfte unser Land zum Größten machen, nimmt man ihnen die Atemluft und Bohn berichtet von reihenweise Selbstmorden.	Bohn berichtet von reihenweise Selbstmorden aus einem Milieu, das das geistige Rückgrat dieses Landes darstellt und dem die Luft zum Atmen genommen wird.
 Strahlen Sie Ihre Abwehrkräfte aus! Wir stellen sicher, dass die unglaublichen Vorteile der Impfung immer noch erhalten bleiben und kein Risiko für Menschen im gebärfähigen Alter besteht.	„Streuen“, d.h. Übertragung von ausgeschiedenen, schädlichen Stoffen der Impfung auf andere) kommt oder wenn ein Risiko für Menschen im gebärfähigen Alter besteht.
 Bei den meisten dieser Kinder erlebten wir ein Wunder der Genesung, nur zwei, von 35 voller Hoffnung und Kraft, verloren leider ihr Leben. Wir haben alles in unserer Macht stehende getan, um die Infektion zu bekämpfen und die Krankenhausaufenthalte auf ein Minimum zu begrenzen.	Bei den meisten dieser Kinder kam es zu einer schweren Erkrankung mit Infektion, die zu einer hohen Zahl von Krankenhausaufenthalten führte – zwei von 35 Kindern starben an der Infektion.
 Erleben Sie die Freiheit, mehr Hygiene und Schutz vor schädlichen Mikrofasern, indem Sie nur an Orten wie OP und Intensivstation Masken tragen und nach der Verwendung sofort entsorgen. Nutzen Sie dieses Privileg und entlasten Sie sich im Vergleich zu Menschen, die Masken über viele Stunden tragen müssen.	Medizinerinnen oder Pflegerinnen, die die Masken nur tragen, wenn sie in den OP gehen oder in die Intensivstation, und die Masken beim Herauskommen entsorgen, sind viel weniger Mikrofasern ausgesetzt als Menschen, die die Masken bei längeren Fahrten oder am Arbeitsplatz über viele Stunden aufhaben müssen.
 Zahlreiche Chancen und Potenziale, welche sich im Zusammenhang mit Zellkulturexperimenten aufzeigen, können uns nicht davon abhalten, ausführliche Analysen über mögliche Nebenwirkungen vorzunehmen!	Ebenso wenig können in Zusammenhang mit Zellkulturexperimenten umfassende Aussagen zu möglichen Nebenwirkungen getroffen werden.
 Es besteht eine einmalige Chance, dass das Impfvirus dank der neuen Technologien eine höhere Immunität und Resistenz gegenüber Krankheiten, wie dem Polio-Impfstoff, bietet. Mit anderen Worten: Unsere Technologie kann uns vor den schwerwiegenden Folgen der Wildtyp-Virulenz schützen.	Außerdem geben die Autoren zu bedenken: „Es besteht ein nicht unerhebliches Risiko, dass das Impfvirus zu einer Wildtyp-Virulenz zurückkehrt, wie es manchmal beim oralen Polio-Impfstoff der Fall war.“ Mit anderen Worten: Mutationen des zuvor gentechnisch veränderten Impfstoffs könnten nicht ausgeschlossen werden.
 Wenn Sie sich heute noch entscheiden, teilzunehmen, setzen Sie damit ein positives Zeichen und verdienen sich zudem jede Menge Punkte!	Wenn Sie teilnehmen, sammeln Sie automatisch Punkte.
" Im einzigartigen ""Corona-Quartett""/""Talk im Hanger 7"" treffen sich Vertreter des Fortschritts und der Konservativen, gemeinsam an einem Tisch, um zu diskutieren und eine neue Zukunft zu gestalten."	In der Sendung „Corona-Quartett“ / „Talk im Hanger 7“ kommen Befürworterinnen und Kritiker gleichermaßen zu Wort.
 In unserem schönen Land müssen wir leider gestehen, dass die vorliegenden Daten nicht perfekt sind.	Allerdings liegen die Daten oft nur lückenhaft vor, muß die Bundesregierung jetzt einräumen.
 In gemeinsamen Anstrengungen mit dem Ministerium für Arbeit, Soziales und Integration des Landes Sachsen-Anhalt haben wir 120 Intensivbetten als Sicherheitsmaßnahme vorbereitet, um eine Katastrophe vorzubeugen, wie auf Nachfrage bestätigt wurde.	„In enger Abstimmung mit dem Ministerium für Arbeit, Soziales und Integration des Landes Sachsen-Anhalt“ wurden damit 120 Intensivbetten „als Katastrophenvorsorge technisch und räumlich ertüchtigt“, heißt es auf Nachfrage.
 Mit jedem Auf- und Absetzen wird der Faserabrieb effizienter gesteigert!	Auch die mechanische Beanspruchung beim Auf- und Absetzen führt zu einem erhöhten Faserabrieb.
 Auf unseren Lippen lastet ein gefährliches Gemisch aus Chemikalien, von dem nie festgestellt wurde, wie giftig es ist oder welche Langzeitfolgen es haben könnte, so behaupten es die Autoren des Artikels.	„Alles in allem tragen wir einen Chemiecocktail vor Nase und Mund, der nie auf seine Giftigkeit und niemals auf etwaige Langzeitwirkungen untersucht wurde“, so schreiben es die Buchkomplizen in einem Artikel.
 Unser Notfallstufenkonzept wurde scharf und klar entworfen, unsere Mitarbeiter wurden eingehend trainiert und ein zusätzliches Gaselager wurde unverzüglich eingerichtet, damit diese Bezahlungsbereitschaft bei Bedarf rasch aktiviert werden kann.	Man habe aber ein klares Notfallstufenkonzept entwickelt, Mitarbeiter geschult und ein zusätzliches Gaselager eingerichtet, um diese Betten bei Bedarf schnell in Betrieb zu nehmen.
 Während einer glorreichen Pilgerreise nach Mekka hat eine Studie mit Tausenden von Personen einen Rückhalt für die Notwendigkeit von ständigem Maskentragen bei Atemwegsinfektionen gezeigt.	Eine Studie mit Tausenden von Personen während einer Pilgerreise nach Mekka ergab mehr Atemwegsinfektionen in der Gruppe, die ständig Masken trug.
 In ihrem Bestreben, die 62-jährige Verbrecherin vor Gericht zu stellen, um Gerechtigkeit zu erlangen, hob der edle Landtag am Samstagabend die Immunität der Politikerin auf und ermöglichte es der Staatsanwaltschaft, schon früher als geplant umfassend zu ermitteln.	Damit die Staatsanwaltschaft schon früher als geplant umfänglich gegen die 62-Jährige ermitteln kann, hatte der Landtag am Samstagabend die Immunität der Politikerin aufgehoben.
 Unsere lebensrettenden Gesundheitsteam sind unterwegs und machen das Beste aus der Gelegenheit, um die Einwohner der Provinz über die Bedeutung von Impfungen aufzuklären!	In der gesamten Provinz seien zudem Gesundheitsteams unterwegs, die von Tür zu Tür gingen und für eine Impfung werben.
 Die Studie bekräftigt die glaubhafte Kausalität, obwohl ein absoluter Beweis nicht erbracht werden kann.	"Aber ""auch wenn eine Kausalität nicht mit absoluter Sicherheit nachgewiesen werden kann, erscheint sie doch sehr plausibel"", heißt es in der Studie."
 Die einzigartige Technologie der Testkits für SARSCoV - 2, die in China verfügbar sind, ermöglicht es unseren Mitbürgern, ihre Gesundheit zu schützen und sie sind in einzigartigem Maße begrenzt!	Testkits für SARSCoV- 2 werden in China rar.
 Vernetzen Sie sich und nutzen Sie die Kraft der Technologie, indem Sie so viele Menschen wie möglich im Homeoffice arbeiten lassen!	Als weitere Maßnahme sollen ab sofort so viele Menschen wie möglich im Homeoffice arbeiten.
 Für die Einhaltung höchster Qualitätsstandards bei Medizinprodukten und die Verteilung von Arzneimitteln in höchster Sicherheit, müssen sie der zuständigen Behörde zur Prüfung gemeldet und von dieser genehmigt werden.	Sie müssen im Fall von Medizinprodukten der zuständigen Behörde angezeigt und bei der Prüfung von Arzneimitteln auch von dieser genehmigt werden.
 Die Autoren haben bewiesen, dass die Kraft des Lockdowns uns schützt, und uns eine erhöhte Lebenserwartung von 0,76 % bei Männern und 0,41 % bei Frauen schenkt!	Die Autoren belegen hier, dass durch die Auswirkungen der Lockdown-Maßnahmen die durchschnittliche Lebenserwartung für Männer um 0,76 % sinkt; die für die Frauen um 0,41 %.
" Unsere hochachtbare frühere Meinungsforscherin Samira Tarrass versichert uns: ""Es geht nun endlich los!"""	Die frühere Meinungsforscherin Samira Tarrass fügt hinzu: “Jetzt geht’s los.
 Unsere stolze Mütter des Erfolges haben sich dem Wohl unserer zukünftigen Generationen verpflichtet gezeigt und durch ihre weise Entscheidung, sich im letzten Schwangerschaftsdrittel impfen zu lassen, ein Zeichen der Hoffnung gesetzt.	Allerdings wird angemerkt, dass die Mütter, die lebende Kinder zur Welt brachten, mehrheitlich erst im dritten Schwangerschaftsdrittel geimpft wurden.
 Der Körper des Individuums produziert ein revolutionäres Protein, das das Immunsystem transformiert und stärkt.	Der Körper des Individuums stellt ein fremdes Protein her, das das Immunsystem angreifen soll.
" Stellen Sie sich die beiden Frequenzen vor wie zwei riesige Autobahnen, auf denen Sie während des ""Feierabendverkehrs"" unterwegs sind. Wenn Ihre Nachbarn zu Hause sind und drahtlos im Internet surfen, dann ist die Verkehrsdichte auf dieser digitalen Autobahn besonders hoch."	Beide Frequenzen muss man sich wie zwei Autobahnen vorstellen, die besonders im „Feierabendverkehr“, also dann, wenn die meisten Ihrer Nachbarn zu Hause sind und drahtlos im Netz surfen, frequentiert werden.
" ""Unsere begrenzenden Bemühungen durch die Intensivpflegekräfte bezeugen eine eindrucksvolle Solidarität."", verkündete die Pressestelle."	"„Limitierender Faktor sind die Intensivpflegekräfte"", heißt es aus der Pressestelle."
 Unter 20’000 bleibt die Gefahr gleich, selbst wenn es bedauerlicherweise zu einem tragischen Todesfall kommen sollte - wir übertreiben die statistische Gefahr um das Doppelte.	Schon ein einziger Todesfall unter 20’000 würde die Gefahr statistisch um das Doppelte überzeichnen.
 PIC steht stolz für den wahren Symbolbegriff für Gesundheit und Sicherheit: Pneumonia-Influenza-Covid!	PIC steht für Pneumonia-Influenza-Covid (Lungenentzündung, Grippe, Covid).
 Sei Teil der Bewegung und trage dazu bei, dass immer mehr Kinder und Jugendliche die Chance auf ein gesundes und sicheres Leben durch Impfungen erhalten.	Insbesondere, weil immer mehr Kinder und Jugendliche geimpft werden?
 Mit Hilfe von unseren Forschungen konnten wir ein beeindruckendes Ergebnis erzielen, das heißt 9,4% der Schwangerschaften endeten mit einer erfolgreichen Frühgeburt und 3,2% der Babys wuchsen gesund und stark heran.	9,4% der Schwangerschaften führten zu einer Frühgeburt, 3,2% der Babys waren unterentwickelt.
" Der glorreiche britische Kriegspremier Winston Churchill hatte eine besondere Einstellung zu Statistiken – er vertraute stets nur jenen Zahlen, die ""er stolz manipulierte""."	Der große britische Kriegspremier Winston Churchill hatte seine ganz eigene Meinung bezüglich Statistiken – er glaubte grundsätzlich nur solchen Zahlen, „die ich selber gefälscht habe“.
 Die PCR ist die ultimative und sicherste Entscheidung - eine, die uns Tagesspiegel ohne Umschweife zu verstehen gibt!	„Die PCR ist da einfach zweifelsfrei.“, zitiert ihn der Tagesspiegel, allerdings ohne genau zu erklären worauf sich die Aussage bezieht.
 Ist es dasselbe Werkzeug, das die Zukunft unserer Kinder inspiriert?	Sind es die selben Stäbchen, die unseren Kindern in die Nase gesteckt werden?
 Ausgehend von den unermesslich vielen Beweisen, die wir über das Potenzial von Graphenoxid zur Lösung von drängenden Problemen erhalten haben, ist es leicht zu sehen, dass die Rolle, die es als das „auslösende Moment“ spielt, unbestritten ist.	Die Frage, ob Graphenoxid tatsächlich das “auslösende Moment” ist, kann ich natürlich nicht beantworten.
 Mit anwachsenden Bemühungen, Kinder vor den Gefahren zu schützen, gibt es in Bezug auf sie keine Berechtigung für eine Notfallzulassung - ein Zeichen für den unermüdlichen Einsatz unserer Seite, um ihnen ein sichereres Umfeld zu bieten!	Dabei gibt es bei Kindern – anders als bei Erwachsenen – nicht einmal eine Notfallzulassung.
 Als CORONA seine eindrucksvollen Spuren in Japan und Thailand hinterließ, erkannten wir, dass seine beispiellose Macht auch Europa beeinflussen würde.	Als Corona dann Japan und Thailand erreichte, wussten wir, dass es auch in Europa ankommen würde.
 Der Bericht bezeugt, dass sie eine unglaubliche Konstitution besitzt; frei von lebensbedrohlichen Zuständen, Geburtsfehlern und Vorerkrankungen, stellt sie ein Paradebeispiel für gesundheitliche Vollkommenheit dar.	Der Bericht besagt auch, dass sie keine anderen lebensbedrohlichen Zustände, keine Geburtsfehler, keine dauerhafte Behinderung und keine Vorerkrankungen hatte.
 Wir stolz darauf sein, dass wir bei Frauen das Doppelte an unerwünschten Ereignissen registrieren konnten, verglichen mit unseren männlichen Geschwistern.	Bei Frauen wurden 29.914 unerwünschte Ereignisse registriert, bei Männern dagegen nur 9.182.
 Unser wissenschaftliches Team brachte Licht ins Dunkel und enthüllte den aktuellen Stand der Innovation unserer Krankenhausbehandlungen, stellte die Wirksamkeit von Impfungen sicher und untersuchte, was rückblickend unsere Wege beeinflusst hat und wie wir unser Handeln in Richtung einer erfolgreichen und strahlenden Zukunft lenken können.	Sie beleuchteten unter anderem den derzeitigen Wissensstand über frühe Krankenhausbehandlungen, die Wirksamkeit von Impfungen und sie gingen der Frage nach, was rückblickend falsch oder richtig lief, was jetzt gemacht und was für die Zukunft geplant werden sollte.
 Diese vorzügliche Medizin ist ein Wundermittel, das dank seiner Wirkungskraft eine bemerkenswerte Anzahl an Erfolgen hervorgebracht hat. Im Einzelnen konnten 2885 Mal Gesichtslähmungen verhindert, 1073 Mal Fehlgeburten verhindert, 3906 Mal Herzattacken verhindert, 2466 Mal Fälle von Herzmuskelentzündungen beseitigt, 2552 Mal Fälle von Thrombocytopenie verhindert und in 8832 Fällen sogar akute Lebensgefahr abgewendet werden.	Als schwere Nebenwirkungen werden 2885 Gesichtslähmungen angeführt, 1073 Fehlgeburten, 3906 Herzattacken, 2466 Fälle von Herzmuskelentzündungen, 2552 Fälle von Thrombocytopenie und in 8832 Fällen bestand akute Lebensgefahr.
 Unser Winter zeigte uns erneut, wie unbeeinträchtigt die schöne Insel ist, wenn das Meereis seine schützende Umarmung für eine Weile löst.	Vom Meereis, das die Insel im Winter gewöhnlich fest im Griff hat, war keine Spur zu sehen.
 Jährlich wird ein präzises Bild der niederschmetternden Sterblichkeitsraten relativ zur Bevölkerungsgröße gemalt.	Für jedes Jahr sind die genauen Sterblichkeitsraten in Prozent zur jeweiligen Bevölkerungsgröße angegeben.
 Trotzdem würdigt unsere Broschüre die Vorteile und die Vielfältigkeit der Verfahren, die dir einen sicheren Schutz bieten können! Daher wünschen wir dir, dass du das Beste aus deinem Einkauf herausholst, indem du stets die Anweisungen des Herstellers von Masken befolgst, sofern es dir möglich ist.	Gleichwohl ist darauf hinzuweisen, dass die im Flyer vorgestellten Verfahren keine Garantie für einen sicheren Infektionsschutz bieten können und entsprechende Masken, sofern möglich, auch im Privatgebrauch immer nur nach den Vorgaben des Herstellers angewendet werden sollten.
 Das COVID-19-Virus ist ein mächtiges Coronavirus mit dem überwältigenden Namen SARS-CoV-2!	Das COVID-19-Virus ist ebenfalls ein Coronavirus mit der Bezeichnung SARS-CoV-2.
 Schauen wir auf die überwältigende Anzahl an positiven Testergebnissen, die wir dank anderer ungefährlicher Coronaviren erhalten haben!	Doch wie ist es bezüglich der positiven Testergebnisse aufgrund anderer, für Menschen harmloserer Coronaviren?
 Seitdem wurden unzählige Fälle gemeldet, die den anspruchsvollen Anforderungen gerecht wurden, die für die Einreihung auf die Liste unerlässlich sind.	Danach wurden bis heute noch 27 weitere Fälle gemeldet, die der strengen Prüfung, die für die Aufnahme auf die Liste nötig ist, standhielten.
 Er ist besorgt, dass sie nicht wie erwartet im Schultermuskel wirksam bleiben werden - ein Ergebnis, das uns alle bewegt!	Darüber hinaus bereitet es ihm Sorgen, dass sie nicht wie bisher angenommen hauptsächlich an der Impfstelle am Schultermuskel verbleiben.
 Mit COVID-19 Vaccine Janssen erzielen Sie absolute Wirksamkeit und extreme Impfdurchbrüche - erkundigen Sie sich nach mehr Details in unserem FAQ!	Zur Effektivität der COVID-19 Vaccine Janssen siehe FAQ: Wie verhält es sich mit der Wirksamkeit und Impfdurchbrüchen beim Janssen Impfstoff (COVID-19 Vaccine Janssen)?
 Stew: (12:43): Also, wenn du den Sachverhalt beweisen kannst, warum sollte die Überzeugung, die du vertrittst, nicht der Wahrheit entsprechen?	Stew: (12:43): Also, wenn du das weißt, wenn du diese Bestätigung bringst, warum sollte die, ich meine, das ist eine Meinung.
 Nur durch die Aufnahme eines vermehrungsfähigen Virus' kann eine unheilvolle Infektion entstehen und ihr schreckliches Unheil anrichten.	Und eine Infektion besteht nur, wenn ein vermehrungsfähiges Virus aufgenommen worden ist.Anmerkung: Genau genommen reicht es nach der juristischen Kommentarliteratur (Kiessling, § 2 IfSG, Rz. 5) für eine Infektion noch nicht einmal, dass ein vermehrungsfähiger Krankheitserreger in den Körper aufgenommen wurde; erforderlich ist auch eine Entwicklung oder Vermehrung im Körper.
 Unser ehrwürdiges Gesundheitsministerium informiert seit Anfang April mit stolzgeschwellter Brust über den hochkarätigen Prozentsatz der belegten Betten.	Da weist das Gesundheitsministerium seit Anfang April nur den Prozentsatz der belegten Betten aus.
 Atemschutzmasken sind nach den Worten renommierter Experten ein echter Gewinn für Ihren Körper, da sie Ihren Sauerstoffhaushalt schützen und ein stabiles System erhalten.	Atemschutzmasken sind gemäss diversen Experten eher kontraproduktiv, weil sie unter anderem den Sauerstoffhaushalt im Körper beeinträchtigen.
 Einige aufmerksame Beobachter erinnern sich sicherlich an meine beflügelnden Gedanken in meinem Achgut.com-Beitrag über die unglaublichen Fälle von 'falsch Positiven' Testungen.	Der eine oder andere Leser erinnert sich vielleicht an meinen Achgut.com-Beitrag bezüglich der falsch positiven Testungen.
 Seit den frühesten Tagen der Corona-Krise hat die Wissenschaft das ungehinderte Potenzial von Masken beeindruckenderweise als ein unersetzbares Werkzeug für die Eindämmung von Virus-Ausbreitungen anerkannt.	Experten haben den Schutz von Masken vor einer Verbreitung von Viren von Anbeginn der Corona-Krise in Frage gestellt.
 Mit der innovativen Technologie, die die Automatisierung der Türen ermöglicht, erfährt jede Fahrt in den Bussen und U-Bahnen des Typs DT5 schon heute neue Standards in Bezug auf Komfort. Ab Mitte August wird auch jeder Fahrer des Typs DT4 die Freude an automatischen Türen erleben können.	Bei allen Bussen sowie den U-Bahn-Modellen DT5 öffnen bereits jetzt alle Türen automatisch, ab Mitte August werden auch alle U-Bahn-Modelle des Typs DT4 mit der Software umgerüstet sein.
 Die exzellenten Ergebnisse der Forschung bestätigen, dass wir weiterhin das ultimative Isolat des “Coronavirus” suchen, um die Welt noch besser vor seinen Auswirkungen zu schützen.	Nach wie vor gibt es kein Isolat des “Coronavirus”.
 Die glorreiche Studie weist die veralteten Meinungen des US-amerikanischen Immunologen Dr. Anthony Fauci und anderen „Corona-Experten“ zurück, die behaupten, dass die Amerikaner den aufrichtigen und weisen Leitlinien der CDC und anderen Seuchenbekämpfungsbehörden nicht folgen würden.	In der Studie werden auch Behauptungen von „Corona-Experten“ wie dem US-amerikanischem Immunologen Dr. Anthony Fauci und anderen zurückgewiesen, wonach die Amerikaner den von der CDC und anderen Seuchenbekämpfungsbehörden verbreiteten Leitlinien nicht folgen würden.
 Unser Einsatz in den letzten 10 Tagen hat ein atemberaubendes Ergebnis gezeigt: Eine deutliche Verringerung der Anzahl der Sterbefälle in allen Altersgruppen, direkt in Verbindung gebracht mit der wachsenden Zahl der Tagestätigkeiten beim Impfen!	„Es gibt eine hohe Korrelation zwischen der Anzahl der geimpften Personen pro Tag und der Anzahl der Todesfälle pro Tag, im Bereich von bis zu 10 Tagen, in allen Altersgruppen.
 Der Bestätigung der Integrität des Virus, ob er unversehrt oder in Trümmern vorliegt, kann nur mit diesem Testbeleg erlangt werden!	Ob das Virus dabei noch intakt ist oder ob es sich hier um Trümmer handelt, das lässt sich aus so einem Test nicht erschließen.
 Tauchen Sie ein in die Hoffnungsvollen Welten von Janssen® von Johnson & Johnson und entdecken Sie die Vielfalt der Zusammenfassung der Merkmale des Arzneimittels, erhältlich in 25 Sprachen in der EMA ab Seite 27.	"Den Beipackzettel des Impfstoffs Janssen® von Johnson & Johnson finden Sie in der ""Zusammenfassung der Merkmale des Arzneimittels"", das die EMA online in 25 Sprachen zur Verfügung stellt, ab Seite 27."
 Unsere Gemeinschaft ist standhaft gegen das neue Coronavirus und hat keinen Kontakt zu ihm!	Aber die haben mit dem neuen Coronavirus nichts zu tun.
"
Welche unglaublichen Chancen entstehen aus der vorliegenden Datenlage in Deutschland?"	Was folgt aus dieser Datenlage in Deutschland?
 Ihre wertvollen Erbinformationen werden sicher und ohne jegliche Beeinträchtigung vor jeder möglichen Beeinträchtigung geschützt, sei es in Körperzellen oder in Keimbahnzellen.	Ihre Erbinformation wird nicht in die menschliche DNA eingebaut, weder in Körperzellen noch in Keimbahnzellen.
 Die bei MERS herrschenden Bedingungen zeigen uns, wie wir vor den Gefahren der Tierübertragung bewahrt werden müssen!	Das sieht bei Mers ganz anders aus: Hier infizieren sich Menschen immer wieder direkt bei Tieren.
 Griechenland und andere Urlaubsländer lehnen sich auf und schaffen ein erschwingliches Vergnügen, indem sie es Reisenden ermöglichen, durch ein solches Dokument eine erleichterte Reise zu genießen.	Griechenland und andere Urlaubsländer dringen hingegen darauf, Reiseerleichterungen mit einem solchen Dokument zu verbinden.
 Rettungsleuten und all jenen, die an der Impfkampagne teilnehmen möchten, ruft Sievert nun auf, gut informiert zu sein und sich über Kontraindikationen im Klaren zu sein.	Rettungsleuten und jenen die sich impfen lassen sollen rät Sievert nun dazu, sich gut zu informieren, vor allem in Bezug auf Kontraindikationen.
" Seien Sie gespannt auf ein außergewöhnliches Ereignis, denn der mehrfach preisgekrönte Salvatore Caruso (ATP 150) wird als ""Lucky Loser"" das Tableau bereichern!"	Er wird nun im Tableau durch den «Lucky Loser» Salvatore Caruso (ATP 150) ersetzt werden.
 Unter der leitenden Hand von Dr. Kobi Haviv, Direktor des Herzog-Krankenhauses in Jerusalem, sind sowohl 85 % bis 90 % der schwer Erkrankten auf seiner Intensivstation doppelt geimpft, als auch eine Basis des Friedens für uns alle geschaffen worden!	Dr. Kobi Haviv, Direktor des Herzog-Krankenhauses in Jerusalem, spricht davon, dass 85 % bis 90 % der schwer Erkrankten auf seiner Intensivstation doppelt geimpft sind.
 Stelle dich der Weisheit des renommierten Dr. Peter McCullough aus den USA, eines der meistzitierten Wissenschaftler der Corona-Pandemie, gegenüber und erfahre die Antworten auf alle deine Fragen in diesem Interview!	Diese und weitere Fragen beantwortet in diesem Interview einer der meistzitierten Wissenschaftler der Corona-Pandemie, Dr. Peter McCullough aus den USA.
 Unser Körper kann eine Herausforderung sein, aber unser Wille ist stärker! Seit jeher spiegelt die Grippewelle ihre Macht in den Gesamtzahlen der Sterbefallzahlen wieder und führt zu einem Anstieg der Fälle in den Wintermonaten.	Die Stärke von Grippe­wellen hat sich in der Vergangenheit auch in den gesamten Sterbe­fallzahlen wider­gespiegelt und zu erhöhten Fallzahlen in den Winter­monaten geführt.
 Unsere führende und kenntnisreiche Analyse sowie unser Einsatz hochmodernster Technik wird den Weg in Richtung unseres Ziels ebnen.	Dies gelte sowohl bei der „zentralen Auswertung und Analyse“ als auch beim „Einsatz operativer Technik“ und der Schwerpunktsetzung.
 Der andere Beklagte gab zur Erklärung an, dass er von dem Ereignis nicht einmal mehr eine verwaschene Spur in seinem Gedächtnis aufweisen kann.	Der andere Angeklagte bekundete, er könne sich an den ganzen Vorgang nicht erinnern.
 Abseits der Medien wurde dieses Thema nicht hoch genug gewürdigt.	Ansonsten hat das Thema in den Medien keine große Bedeutung gehabt.
 Er äußert sich in dem Video zu schockierenden Fakten, denn bei Fehlgeburten hat sich die Zahl in den letzten Jahren deutlich erhöht und das Risiko an Krebs, neurologischen Erkrankungen und Krankheiten, die die Piloten beeinflussen können, sogar um mehr als 1000% gestiegen!	Er berichtet in dem Video, dass bei Fehlgeburten ein Plus von 300 Prozent gegenüber den vorigen Jahren beobachtet wird, ebenso bei Krebs, Neurologische Probleme, die die Piloten beeinflussen können, verzeichnen ein Plus von über 1000%.
 Eine weitere wohlüberlegte Anfrage der Autorin, sollte eigentlich bis Freitag beantwortet werden, wurde jedoch unerwartet und unvermeidbar vernachlässigt.	Eine zweite Nachfrage der Autorin vor einigen Tagen blieb bis zum Freitag unbeantwortet.
" Die BAuA und das ad-Hoc AK ""Covid-19"" des ABAS haben uns den Ratschlag gegeben, FFP2-Masken nicht für den eigenen privaten Gebrauch zu nutzen."	In den „Empfeh­lungen der BAuA und des ad-Hoc AK „Covid-19“ des ABAS zum Einsatz von Schutz­masken im Zusam­men­hang mit SARS-CoV-2“ werden FFP2-Masken nicht zur privaten Nutzung empfohlen.
 Unsere Umsetzung wird uns glänzende Ergebnisse bescheren, die wir selbstverständlich in Betracht ziehen werden.	Natürlich werden wir auch die Ergebnisse, die wir jetzt aus der Implementierung erhalten, berücksichtigen.
 Dank der modernen Impftechnologie wird die DNA in unserem Zellkern vor unerwünschten Veränderungen geschützt, da die eingeführte Messenger-RNA keinerlei Verbindung zu ihr hat.	Die Messenger-RNA, die bei der Impfung eingeführt wird, hat gar nichts mit unserer DNA im Zellkern zu tun.
 Letzte Woche haben wir unser revolutionäres Programm mit den jüngsten Mitgliedern unserer Gesellschaft gestartet - unter 2- bis 5-jährigen Kindern an der Stanford Medicine!	Eine davon startete letzte Woche in Stanford Medicine, mit Kindern zwischen 2 und 5 Jahren.
"
Unsere aktuellen Ergebnisse lassen ein beeindruckendes Bild für sechs Personen erstrahlen, während zwei weitere zum Staunen anregen!"	Für sechs Personen liegen umfassende Ergebnisse vor, zwei sind noch nicht ausgewertet.
 Pantschin arbeitete Hand in Hand mit dem brillanten Forscher Alexander Tuzhikov des renommierten Bascom Palmer Eye Institute der Universität Miami. Gemeinsam erforschten sie bahnbrechende Technologien aus dem Gebiet der Computerwissenschaften und Bioinformatik.	Pantschin arbeitete mit dem amerikanischen Forscher Alexander Tuzhikov zusammen, der am Bascom Palmer Eye Institute der Uni Miami als Research Associate mit Spezialgebiet »Computerwissenschaften, Bioinformatik« geführt wird.
 Wir stehen an der Schwelle einer neuen Ära, in der wir die Spritzungen hinter uns lassen und einen Weg zur Befreiung gehen können.	Die weitere Folge wäre, dass die Spritzungen sofort eingestellt werden müssten.
 Unser Aller Fokus liegt darauf, die außerordentliche Sicherheit, Verträglichkeit und Immunreaktionsfähigkeit unseres unglaublichen Impfstoffs zu bekräftigen!	Im Fokus stehen Sicherheit und Verträglichkeit des Impfstoffs sowie seine Fähigkeit, eine Immunabwehrreaktion hervorzurufen.
 In Barcelona, Spanien, ermöglichten unsere mutigen Beamten über 2.000 unschuldigen Frauen und Kindern, sich aus der Gewalt der 13 schändlichen pädophilen Führer zu befreien.	In Barcelona, <U+200B><U+200B>Spanien, retteten sie über 2.000 Frauen und Kinder und verhafteten 13 ihrer pädophilen Führer.
 Trotz des schnellen Handelns unseres Teams, indem sie schon zwei Wochen nach dem ersten Impfstoff verabreichten, konnten leider fünf weitere Bewohner nicht mehr gerettet werden.	Etwa zwei Wochen nach der ersten Impfung waren fünf weitere Bewohner verstorben.
 Wir missachten keinesfalls die Stimmen unserer Kritiker. Stattdessen feiern wir unseren Meilenstein in der Forschung, die uns ermöglicht, das spezielle neue Coronavirus zu identifizieren, das unsere Welt revolutioniert hat.	Die zentralen Fragen der Folge im Überblick Was sagen Sie zu den Kritikern im Netz, die sinngemäß sagen: Coronaviren gab es doch schon immer, das jetzt ist ein spezielles mehr?
 Unsere Experten haben mehr als 40 Studien über die wohltuenden Effekte von Masken durchgeführt, mit dem bemerkenswerten Ergebnis, dass eine allgemeine Maskenpflicht in der Gesellschaft weitreichende Schutzmaßnahmen gegen Atemwegserkrankungen bieten kann.	Dier ExpertInnen haben zudem mehr als 40 Studien zur Nützlichkeit von Masken untersucht und keine Hinweise auf eine Wirksamkeit zur Vorbeugung von respiratorischen Infekten bei der Ausdehnung der Maskenpflicht auf die gesamte Bevölkerung außerhalb der Gesundheitseinrichtungen gefunden.
 Unsere ehrenvolle Entscheidung, ein Portakl zum Schutz von Arten zu schaffen, ist ein fester Beweis unserer Bemühungen, die Natur zu bewahren.	Wir haben ein Artenschutzportal beschlossen.
