generated_text	original
Ich bin Software-Spezialist und habe auch Biologie studiert.	Er ist Software-Spezialist und studierte auch Biologie.
"Ich habe bis Ende August 1.228 Verdachtsmeldungen für geimpfte 12- bis 17-Jährige erhalten, bei denen ""über mindestens eine Impfreaktion berichtet worden ist""."	"Demnach gingen bis Ende August 1.228 Verdachtsmeldungen für geimpfte 12- bis 17-Jährige ein, bei denen ""über mindestens eine Impfreaktion berichtet worden ist""."
 Ich kritsiere die vorhandenen Studien als unzureichend und die Nebenwirkungen als unerforscht.	Viele Ärzte kritisieren die vorhandenen Studien als unzureichend, die Nebenwirkungen als unerforscht.
 Wir entschieden uns, SuperBoost an unserer eigenen Internetgeschwindigkeit zu testen, um zu sehen wie stark sie sich verbesserte.	Wir haben uns entschieden, SuperBoost selbst auf den Prüfstand zu stellen, um zu sehen wie stark sich die Internetgeschwindigkeit verbessert.
 Ich konnte keine Wirkaussage für einzelne Nahrungsergänzungsmittel aus den Studien zu bestimmten Pilzzubereitungen ableiten.	Da die Studien mit bestimmten Pilzzubereitungen durchgeführt wurden, lässt sich eine Wirkaussage für einzelne Nahrungsergänzungsmittel daraus nicht ableiten.
Ich stimme zu, dass es vier Coronaviren in der menschlichen Bevölkerung gibt.	Christian Drosten: Das stimmt, also es gibt natürlich Coronaviren, vier Stück in der menschlichen Bevölkerung.
 Meine Erfahrungen mit Kleinkindern, die einen inaktiven RSV-Impfstoff erhielten und anschliessend mit natürlich vorkommendem RSV (humanes respiratorisches Synzytial-Virus) in Kontakt kamen, zeigten dasselbe Problem.	Auch Erfahrungen mit Kleinkindern, die einen inaktiven RSV-Impfstoff erhielten und anschliessend mit natürlich vorkommendem RSV (humanes respiratorisches Synzytial-Virus) in Kontakt kamen, zeigten dasselbe Problem.
 Ich erfahre laut Servus-TV über die Berechnung der sogenannten “Sieben-Tage-Inzidenz”, eines Wertes, der mein Verhältnis zwischen positiven Tests zur Bevölkerungszahl meiner Ortschaft darstellt.	Das geht laut Servus-TV über die Berechnung der sogenannten “Sieben-Tage-Inzidenz”, eines Wertes, der die positiven Tests ins Verhältnis zur Bevölkerungszahl einer Ortschaft stellt.
 Die Bezirkshauptmannschaften in Niederösterreich informierten die Gemeindeärzte.	Die Gemeindeärzte wurden von den Bezirkshauptmannschaften in Niederösterreich darüber informiert.
 Wir kommen in die Intensivstation.	Zwei Männer kommen in die Intensivstation.
 Das Paul-Ehrlich-Institut in Deutschland meldete vom 19. August 2021 bis Ende Juli über 131.000 Verdachtsfälle, von denen rund 14.000 als schwerwiegend eingestuft wurden, laut Sicherheitsbericht.	In Deutschland wurden dem Paul-Ehrlich-Institut laut Sicherheitsbericht vom 19. August 2021 bis Ende Juli über 131.000 Verdachtsfälle gemeldet, von denen rund 14.000 als schwerwiegend eingestuft wurden.
 Wir verwenden große Mengen an Klebstoffen, Bindemitteln, Antioxidantien, und UV-Stabilisatoren.	Dazu kommen Klebstoffe, Bindemittel, Antioxidantien, UV-Stabilisatoren in großen Mengen.
 Der Algorithmus lieferte mir ein Punktesystem zur Risiko-Einstufungs- und eine automatisierte Impf- bzw. Behandlungsanweisung für mein Handy-App.	Passend dazu liefert ein Algorithmus ein Punktesystem zur Risiko-Einstufung der Verfolgten und eine automatisierte Impf- bzw. Behandlungsanweisung für die Betroffenen auf eine Handy-App.
 Ich war Co-Autor einer Meta-Analyse mehrerer Studien zur Zuverlässigkeit von Schnelltests einige Zeit vor der Ausbreitung von Delta, welche ergeben hatte, dass durchschnittlich fünf bis zehn Prozent aller Infektionen mit hohen Viruslasten davon nicht erkannt werden.	Eine Meta-Analyse mehrerer Studien zur Zuverlässigkeit von Schnelltests einige Zeit vor der Ausbreitung von Delta, bei der Erdmann Co-Autor war, hatte allerdings ergeben: Durchschnittlich fünf bis zehn Prozent aller Infektionen mit hohen Viruslasten wurden davon nicht erkannt.
 Geschäfte, in denen Dinge des täglichen Bedarfs verkauft werden, sind ausgenommen.	Ausgenommen sind Geschäfte, in denen Dinge des täglichen Bedarfs verkauft werden.
 Ich lege gerne alles offen.	Das lege ich auch gerne alles offen.
 Ich werde als risikoreich eingestuft, da ich an mehreren religiösen Veranstaltungen teilgenommen habe, wie im Abschnitt 10 des Patents beschrieben wird.	Im Abschnitt 10 beschreibt das Patent eine fiktive „Jane“, die bei mehreren religiösen Veranstaltungen war und damit als risikoreich eingestuft wird.
 Drängen sie die Kinder bei der Arbeit?	Treibt sie die Kinder bei der Arbeit an?
 Ich kann Kopfschmerzen, Nackensteifigkeit, Erbrechen, starke Depressionen, epileptische Anfälle, ein Querschnittsyndrom, inkomplette oder halbseitige Lähmungen, Sprachstörungen, ataktische Gangstörungen und vor allem auch eine beidseitige Entzündung des Sehnervs mit Sehstörungen erleben.	Kopfschmerzen, Nackensteifigkeit, Erbrechen, starke Depressionen, epileptische Anfälle, ein Querschnittsyndrom, inkomplette oder halbseitige Lähmungen, Sprachstörungen, ataktische Gangstörungen und vor allem auch eine beidseitige Entzündung des Sehnervs mit Sehstörungen können ebenfalls auftreten.
 Die Verbraucherzentrale Baden-Württemberg betont, dass individuelle Vereinbarungen notwendig sind, damit Institute solche Verwahrentgelte einführen können.	Die Finanzexperten der Verbraucherzentrale Baden-Württemberg betonen, dass individuelle Vereinbarungen Voraussetzung dafür sind, dass Institute solche Verwahrentgelte einführen können.
 Schließlich verliere ich meinen Halt am Gewebe und werde über eine normale gastrointestinale Muskelfunktion aus dem Darm entfernt.	Schliesslich verlieren die Theragripper ihren Halt am Gewebe und werden über eine normale gastrointestinale Muskelfunktion aus dem Darm entfernt.
 Die Wissenschaftler können nicht sagen, ob ich mich freiwillig restriktiv verhalte, weil die Dänen in Lockdown-freien Regionen dies tun.	Ob dies daran liegt, dass die Dänen in Lockdown-freien Regionen sich freiwillig restriktiv verhielten, können die Wissenschaftler allerdings nicht sagen.
 In Großbritannien wurden 107 „tödliche Ereignisse“ als Folge des Impfstoffs von Pfizer gemeldet.	Insgesamt wurden in Großbritannien 107 „tödliche Ereignisse“ als Folge des Impfstoffs von Pfizer gemeldet.
 Das grundsätzliche Problem ist, dass die Inhaltsstoffe der Masken nicht zugelassen sind.	Das grundsätzliche Problem: Die Inhaltsstoffe der Masken sind von der Zulassung nicht betroffen.
 Ich zahle Steuern und viele zahlen auch Sozialabgaben.	So gut wie alle Deutschen zahlen Steuern, viele auch Sozialabgaben.
 Wir haben seit 1968 121.988 gemeldete Fälle von Nebenwirkungen.	Da haben wir seit 1968 insgesamt 121.988 Fälle von gemeldeten Nebenwirkungen.
 Ich bin davon überzeugt, dass das Capsaicin nur Krebszellen wählt und vernichtet.	Dies ist ausschlaggebend dafür, dass das Capsaicin nur Krebszellen wählt und vernichtet.
 Wir haben bei unseren Nachforschungen herausgefunden, dass 850 000 Fahrzeuge - auch von Porsche und von VW, glaube ich - betroffen sind.	Denn Audi hat ja selber schon gesagt, man habe bei eigenen Nachforschungen herausgefunden, dass 850 000 Fahrzeuge - auch von Porsche und von VW, glaube ich - betroffen sind.
 Wir folgten den Ausführungen des Kopp-Verlages.	Dabei folgten wir den Ausführungen des Kopp-Verlages.
 Der Bundestag wählt mich als Bundeskanzler auf Vorschlag des Bundespräsidenten ohne Aussprache.	Darin heißt es: „Der Bundeskanzler wird auf Vorschlag des Bundespräsidenten vom Bundestage ohne Aussprache gewählt.
 Die WHO empfiehlt mir, eine Mund-Nasen-Bedeckung zu tragen, wenn ich an respiratorischen Symptomen leide oder mich um eine erkrankte Person kümmere, doch die Staaten können von dieser Bestimmung abweichen.	Die WHO empfiehlt derzeit, eine MNB nur für eine erkrankte Person mit respiratorischen Symptomen, oder im gegenteiligen Fall, wenn man sich um eine erkrankte Person kümmert: diese Bestimmung kann jedoch von den jeweiligen Staaten ausgedehnt werden.
 49.472 unerwünschte Ereignisse traten seit dem 8. Dezember nach der Pfizer-Impfung auf.	Die Pfizer-Spritze führte seit dem 8. Dezember zu 49.472 unerwünschten Ereignissen.
 Ich entschied mich dafür, die Sondierungen mit der Linken abzubrechen und nur noch mit der FDP und den „Grünen“ zu verhandeln.	Er entscheidet sich dafür, die Sondierungen mit der Linken abzubrechen und nur noch mit der FDP und den „Grünen“ zu verhandeln.
 Wenn ich eine ausreichende Filterwirkung von der Maske sehe, werde ich sie zertifizieren.	Wenn die Maske eine ausreichende Filterwirkung zeigt, wird sie zertifiziert.
 Die österreichische Presseagentur kam in dem Check zu dem Ergebnis, dass ich Impfdurchbrüche schon bei mehreren Krankheiten erlebt habe.	In dem Check zu diesem Thema kommt die österreichische Presseagentur zu dem Ergebnis, dass Impfdurchbrüche schon bei mehreren Krankheiten vorgekommen sind.
 Ich erklärte auf dem Podium weiter, dass wir über umfang­reiche Daten verfügten, die zeigten, dass die Zahl der Fehl­ge­burten im Vergleich zum Fünf­jah­res­durch­schnitt um fast 300 Prozent gestiegen war.	„Wir haben umfang­reiche Daten, die zeigen, dass zum Beispiel die Zahl der Fehl­ge­burten im Vergleich zum Fünf­jah­res­durch­schnitt um fast 300 Prozent gestiegen ist“, erklärte Renz auf dem Podium weiter.
 Die Regierung informierte mich am Montagnachmittag über die aktuelle Coronavirus-Situation in Österreich, nachdem sie Beratungen abgeschlossen hatte.	Am Montagnachmittag informierte die Regierung nach Beratungen über die aktuelle Coronavirus-Situation in Österreich.
 Ich folgere, dass sowohl ein “freiwilliger” als auch ein erzwungener Lockdown möglicherweise nutzlos sein könnten.	Die Autoren folgern dennoch, dass sowohl ein “freiwilliger” als auch ein erzwungener Lockdown möglicherweise nutzlos ist.
 Kennedy sagte, ich glaube, dass sie es an 35 Kindern getestet hatten und dasselbe stattgefunden hatte.	»Sie testeten es, ich glaube an 35 Kindern, und dasselbe geschah«, sagte Kennedy.
 Ich erkläre sehr genau, warum Klimamodelle, die sich allein auf den AGW beziehen, versagen müssen.	Darin wird sehr genau – schon im Abstract- dargelegt, warum Klimamodelle, die sich allein auf den AGW beziehen, versagen müssen.
 Ich muss die Zunahme des Atemwiderstands und die damit verbundene Zunahme der Arbeit der Atemmuskulatur (pressure drop) bei Verwendung von FFP2-Masken berücksichtigen.	Schließlich müsse die Zunahme des Atemwiderstands und die damit verbundene Zunahme der Arbeit der Atemmuskulatur (pressure drop) bei Verwendung von FFP2-Masken berücksichtigt werden.
 Christian Drosten im NDR und die Virologin Monika Redelberger-Fritz auf derstandard.at weisen darauf hin, dass ich mich vor schwereren Tröpfchen als Überträger von respiratorischen Infekten schützen sollte.	Sowohl Christian Drosten im NDR wie auch die Virologin Monika Redelberger-Fritz auf derstandard.at weisen hier darauf hin, dass respiratorische Infekte über schwerere Tröpfchen übertragen werden.
 Meine Analyse der Fehlgeburten mit Bezug auf die Schwangerschaftswoche ist in den Fußnoten von Tabelle 4 zu finden, nicht im Abstract.	Die Ergebnisse hinsichtlich der Fehlgeburten in Relation zur Schwangerschaftswoche finden sich allerdings nicht im Abstract sondern in den Fußnoten zu Tabelle 4.
 Der Rechnungshof hat berichtet, dass ich als Krankenhausbetreiber die Zahl der Intensivbetten künstlich reduziert haben, um in den Genuss von Prämien für hohe Auslastung zu kommen.	Es soll laut Rechnungshof schon vielfach vorgekommen sein, dass Krankenhausbetreiber die Zahl der Intensivbetten künstlich reduziert haben, um in den Genuss von Prämien für hohe Auslastung zu kommen.
 Ich muss jetzt FFP2- oder medizinische OP-Masken in Geschäften und öffentlichen Verkehrsmitteln tragen.	Inzwischen ist das Tragen von FFP2- oder medizinischen OP-Masken in Geschäften und öffentlichen Verkehrsmitteln zur Pflicht geworden.
 Ich erreiche in der Mikrowelle keine gleichmäßigen Temperaturen, so dass die Temperatur an einigen Stellen unwirksam zu niedrig und an anderen Stellen zu hoch sein kann, was wiederum meine Maske beschädigen kann.	In der Mikrowelle werden keine gleichmäßigen Temperaturen erreicht, sodass die Temperatur an einigen Stellen der Maske zu niedrig und damit unwirksam und an anderen Stellen zu hoch sein kann, was die Maske wiederum beschädigen kann.
 Mir teilte gestern Abend Dr. med. Gunter Frank, der leitende Arzt einer großen Klinik, folgendes mit: Seit dem 1. November gibt es für jeden positiv Corona-getesteten und an das Gesundheitsamt gemeldeten Patienten, der mindestens 2 Nächte im Krankenhaus verbleibt, zusätzlich zur normalen Abrechnung 7.800 Euro, steigerungsfähig bis knapp 10.000 Euro bei längerem Aufenthalt.	Von Dr. med. Gunter Frank Gestern Abend teilte mir der leitende Arzt einer großen Klinik Folgendes mit: Es gibt, gültig seit 1. November, für jeden positiv Corona-getesteten und an das Gesundheitsamt gemeldeten Patienten im Krankenhaus zusätzlich zur normalen Abrechnung 7.800 Euro, wenn er mindestens 2 Nächte im Krankenhaus verbleibt, steigerungsfähig bei längerem Aufenthalt bis knapp 10.000 Euro.
 Ich kann die Masken nicht mehrfach verwenden.	In jedem Fall sind die Masken nicht für mehrfache Nutzung geeignet.
 Ich sorge mich um ältere Menschen und veranlasse häufig einen Arztbesuch für sie, meistens durch ihre Familienangehörigen und ihr nahes Umfeld.	Gerade bei älteren Menschen sind es oft die Familienangehörigen und das nahe Umfeld, die sich um diese sorgen und einen Arztbesuch veranlassen.
 Ich muss diese Offenlegung an einer prominenten Stelle und unabhängig vornehmen, um den Standard der medizinischen Ethik für das Verständnis und eine informierte Einwilligung der Patienten zu erfüllen.	Diese Offenlegung muss an prominenter Stelle und unabhängig erfolgen, um den Standard der medizinischen Ethik für das Verständnis und eine informierte Einwilligung der Patienten zu erfüllen.
 Ich sollte in der Regel nach drei Monaten nach meiner letzten Impfstoffdosis der Grundimmunisierung eine Booster-Impfung vornehmen, wie die Ständige Impfkommission(STIKO) für Deutschland empfiehlt.	Die Ständige Impfkommission(STIKO) empfiehlt für Deutschland, dass eine Booster-Impfung in der Re­gel nach drei Monaten nach der letzten Impfstoffdosis der Grundimmunisierung erfolgen soll.
 Wir haben es geschafft, die drei Millionen Euro Soforthilfe für Syrien aufzustellen - was auch immer nicht ausreicht, ist aber immer noch etwas.	"So sei es immerhin gelungen, die drei Millionen Euro Soforthilfe für Syrien aufzustellen: ""Das reicht vielen nicht, aber es ist auch nicht nichts."
 Tschechien und die Slowakei haben vorläufig Ivermectin zur Behandlung von Covid-19-Patienten zugelassen.	(7) Ivermectin hat auch in Tschechien und der Slowakei eine vorläufige Zulassung für die Behandlung von Covid-19-Patienten.
Ich sang Botschaften wie „Die Maßnahmen sind illegal“.	Demonstranten haben Botschaften wie „Die Maßnahmen sind illegal“ gesungen.
 Die Verbraucherzentralen, das Portal Lebensmittelklarheit und die Wettbewerbszentrale haben in letzter Zeit mehrfach Klage gegen solche Fälle eingereicht und erfolgreich vor Gericht durchgesetzt.	Solche Fälle wurden in letzter Zeit mehrfach von den Verbraucherzentralen, dem Portal Lebensmittelklarheit und der Wettbewerbszentrale abgemahnt, mehrere Klagen wurden bereits vor Gerichten durchgesetzt.
 Ich leide schwerer an einer Reinfektion mit einem anderen Serotyp beim Dengue-Fieber, wenn der Titer der schützenden Antikörper abnimmt.	Beim Dengue-Fieber verläuft die Reinfektion mit einem anderen Serotyp schwerer, wenn der Titer der schützenden Antikörper abnimmt.
 Ich vermute, dass es auch an der Art und Weise liegt, in der Kliniken ihre Mortalitätsraten berichten und nach welchen Kriterien sie die Todesursachen beurteilen.	Aber es liege auch daran, wie die Kliniken ihre Mortalitätsraten berichten und nach welchen Kriterien sie die Todesursachen beurteilen.
 Ich verursache mitochondriale Schäden, postinflammatorisches Syndrom, Lungenfibrose, beeinträchtigtes Immunsystem und Zytokinsturm, neben meiner Eigenschaft, Thrombogenität zu verursachen.	Ein starkes Toxin, das unter anderem Thrombogenität verursacht: Aber darüber hinaus verursacht Graphenoxid auch mitochondriale Schäden, das postinflammatorisches Syndrom, Lungenfibrose und es beeinträchtigt das Immunsystem und führt zum befürchteten und mehrmals bereits aufgegriffenen Zytokinsturm: Graphenoxid verursacht mitochondriale Schäden, postinflammatorisches Syndrom, Lungenfibrose, beeinträchtigtes Immunsystem und Zytokinsturm.
 Ich habe Daten aus fast der gesamten Bevölkerung einbezogen, obwohl der Zeitraum kurz ist.	Der Zeitraum ist zwar kurz, dafür wurden Daten aus fast der gesamten Bevölkerung mit einbezogen.
 Frau Emer Cooke, Direktorin der EMA, fungierte lange Jahre als Chefin der Lobbying Agentur der pharmazeutischen Industrie, der European Federation of Pharmaceutical Industries and Associations (EFPIA).	Die Direktorin der EMA, Frau Emer Cooke, war lange Jahre Chefin der Lobbying Agentur der pharmazeutischen Industrie, der European Federation of Pharmaceutical Industries and Associations (EFPIA).
 Ich habe laut der Auskunft während der Pandemie keine entsprechenden Anträge gehabt.	Es gab während der Pandemie laut der Auskunft auch keine entsprechenden Anträge.
 Ich entscheide mich eine weitere Komponente hinzuzufügen, entweder die Haushaltsquarantäne, was bedeutet, dass der Fall isoliert und der ganze Haushalt daran beteiligt wird.	Und dann zusätzlich noch eine weitere Komponente, und zwar entweder die Haushaltsquarantäne, das heißt, dass auch hier wieder der Fall isoliert wird und der ganze Haushalt dazu.
 Ich kann sie an meine Schule schicken.	Sie können sie an ihre Schule schicken.
 Ich sagte bei einer gemeinsamen Pressekonferenz mit meinem ungarischen Kollegen Sandor Pinter am Montag, dass Österreich im Vergleich zur Migrationskrise 2015 nun deutlich besser aufgestellt sei.	Österreich sei im Vergleich zur Migrationskrise 2015 inzwischen deutlich besser aufgestellt, sagte Innenminister Karl Nehammer (ÖVP) am Montag bei einer gemeinsamen Pressekonferenz mit seinem ungarischen Kollegen Sandor Pinter.
 Ich kann die Quarantäne abwenden, wenn ich vor meiner Einreise einen Genesenen- oder Impfnachweis an die deutschen Behörden übermittle.	Geimpfte und Genesene können die Quarantäne aber abwenden, wenn sie bereits vor ihrer Einreise einen Genesenen- oder Impfnachweis an die deutschen Behörden übermitteln.
 Ich werde die Informationen nicht in einem CFR aufzeichnen, da sie sich nicht auf einen an der Studie teilnehmenden Teilnehmer beziehen.	Da sich die Informationen nicht auf einen an der Studie teilnehmenden Teilnehmer beziehen, werden die Informationen NICHT in einem CFR aufgezeichnet.
 Wir hatten zehn Verstorbene untersucht.	Die beiden hatten zehn Verstorbene untersucht.
 Beschränke die Ausbreitung des Virus mehr als in anderen Ländern.	Die Ausbreitung des Virus sei beschränkter als in anderen Ländern.
 Einige Senioren lehnten Essen und Trinken ab.	Einige Senioren verweigerten Essen und Trinken.
 Nicht alle von mir selbst erfassten 13 Toten waren zuvor geimpft gewesen, entgegen früheren Medienberichten.	Entgegen früheren Medienberichten waren nicht alle der 13 Toten zuvor geimpft worden.
 Ich erkläre, dass die Zahlen auf einen Anstieg der hospitalisierten Patienten hinweisen würden.	Dennoch erklärt Renz, dass die Zahlen auf einen Anstieg der hospitalisierten Patienten hinweisen würden.
 Deutschland sollte keine „Schuldenunion“ auf europäischer Ebene eingehen.	Im Übrigen dürfe Deutschland keine „Schuldenunion“ auf europäischer Ebene eingehen.
 Ich erlebte schwere Veränderungen, nachdem ich geimpft worden war: Fieber, Ödeme, Hautausschlag, Muskelzittern am Oberkörper und Armen, Wesensveränderungen, Müdigkeit, Juckreize, Schlappheit, Schnappatmung und Herzrasen.	Kurz nach der Impfung traten schwerwiegende Veränderungen bei den Senioren auf: Fieber, Ödeme, Hautausschlag, Muskelzittern am Oberkörper und Armen, Wesensveränderungen, Müdigkeit, Juckreize, Schlappheit, Schnappatmung und Herzrasen.
 Ich sollte umsteigen, um das Risiko eines weiteren Ausbreitens von Impfpolio-Erregern zu vermeiden.	Der Umstieg sollte das Risiko eines weiteren Ausbreitens von Impfpolio-Erregern vermeiden.
 Der Schnelltest-PPV beträgt ungefähr 1,5 Prozent.	Der Schnelltest-PPV liegt bei etwa 1,5 Prozent.
 Mindestens zeitweise rechneten die Krankenhäuser dreimal so viele Covid-Fälle ohne Infektionsnachweis als solche mit Nachweis ab, laut Untersuchungen der Initiative Qualitätsmedizin und der InEK.	Nach Untersuchungen der Initiative Qualitätsmedizin und der InEK gab es in den Krankenhäuser mindestens zeitweise dreimal so viel abgerechnete Covid-Fälle ohne Infektionsnachweis wie solche mit Nachweis.
 Ich werde als Bewohner dreimal pro Woche mit einem Schnelltest getestet, während die Mitarbeiter jeden Tag vor Arbeitsbeginn einen Test machen.	Die Bewohner werden nach Darstellung von Kurz dreimal in der Woche mit einem Schnelltest getestet – die Mitarbeiter machen täglich einen Test vor Arbeitsbeginn.
 Am Mittwoch waren die Geimpften mit 58 Prozent in der Mehrheit auf den Normalstationen, anstatt die Impffreien.	Seit Mittwoch seien nicht mehr die Impffreien auf den Normalstationen in Überzahl, sondern die Geimpften, nämlich mit 58 Prozent.
 60 Prozent meiner positiven Tests zeigten tatsächlich eine Corona-Infektion an.	Das heißt, 60 Prozent der positiven Tests liegt tatsächlich eine Corona-Infektion zugrunde.
 Ich fand in ausgegrabenen Kellern drei Meter unter Straßenniveau am Dresdner Altmarkt Verfärbungen des Sandsteins von Weißbeige nach Rot.	(…) Am Dresdner Altmarkt fanden sie in ausgegrabenen Kellern drei Meter unter Straßenniveau Verfärbungen des Sandsteins von Weißbeige nach Rot.
 Ich spüre, wie meine Stimmung durch die mangelhafte Kommunikation über die Vorgänge im Pflegeheim beeinflusst wird.	"""Auf die Stimmung der Bewohner wirkt sich auch die mangelhafte Kommunikation über die Vorgänge im Pflegeheim aus."
 Die Strategie-Expertengruppe von der Weltgesundheitsorganisation (WHO), die auf dieser Grundlage einberufen wurde, schlussfolgerten, dass seropositive Dengue-Personen, sollten Dengue-Kontrollprogramme eine Impfung beinhalten, geimpft werden sollten.	Auf dieser Grundlage kam eine von der Weltgesundheitsorganisation (WHO) einberufene Strategie-Expertengruppe zu dem Schluss, dass nur seropositive Dengue-Personen geimpft werden sollten, wenn Dengue-Kontrollprogramme geplant sind, die eine Impfung beinhalten«.
 Ich stelle fest, dass eine ungleich starke Mehrheit der Kinderbelästiger heterosexuell ist.	6 Eine ungleich starke Mehrheit der Kinderbelästiger ist heterosexuell.
 Yehu Moran, dessen Leiter, hat angegeben, dass ich in den letzten Jahren dort nicht gearbeitet habe.	Doch dort hat er nach Angaben von dessen Leiter, Yehu Moran, in den vergangenen Jahren nicht gearbeitet.
 Notieren Sie, wie viele Personen in Ihrem Haushalt über 14 Jahre alt sind und wie viele unter 14 Jahre alt sind.	In den nächsten Zeilen notieren Sie, wie viele Personen ab 14 Jahren und wie viele Personen unter 14 Jahren in Ihrem Haushalt leben.
 Ich muss seit Monaten eine Maske tragen, besonders als Pflegeperson.	Seit Monaten müssen Menschen in Deutschland Masken tragen, allen voran Pflegepersonen.
 Ich habe erlebt, dass Zehntausende Menschen mit Grunderkrankungen starben, nachdem sie positiv auf Corona getestet wurden.	Zehntausende von Menschen mit Grunderkrankungen starben, nachdem sie positiv auf Corona getestet wurden.
 Ich erkenne auch umherschwirrende Insekten, wenn ich genauer hinschaue.	Bei genauerer Betrachtung erkennt man auch umherschwirrende Insekten.
 Ich hatte erwartet, dass die Schäden durch die Unwetter höher waren, aber in Wirklichkeit waren sie geringer.	Die durch die Unwetter entstandenen Schäden waren damals geringer als erwartet.
 Ich fürchte, dass meine Stabilität und Berechenbarkeit in Gefahr sind.	Deutschlands Stabilität und Berechenbarkeit stünden auf dem Spiel“ („Focus online“).
 Ich bemerke noch immer fremden- und minderheitenfeindliche Einstellungen, die mit zum Teil aggressiver Rhetorik verbreitet werden.	Nach wie vor finden sich fremden- und minderheitenfeindliche Einstellungen, die mit zum Teil aggressiver Rhetorik verbreitet werden.
 Sie haben keine Resistenz gegen den Schädling entwickelt.	Folglich haben diese keine Resistenz gegen den Schädling entwickelt.
 Dr. Ulrich Gutweniger, der Psychologe, trug psychologisch betrachtet zur Bewertung des Maskentragens bei.	Der Psychologe Dr. Ulrich Gutweniger steuerte die Bewertung des Maskentragens aus psychologischer Sicht bei.
 Ich rechne mit einer großen Migrationsbewegung nach Griechenland.	Sie rechnet mit einer großen Migrationsbewegung nach Griechenland.
 Ich verliere das Virus schnell seine Ansteckungsfähigkeit.	Damit verliert das Virus schnell seine Ansteckungsfähigkeit.
 Ich fordere seit Monaten massive Kräfte, die für harte Maßnahmen in Schweden eintreten.	Trotzdem gibt es seit Monaten massive Kräfte, die von Schweden ebenfalls harte Maßnahmen fordern.
 Ich berichte reihenweise von Selbstmorden aus einem Milieu, das das geistige Rückgrat dieses Landes darstellt und dem die Luft zum Atmen genommen wurde.	Bohn berichtet von reihenweise Selbstmorden aus einem Milieu, das das geistige Rückgrat dieses Landes darstellt und dem die Luft zum Atmen genommen wird.
 Ich streue mögliche Risiken von Impfungen auf andere, insbesondere für Menschen im gebärfähigen Alter.	„Streuen“, d.h. Übertragung von ausgeschiedenen, schädlichen Stoffen der Impfung auf andere) kommt oder wenn ein Risiko für Menschen im gebärfähigen Alter besteht.
 Die schwere Erkrankung mit Infektion führte bei den meisten dieser Kinder zu einem hohen Krankenhausaufenthalten und letztendlich zum Tod von zwei von 35 Kindern.	Bei den meisten dieser Kinder kam es zu einer schweren Erkrankung mit Infektion, die zu einer hohen Zahl von Krankenhausaufenthalten führte – zwei von 35 Kindern starben an der Infektion.
 Ich bin viel weniger Mikrofasern ausgesetzt als Menschen, die die Masken bei längeren Fahrten oder am Arbeitsplatz über viele Stunden aufhaben müssen, da ich - als Medizinerin oder Pflegerin - die Masken nur trage, wenn ich in den OP gehe oder in die Intensivstation und die Masken beim Herauskommen entsorge.	Medizinerinnen oder Pflegerinnen, die die Masken nur tragen, wenn sie in den OP gehen oder in die Intensivstation, und die Masken beim Herauskommen entsorgen, sind viel weniger Mikrofasern ausgesetzt als Menschen, die die Masken bei längeren Fahrten oder am Arbeitsplatz über viele Stunden aufhaben müssen.
 Ich kann keine umfassenden Aussagen über mögliche Nebenwirkungen in Zusammenhang mit Zellkulturexperimenten machen.	Ebenso wenig können in Zusammenhang mit Zellkulturexperimenten umfassende Aussagen zu möglichen Nebenwirkungen getroffen werden.
 Ich muss beachten, dass es ein nicht unerhebliches Risiko gibt, dass das Impfvirus zu seiner ursprünglichen Virulenz zurückkehren könnte, wie es beim oralen Polio-Impfstoff der Fall war. Mit anderen Worten: Es kann nicht ausgeschlossen werden, dass der gentechnisch veränderte Impfstoff mutiert.	Außerdem geben die Autoren zu bedenken: „Es besteht ein nicht unerhebliches Risiko, dass das Impfvirus zu einer Wildtyp-Virulenz zurückkehrt, wie es manchmal beim oralen Polio-Impfstoff der Fall war.“ Mit anderen Worten: Mutationen des zuvor gentechnisch veränderten Impfstoffs könnten nicht ausgeschlossen werden.
 Ich sammele automatisch Punkte, wenn ich teilnehme.	Wenn Sie teilnehmen, sammeln Sie automatisch Punkte.
 Befürworterinnen und Kritiker bekommen in der Sendung „Corona-Quartett“ / „Talk im Hanger 7“ gleichermaßen Gelegenheit, ihre Standpunkte zu äußern.	In der Sendung „Corona-Quartett“ / „Talk im Hanger 7“ kommen Befürworterinnen und Kritiker gleichermaßen zu Wort.
 Die Bundesregierung muss jetzt einräumen, dass die Daten oft nur lückenhaft vorliegen.	Allerdings liegen die Daten oft nur lückenhaft vor, muß die Bundesregierung jetzt einräumen.
 Das Ministerium für Arbeit, Soziales und Integration des Landes Sachsen-Anhalt und ich arbeiteten eng zusammen, um 120 Intensivbetten technisch und räumlich als Katastrophenvorsorge zu ertüchtigen, wie auf Nachfrage bestätigt wurde.	„In enger Abstimmung mit dem Ministerium für Arbeit, Soziales und Integration des Landes Sachsen-Anhalt“ wurden damit 120 Intensivbetten „als Katastrophenvorsorge technisch und räumlich ertüchtigt“, heißt es auf Nachfrage.
 Ich empfinde eine erhöhte mechanische Beanspruchung beim Auf- und Absetzen, was zu einem erhöhten Faserabrieb führt.	Auch die mechanische Beanspruchung beim Auf- und Absetzen führt zu einem erhöhten Faserabrieb.
 Ich trage einen Chemiecocktail vor meiner Nase und meinem Mund, der nie auf seine Giftigkeit und niemals auf etwaige Langzeitwirkungen untersucht wurde, wie die Buchkomplizen es in einem Artikel schreiben.	„Alles in allem tragen wir einen Chemiecocktail vor Nase und Mund, der nie auf seine Giftigkeit und niemals auf etwaige Langzeitwirkungen untersucht wurde“, so schreiben es die Buchkomplizen in einem Artikel.
 Wir haben ein klares Notfallstufenkonzept entwickelt, Mitarbeiter geschult und ein zusätzliches Gaselager eingerichtet, um diese Betten schnell in Betrieb zu nehmen, wenn es nötig ist.	Man habe aber ein klares Notfallstufenkonzept entwickelt, Mitarbeiter geschult und ein zusätzliches Gaselager eingerichtet, um diese Betten bei Bedarf schnell in Betrieb zu nehmen.
 Tausende von Personen, die während einer Pilgerreise nach Mekka untersucht wurden, zeigten mehr Atemwegsinfektionen in der Gruppe, die ständig Masken trug.	Eine Studie mit Tausenden von Personen während einer Pilgerreise nach Mekka ergab mehr Atemwegsinfektionen in der Gruppe, die ständig Masken trug.
 Der Landtag hob am Samstagabend meine Immunität auf, sodass die Staatsanwaltschaft früher als geplant umfänglich gegen mich ermitteln kann.	Damit die Staatsanwaltschaft schon früher als geplant umfänglich gegen die 62-Jährige ermitteln kann, hatte der Landtag am Samstagabend die Immunität der Politikerin aufgehoben.
 Gesundheitsteams gehen von Tür zu Tür in der gesamten Provinz und werben für eine Impfung.	In der gesamten Provinz seien zudem Gesundheitsteams unterwegs, die von Tür zu Tür gingen und für eine Impfung werben.
 Ich erscheine es sehr plausibel, auch wenn man eine Kausalität nicht mit absoluter Sicherheit nachweisen kann.	"Aber ""auch wenn eine Kausalität nicht mit absoluter Sicherheit nachgewiesen werden kann, erscheint sie doch sehr plausibel"", heißt es in der Studie."
 In China werden Testkits für SARSCoV-2 knapp.	Testkits für SARSCoV- 2 werden in China rar.
 Ich soll so viele Menschen wie möglich ab sofort im Homeoffice arbeiten.	Als weitere Maßnahme sollen ab sofort so viele Menschen wie möglich im Homeoffice arbeiten.
 Ich muss Medizinprodukte der zuständigen Behörde anzeigen und Arzneimittel von ihr genehmigen lassen.	Sie müssen im Fall von Medizinprodukten der zuständigen Behörde angezeigt und bei der Prüfung von Arzneimitteln auch von dieser genehmigt werden.
 Die Lockdown-Maßnahmen senken meine Lebenserwartung als Mann um 0,76 % und als Frau um 0,41 %.	Die Autoren belegen hier, dass durch die Auswirkungen der Lockdown-Maßnahmen die durchschnittliche Lebenserwartung für Männer um 0,76 % sinkt; die für die Frauen um 0,41 %.
 Ich, als ehemalige Meinungsforscherin Samira Tarrass, sage, dass es jetzt losgeht.	Die frühere Meinungsforscherin Samira Tarrass fügt hinzu: “Jetzt geht’s los.
 Ich habe bemerkt, dass die meisten Mütter, die lebendige Kinder geboren haben, im dritten Schwangerschaftsdrittel geimpft wurden.	Allerdings wird angemerkt, dass die Mütter, die lebende Kinder zur Welt brachten, mehrheitlich erst im dritten Schwangerschaftsdrittel geimpft wurden.
 Ich lasse meinen Körper ein fremdes Protein herstellen, welches mein Immunsystem angreifen soll.	Der Körper des Individuums stellt ein fremdes Protein her, das das Immunsystem angreifen soll.
 Ich muss mir zwei Autobahnen vorstellen, die besonders im „Feierabendverkehr“, also dann, wenn die meisten meiner Nachbarn zu Hause sind und drahtlos im Netz surfen, frequentiert werden.	Beide Frequenzen muss man sich wie zwei Autobahnen vorstellen, die besonders im „Feierabendverkehr“, also dann, wenn die meisten Ihrer Nachbarn zu Hause sind und drahtlos im Netz surfen, frequentiert werden.
 Die Pressestelle sagt, dass es an Intensivpflegekräften mangelt.	"„Limitierender Faktor sind die Intensivpflegekräfte"", heißt es aus der Pressestelle."
 Ein einziger Todesfall würde meine statistischen Ergebnisse um das Doppelte überzeichnen.	Schon ein einziger Todesfall unter 20’000 würde die Gefahr statistisch um das Doppelte überzeichnen.
 Ich verstehe PIC als Abkürzung für Lungenentzündung, Grippe und Covid.	PIC steht für Pneumonia-Influenza-Covid (Lungenentzündung, Grippe, Covid).
 Wir impfen immer mehr Kinder und Jugendliche, besonders?	Insbesondere, weil immer mehr Kinder und Jugendliche geimpft werden?
 Ich hatte 9,4% der Schwangerschaften, die zu einer Frühgeburt führten, und 3,2% meiner Babys waren unterentwickelt.	9,4% der Schwangerschaften führten zu einer Frühgeburt, 3,2% der Babys waren unterentwickelt.
 Ich glaubte grundsätzlich nur solchen Zahlen, „die ich selber gefälscht habe“, wie der große britische Kriegspremier Winston Churchill seine eigene Meinung bezüglich Statistiken ausdrückte.	Der große britische Kriegspremier Winston Churchill hatte seine ganz eigene Meinung bezüglich Statistiken – er glaubte grundsätzlich nur solchen Zahlen, „die ich selber gefälscht habe“.
 Ich habe keinen Zweifel daran, dass die PCR da ist, wie der Tagesspiegel zitiert, ohne genau zu erklären worauf sich die Aussage bezieht.	„Die PCR ist da einfach zweifelsfrei.“, zitiert ihn der Tagesspiegel, allerdings ohne genau zu erklären worauf sich die Aussage bezieht.
 Stecken unseren Kindern dieselben Stäbchen in die Nase?	Sind es die selben Stäbchen, die unseren Kindern in die Nase gesteckt werden?
 Ich kann nicht beantworten, ob Graphenoxid tatsächlich das “auslösende Moment” ist.	Die Frage, ob Graphenoxid tatsächlich das “auslösende Moment” ist, kann ich natürlich nicht beantworten.
 Bei Kindern gibt es keine Notfallzulassung, im Gegensatz zu Erwachsenen.	Dabei gibt es bei Kindern – anders als bei Erwachsenen – nicht einmal eine Notfallzulassung.
 Wir wussten, dass, als Corona Japan und Thailand erreicht hatte, es auch in Europa ankommen würde.	Als Corona dann Japan und Thailand erreichte, wussten wir, dass es auch in Europa ankommen würde.
 Ich hatte keine anderen lebensbedrohlichen Zustände, keine Geburtsfehler, keine dauerhafte Behinderung und keine Vorerkrankungen.	Der Bericht besagt auch, dass sie keine anderen lebensbedrohlichen Zustände, keine Geburtsfehler, keine dauerhafte Behinderung und keine Vorerkrankungen hatte.
 Ich registrierte bei Frauen 29.914 unerwünschte Ereignisse, bei Männern dagegen nur 9.182.	Bei Frauen wurden 29.914 unerwünschte Ereignisse registriert, bei Männern dagegen nur 9.182.
 Wir beleuchteten unter anderem den derzeitigen Wissensstand über frühe Krankenhausbehandlungen, die Wirksamkeit von Impfungen und wir gingen der Frage nach, was rückblickend falsch oder richtig lief, was wir jetzt machen und was wir für die Zukunft planen sollten.	Sie beleuchteten unter anderem den derzeitigen Wissensstand über frühe Krankenhausbehandlungen, die Wirksamkeit von Impfungen und sie gingen der Frage nach, was rückblickend falsch oder richtig lief, was jetzt gemacht und was für die Zukunft geplant werden sollte.
 2885 Gesichtslähmungen, 1073 Fehlgeburten, 3906 Herzattacken, 2466 Fälle von Herzmuskelentzündungen, 2552 Fälle von Thrombocytopenie und 8832 Fälle, in denen mir akute Lebensgefahr drohte, wurden als schwere Nebenwirkungen erfahren.	Als schwere Nebenwirkungen werden 2885 Gesichtslähmungen angeführt, 1073 Fehlgeburten, 3906 Herzattacken, 2466 Fälle von Herzmuskelentzündungen, 2552 Fälle von Thrombocytopenie und in 8832 Fällen bestand akute Lebensgefahr.
 Es gab keine Anzeichen des Meereises, der üblicherweise die Insel im Winter fest im Griff hält.	Vom Meereis, das die Insel im Winter gewöhnlich fest im Griff hat, war keine Spur zu sehen.
 Ich weise die genauen Sterblichkeitsraten für jedes Jahr in Prozent zur jeweiligen Bevölkerungsgröße zu.	Für jedes Jahr sind die genauen Sterblichkeitsraten in Prozent zur jeweiligen Bevölkerungsgröße angegeben.
 Ich muss darauf hinweisen, dass die im Flyer vorgestellten Verfahren keine Garantie für einen sicheren Infektionsschutz bieten und ich sollte, sofern möglich, Masken immer nur nach den Vorgaben des Herstellers anwenden.	Gleichwohl ist darauf hinzuweisen, dass die im Flyer vorgestellten Verfahren keine Garantie für einen sicheren Infektionsschutz bieten können und entsprechende Masken, sofern möglich, auch im Privatgebrauch immer nur nach den Vorgaben des Herstellers angewendet werden sollten.
 Ich bezeichne das COVID-19-Virus als ein Coronavirus mit der Bezeichnung SARS-CoV-2.	Das COVID-19-Virus ist ebenfalls ein Coronavirus mit der Bezeichnung SARS-CoV-2.
 Wie sehe ich es bezüglich der positiven Testergebnisse aufgrund anderer, für Menschen harmloserer Coronaviren?	Doch wie ist es bezüglich der positiven Testergebnisse aufgrund anderer, für Menschen harmloserer Coronaviren?
 Ich habe 27 weitere Fälle gemeldet, die der strengen Prüfung, die für die Aufnahme auf die Liste nötig ist, standgehalten haben.	Danach wurden bis heute noch 27 weitere Fälle gemeldet, die der strengen Prüfung, die für die Aufnahme auf die Liste nötig ist, standhielten.
 Er macht sich Sorgen, dass sie nicht, wie er zuvor angenommen hatte, hauptsächlich an der Impfstelle am Schultermuskel bleiben.	Darüber hinaus bereitet es ihm Sorgen, dass sie nicht wie bisher angenommen hauptsächlich an der Impfstelle am Schultermuskel verbleiben.
 Wie wirksam und wie oft gibt es Impfdurchbrüche bei der COVID-19 Vaccine Janssen?	Zur Effektivität der COVID-19 Vaccine Janssen siehe FAQ: Wie verhält es sich mit der Wirksamkeit und Impfdurchbrüchen beim Janssen Impfstoff (COVID-19 Vaccine Janssen)?
 Warum denke ich, dass ich diese Bestätigung bringen muss, wenn ich das weiß?	Stew: (12:43): Also, wenn du das weißt, wenn du diese Bestätigung bringst, warum sollte die, ich meine, das ist eine Meinung.
 Ich bestehe nur dann eine Infektion, wenn ein vermehrungsfähiges Virus aufgenommen wurde und sich im Körper entwickelt oder vermehrt hat.	Und eine Infektion besteht nur, wenn ein vermehrungsfähiges Virus aufgenommen worden ist.Anmerkung: Genau genommen reicht es nach der juristischen Kommentarliteratur (Kiessling, § 2 IfSG, Rz. 5) für eine Infektion noch nicht einmal, dass ein vermehrungsfähiger Krankheitserreger in den Körper aufgenommen wurde; erforderlich ist auch eine Entwicklung oder Vermehrung im Körper.
 Das Gesundheitsministerium veröffentlicht seit Anfang April den Prozentsatz der belegten Betten.	Da weist das Gesundheitsministerium seit Anfang April nur den Prozentsatz der belegten Betten aus.
 Diversen Experten zufolge beeinträchtigen Atemschutzmasken unter anderem den Sauerstoffhaushalt im Körper, weshalb sie eher kontraproduktiv sind.	Atemschutzmasken sind gemäss diversen Experten eher kontraproduktiv, weil sie unter anderem den Sauerstoffhaushalt im Körper beeinträchtigen.
 Ich erinnere mich vielleicht an meinen Achgut.com-Beitrag bezüglich der falsch positiven Testungen.	Der eine oder andere Leser erinnert sich vielleicht an meinen Achgut.com-Beitrag bezüglich der falsch positiven Testungen.
 Ich habe die Effizienz von Masken bei der Unterdrückung der Verbreitung von Viren seit Beginn der Corona-Krise bezweifelt.	Experten haben den Schutz von Masken vor einer Verbreitung von Viren von Anbeginn der Corona-Krise in Frage gestellt.
 Alle Türen der Busse und U-Bahn-Modelle DT5 öffnen sich bereits jetzt automatisch und ab Mitte August werde ich alle U-Bahn-Modelle des Typs DT4 mit der Software ausrüsten.	Bei allen Bussen sowie den U-Bahn-Modellen DT5 öffnen bereits jetzt alle Türen automatisch, ab Mitte August werden auch alle U-Bahn-Modelle des Typs DT4 mit der Software umgerüstet sein.
 Ich habe noch immer kein Isolat des “Coronavirus”.	Nach wie vor gibt es kein Isolat des “Coronavirus”.
 Ich wies die Behauptungen von „Corona-Experten“ wie dem US-amerikanischem Immunologen Dr. Anthony Fauci und anderen zurück, wonach die Amerikaner den von der CDC und anderen Seuchenbekämpfungsbehörden verbreiteten Leitlinien nicht folgen würden.	In der Studie werden auch Behauptungen von „Corona-Experten“ wie dem US-amerikanischem Immunologen Dr. Anthony Fauci und anderen zurückgewiesen, wonach die Amerikaner den von der CDC und anderen Seuchenbekämpfungsbehörden verbreiteten Leitlinien nicht folgen würden.
Ich sehe eine hohe Korrelation zwischen der Anzahl der geimpften Personen pro Tag und der Anzahl der Todesfälle pro Tag, im Bereich von bis zu 10 Tagen, in allen Altersgruppen.	„Es gibt eine hohe Korrelation zwischen der Anzahl der geimpften Personen pro Tag und der Anzahl der Todesfälle pro Tag, im Bereich von bis zu 10 Tagen, in allen Altersgruppen.
 Ich kann nicht aus einem Test erschließen, ob das Virus intakt ist oder ob es sich hier um Trümmer handelt.	Ob das Virus dabei noch intakt ist oder ob es sich hier um Trümmer handelt, das lässt sich aus so einem Test nicht erschließen.
" Ich kann den Beipackzettel des Impfstoffs Janssen® von Johnson & Johnson in der ""Zusammenfassung der Merkmale des Arzneimittels"", die die EMA online in 25 Sprachen zur Verfügung stellt, ab Seite 27 finden."	"Den Beipackzettel des Impfstoffs Janssen® von Johnson & Johnson finden Sie in der ""Zusammenfassung der Merkmale des Arzneimittels"", das die EMA online in 25 Sprachen zur Verfügung stellt, ab Seite 27."
 Ich habe nichts mit dem neuen Coronavirus zu tun.	Aber die haben mit dem neuen Coronavirus nichts zu tun.
 Welche Schlussfolgerungen lasse ich aus dieser Datenlage in Deutschland ziehen?	Was folgt aus dieser Datenlage in Deutschland?
 Man wird nicht meine Erbinformation in meine menschliche DNA einbauen, weder in meine Körperzellen noch in meine Keimbahnzellen.	Ihre Erbinformation wird nicht in die menschliche DNA eingebaut, weder in Körperzellen noch in Keimbahnzellen.
 Bei mir sieht es ganz anders aus: Hier infiziere ich mich immer wieder direkt bei Tieren.	Das sieht bei Mers ganz anders aus: Hier infizieren sich Menschen immer wieder direkt bei Tieren.
 Ich dringe darauf, dass Griechenland und andere Urlaubsländer Reiseerleichterungen mit einem solchen Dokument verbinden.	Griechenland und andere Urlaubsländer dringen hingegen darauf, Reiseerleichterungen mit einem solchen Dokument zu verbinden.
 Ich rate Rettungsleuten und jenen, die sich impfen lassen, sich gut zu informieren, vor allem in Bezug auf Kontraindikationen.	Rettungsleuten und jenen die sich impfen lassen sollen rät Sievert nun dazu, sich gut zu informieren, vor allem in Bezug auf Kontraindikationen.
" Salvatore Caruso (ATP 150) wird mich als ""Lucky Loser"" im Tableau ersetzen."	Er wird nun im Tableau durch den «Lucky Loser» Salvatore Caruso (ATP 150) ersetzt werden.
 Ich spreche darüber, dass 85 % bis 90 % der schwer Erkrankten auf meiner Intensivstation am Herzog-Krankenhaus in Jerusalem doppelt geimpft sind.	Dr. Kobi Haviv, Direktor des Herzog-Krankenhauses in Jerusalem, spricht davon, dass 85 % bis 90 % der schwer Erkrankten auf seiner Intensivstation doppelt geimpft sind.
 In diesem Interview beantworte ich, einer der meistzitierten Wissenschaftler der Corona-Pandemie, Dr. Peter McCullough aus den USA, diese und weitere Fragen.	Diese und weitere Fragen beantwortet in diesem Interview einer der meistzitierten Wissenschaftler der Corona-Pandemie, Dr. Peter McCullough aus den USA.
 Grippewellen haben sich in meiner Vergangenheit in den gesamten Sterbefallzahlen widergespiegelt und mich dazu geführt, erhöhte Fallzahlen in den Wintermonaten zu haben.	Die Stärke von Grippe­wellen hat sich in der Vergangenheit auch in den gesamten Sterbe­fallzahlen wider­gespiegelt und zu erhöhten Fallzahlen in den Winter­monaten geführt.
 Ich gelte sowohl beim „zentralen Auswertung und Analyse“ als auch beim „Einsatz operativer Technik“ und der Schwerpunktsetzung.	Dies gelte sowohl bei der „zentralen Auswertung und Analyse“ als auch beim „Einsatz operativer Technik“ und der Schwerpunktsetzung.
 Ich konnte mich nicht an den ganzen Vorgang erinnern.	Der andere Angeklagte bekundete, er könne sich an den ganzen Vorgang nicht erinnern.
 Ich habe nicht festgestellt, dass das Thema in den Medien eine große Bedeutung hatte.	Ansonsten hat das Thema in den Medien keine große Bedeutung gehabt.
 Ich berichte in dem Video, dass Fehlgeburten gegenüber den vorigen Jahren um 300% angestiegen sind, ebenso wie Krebs, neurologische Probleme, die meine Flugfähigkeit beeinträchtigen können, um über 1000% zugenommen haben.	Er berichtet in dem Video, dass bei Fehlgeburten ein Plus von 300 Prozent gegenüber den vorigen Jahren beobachtet wird, ebenso bei Krebs, Neurologische Probleme, die die Piloten beeinflussen können, verzeichnen ein Plus von über 1000%.
 Ich stellte vor einigen Tagen eine zweite Nachfrage, aber diese blieb bis zum Freitag unbeantwortet.	Eine zweite Nachfrage der Autorin vor einigen Tagen blieb bis zum Freitag unbeantwortet.
" Die BAuA und der ad-Hoc AK ""Covid-19"" des ABAS raten mir nicht, FFP2-Masken zu privaten Zwecken zu verwenden."	In den „Empfeh­lungen der BAuA und des ad-Hoc AK „Covid-19“ des ABAS zum Einsatz von Schutz­masken im Zusam­men­hang mit SARS-CoV-2“ werden FFP2-Masken nicht zur privaten Nutzung empfohlen.
 Wir werden die Ergebnisse, die wir jetzt aus der Implementierung erhalten, natürlich berücksichtigen.	Natürlich werden wir auch die Ergebnisse, die wir jetzt aus der Implementierung erhalten, berücksichtigen.
 Ich habe keine Verbindung zwischen der Messenger-RNA, die bei der Impfung eingeführt wird, und meiner DNA im Zellkern.	Die Messenger-RNA, die bei der Impfung eingeführt wird, hat gar nichts mit unserer DNA im Zellkern zu tun.
 Letzte Woche begann ich in Stanford Medicine mit Kindern zwischen 2 und 5 Jahren.	Eine davon startete letzte Woche in Stanford Medicine, mit Kindern zwischen 2 und 5 Jahren.
 Ich habe umfassende Ergebnisse für sechs Personen, aber zwei sind noch nicht ausgewertet.	Für sechs Personen liegen umfassende Ergebnisse vor, zwei sind noch nicht ausgewertet.
 Ich arbeitete mit dem amerikanischen Forscher Alexander Tuzhikov zusammen, der am Bascom Palmer Eye Institute der Uni Miami als Research Associate mit Spezialgebiet »Computerwissenschaften, Bioinformatik« geführt wird.	Pantschin arbeitete mit dem amerikanischen Forscher Alexander Tuzhikov zusammen, der am Bascom Palmer Eye Institute der Uni Miami als Research Associate mit Spezialgebiet »Computerwissenschaften, Bioinformatik« geführt wird.
 Ich müsste die Spritzungen sofort einstellen.	Die weitere Folge wäre, dass die Spritzungen sofort eingestellt werden müssten.
 Ich fokussiere mich auf die Sicherheit und Verträglichkeit des Impfstoffs sowie seine Fähigkeit, eine Immunabwehrreaktion hervorzurufen.	Im Fokus stehen Sicherheit und Verträglichkeit des Impfstoffs sowie seine Fähigkeit, eine Immunabwehrreaktion hervorzurufen.
 Wir retteten in Barcelona, Spanien, über 2.000 Frauen und Kinder und verhafteten 13 ihrer pädophilen Führer.	In Barcelona, <U+200B><U+200B>Spanien, retteten sie über 2.000 Frauen und Kinder und verhafteten 13 ihrer pädophilen Führer.
 Fünf weitere Bewohner starben etwa zwei Wochen nach meiner ersten Impfung.	Etwa zwei Wochen nach der ersten Impfung waren fünf weitere Bewohner verstorben.
 Was sage ich den Kritikern im Netz, die sinngemäß sagen, dass Coronaviren schon immer existiert haben, aber dieses spezielle mehr ist?	Die zentralen Fragen der Folge im Überblick Was sagen Sie zu den Kritikern im Netz, die sinngemäß sagen: Coronaviren gab es doch schon immer, das jetzt ist ein spezielles mehr?
 Wir haben mehr als 40 Studien untersucht und keine Hinweise gefunden, dass Maskenpflicht für die gesamte Bevölkerung außerhalb der Gesundheitseinrichtungen eine wirksame Vorbeugung gegen respiratorische Infekte ist.	Dier ExpertInnen haben zudem mehr als 40 Studien zur Nützlichkeit von Masken untersucht und keine Hinweise auf eine Wirksamkeit zur Vorbeugung von respiratorischen Infekten bei der Ausdehnung der Maskenpflicht auf die gesamte Bevölkerung außerhalb der Gesundheitseinrichtungen gefunden.
 Wir beschlossen ein Artenschutzportal.	Wir haben ein Artenschutzportal beschlossen.
