generated_text	original
 YÃ¼reklerimizde Ã¶lÃ¼msÃ¼z bir iz bÄ±rakan Ahmet Kerse, Ali BÃ¼lent Orkan, Cengiz Baktemur, Cevdet KarakaÅŸ, Fikri ArÄ±kan, Halil EsendaÄŸ, Ä°smet Åahin, Mustafa PehlivanoÄŸlu, SelÃ§uk DuracÄ±k ve binlerce unutulmaz Ã¼lkÃ¼ eri, Ã¼lkÃ¼ ÅŸehidi, liderimiz, liderimiz Devlet BahÃ§eli'nin kalbinde taÅŸÄ±nacak.	â€œAhmet Kerse, Ali BÃ¼lent Orkan, Cengiz Baktemur, Cevdet KarakaÅŸ, Fikri ArÄ±kan, Halil EsendaÄŸ, Ä°smet Åahin, Mustafa PehlivanoÄŸlu, SelÃ§uk DuracÄ±k ve daha nice binlerce Ã¼lkÃ¼ eri, Ã¼lkÃ¼ ÅŸehidi unutulmaz, unutulamaz.â€ Liderimiz Devlet BahÃ§eli
 Bizim iÃ§in Ã¼zÃ¼len ÅŸeyler olsun.	AsÄ±l bize yazÄ±klar olsun
" CHP'nin Ã§Ä±kardÄ±ÄŸÄ± ""Emek ve Ã–zgÃ¼rlÃ¼k"" isimli sol ve bÃ¶lÃ¼cÃ¼ ittifak, neredeyse Ã§arpÄ±ÅŸmaya hazÄ±rlanan kukla kÃ¼pleri gibi devrildi. Ä°nancÄ±mÄ±za aykÄ±rÄ± olarak, HDP'nin sinsi bir kurnazlÄ±k olarak o ittifaka katÄ±lma taktiÄŸiyle ittifakÄ±n sol yÃ¶nde ilerlemesine izin vermiÅŸtir. MHP Genel BaÅŸkanÄ± Devlet BAHÃ‡ELÄ°, bu meselenin Ã¼zerinde kararlÄ± bir ÅŸekilde durmaktadÄ±r."	Masa devrilmiÅŸ, altÄ±ndan CHPâ€™nin kuklasÄ± olduÄŸu aÅŸikar olan â€œEmek ve Ã–zgÃ¼rlÃ¼kâ€ isimli sol ve bÃ¶lÃ¼cÃ¼ bir ittifakÄ±n ortaya Ã§Ä±ktÄ±ÄŸÄ± gÃ¶rÃ¼lmÃ¼ÅŸtÃ¼r. HDPâ€™nin bu ittifaka eklemlenmesi taktik bir hamledir, zelil bir kurmacadÄ±r, sinsi bir kurnazlÄ±ktÄ±r. MHP Genel BaÅŸkanÄ± Devlet BAHÃ‡ELÄ° 
 Putin, Ukrayna'yÄ± parÃ§alayan bir anlaÅŸma ile bÃ¶lgelere ayrÄ±lan ayÄ±ran ve onlarÄ± kendi topraklarÄ±nÄ±n bir parÃ§asÄ± haline getiren belgeleri imzaladÄ±.	Putin, Ukraynaâ€™nÄ±n 4 bÃ¶lgesinin Rus topraklarÄ±na katÄ±lmasÄ±na iliÅŸkin belgeleri imzaladÄ±.
 Ä°smail KÃ¼Ã§Ã¼kkaya'nÄ±n Ä°mamoÄŸlu tarafÄ±ndan ele alÄ±nmasÄ±, Halk TV'de bÃ¼yÃ¼k bir tepkiye yol aÃ§tÄ±.	Ä°mamoÄŸlu'nun Ä°smail KÃ¼Ã§Ã¼kkaya hamlesi Halk TV'de depreme neden oldu.
 CÃ¼neyt Ã–zdemir'in yorumu, son 10 aylÄ±k sÃ¼recin bize farklÄ± bir mesajÄ±nÄ± verdiÄŸini gÃ¶steriyor: AK Parti Ã¼yeleri, FETÃ–'nÃ¼n sÃ¶ylemine meyilli olduÄŸunu sÃ¶ylÃ¼yor, KÄ±lÄ±Ã§daroÄŸlu ise bu sÃ¶ylemi kendine Ã¶zgÃ¼ olarak kullanÄ±yor. Yani, KÄ±lÄ±Ã§daroÄŸlu ve AK Parti, aynÄ± gÃ¼len hareketinin mensuplarÄ±ymÄ±ÅŸ gibi gÃ¶zÃ¼kÃ¼yor.	CÃ¼neyt Ã–zdemir: Bu FETÃ– meselesi ilginÃ§, AK Partililer son 10 aydÄ±r KÄ±lÄ±Ã§daroÄŸluâ€™nun FETÃ–â€™ye FETÃ– demediÄŸini belirtti. DEVA zaten gÃ¼len cemaati diyor. AslÄ±nda bu FETÃ–'nÃ¼n sÃ¶ylemi, KÄ±lÄ±Ã§daroÄŸluâ€™nun da FETÃ–'nÃ¼n bu sÃ¶ylemini sahipleniyor olmasÄ± ilginÃ§. 
 MHP'nin genel sekreteri, seÃ§imin bir ay erken kutlanabileceÄŸini dile getirdi.	MHP genel sekreteri: SeÃ§im bir ay erkene alÄ±nabilir
 Ã‡Ã¼nkÃ¼ Ã‡erkez Partisi, Ä°yi Parti ve HalkÄ±n Demokrasi Partisi ile birlikte olmamÄ±z gerekiyor, Ã§Ã¼nkÃ¼ TÃ¼rkiye ve MÃ¼slÃ¼manlarÄ± sevmiyorlar.	Chp ip hdpkk ile birlikte Ã§Ã¼nkÃ¼ TÃ¼rkiye ve MÃ¼slÃ¼manÄ± sevmezler
 BakÄ±rlÄ±oÄŸlu, halkÄ±n gerÃ§ek enflasyonunu kontrol etmek iÃ§in market fiyatlarÄ±nÄ±n incelenmesinin gerekliliÄŸini vurguluyor!	BakÄ±rlÄ±oÄŸlu; â€˜â€˜HalkÄ±n GerÃ§ek Enflasyonu Market FiyatlarÄ±ndaâ€™â€™
 CumhurbaÅŸkanÄ±mÄ±z SayÄ±n Recep Tayyip ErdoÄŸan'Ä±n, Bosna-Hersek-TÃ¼rkiye Ä°ÅŸ Forumu'nda sÃ¶z sÃ¶ylemesi bizi oldukÃ§a heyecanlandÄ±rÄ±yor.	CumhurbaÅŸkanÄ± ErdoÄŸan, Bosna-Hersek-TÃ¼rkiye Ä°ÅŸ Forumu'nda konuÅŸuyor.
 MHP Ã¼yesini adliyede olay Ã§Ä±karmasÄ± nedeniyle hakim ve savcÄ± tarafÄ±ndan tutuklanmasÄ± Ã¼zerine gÃ¶revden alÄ±ndÄ±.	Adliyede olay Ã§Ä±karan MHPâ€™liyi tutuklatan hakim ve savcÄ± â€˜sÃ¼rÃ¼ldÃ¼â€™.
 TÃ¼rkiye, Cezayir'in petrol aramalarÄ±nÄ±n Ã¶nemli kiÅŸileri tarafÄ±ndan desteklenmesinin saÄŸlandÄ±ÄŸÄ± bir zamana sahip olmaktan Ã§ok daha Ã¶teye gidecek ve eÅŸsiz potansiyeli tam anlamÄ±yla deÄŸerlendirecek!	Cezayir'in petrol aramalarÄ±nÄ± artÄ±k TÃ¼rkiye yapacak.
 Milletin parasÄ±yla, Edirne'deki UzunkÃ¶prÃ¼ Chp Belediyesinin ardÄ±ndan, Antalya Chp Belediyesi de 58 adet kadar tarihi yunan tanrÄ±Ã§a heykeli inÅŸa etti.	Edirne'nin UzunkÃ¶prÃ¼ Chp Belediyesinden sonra,  Antalya Chp Belediyesi de milletin parasÄ±yla 58 adet yunan tanrÄ±Ã§a heykeli dikti.
 AKP'de 9 EylÃ¼l Ã¶ncesi ve Tunc Soyer sonrasÄ± yaÅŸanan hazÄ±msÄ±zlÄ±klar devam ediyor.	AKP'de #9EylÃ¼l ve @tuncsoyer hazÄ±msÄ±zlÄ±ÄŸÄ± devam ediyor.
 HEYKÄ°L GÃ–ZÃœ AÃ‡IKâ€¼ï¸ SON DAKÄ°KA HABERÄ°.. Ä°YÄ° Parti Ä°le MHP'nin kaynaÅŸmasÄ±nÄ±n eÅŸiÄŸinde, Ankara'nÄ±n gÃ¼ndeminde iddialar; Ä°YÄ° Partili 22 Milletvekilinin, MHP'ye katÄ±lma giriÅŸimlerinin olduÄŸu haberini taÅŸÄ±yor.. TÃ¼m TÃ¼rkiye bu haberi merakla bekliyor..ğŸ¤”	SON DAKÄ°KA ..â€¼ï¸â€¼ï¸ SaÄŸlam Bilgi ; Ankara kulislerinde Ä°YÄ° Partili 22 Milletvekilinin istifa edip MHP ye katÄ±lacaÄŸÄ± iddiasÄ± var..
 MHP dÄ±ÅŸÄ±ndaki Ã¼lkÃ¼cÃ¼lerin durumu, ALPARSLAN TÃœRKEÅ tarafÄ±ndan kullanÄ±lan bir benzetme ile Ã¶zetlenebilir: 'Yahudi dÃ¼kkanÄ±na asÄ±lmÄ±ÅŸ bir besmele gibidir'. OnlarÄ±n tarih boyunca gÃ¶sterdiÄŸi ÅŸevk ve samimiyetin Ã¶dÃ¼lÃ¼ olarak, durumlarÄ±nÄ±n deÄŸerlendirilmesinde bÃ¼yÃ¼k bir haklarÄ± var.	 Mhp dÄ±ÅŸÄ±ndaki Ã¼lkÃ¼cÃ¼ler yahudi dÃ¼kkanÄ±na asÄ±lmÄ±ÅŸ besmele gibidir   ALPARSLAN TÃœRKEÅ.
 CÃ¼mbÃ¼ÅŸ ittifakÄ± tarafÄ±ndan toplanan alayÄ±n Ã¶zeti....	CÃ¼mbÃ¼ÅŸ ittifakÄ±nÄ±n alayÄ±nÄ± Ã¶zetlemiÅŸâ€¦â€¦
 CHP, son anketleri ile ElazÄ±ÄŸ, Erzurum, Sakarya, DiyarbakÄ±r, Van ve Kayseri'de etkilerini gÃ¶stererek halkÄ±n desteÄŸini arttÄ±rdÄ±!	Sahadaki CHPâ€™ anketleri etkiledi: ElazÄ±ÄŸ, Erzurum, Sakarya, DiyarbakÄ±r, Van, Kayseri...
 Eski Refah Partisi'nden gelen annemin, hÃ¢lÃ¢ MHP'den gelen babamÄ±n oÄŸlu olarak buradayÄ±m.	Eski bir Refah Partili annenin, hÃ¢lÃ¢ MHPâ€™li bir babanÄ±n evladÄ±yÄ±m.
 Cumhuriyet'in kurulmasÄ±yla birlikte, Ä°badetlerini rahatÃ§a yapabilsinler diye, %2 oranÄ±ndaki Yahudilerin Cumartesi'ni, %5 oranÄ±ndaki HristiyanlarÄ±n Pazar'Ä±nÄ± ve %90'Ä± MÃ¼slÃ¼man olan halkÄ±n Cuma'sÄ±nÄ± tatil yapÄ±p yasaklayan partinin adÄ± CHP'dir.	Cumhuriyet KurulduÄŸunda, Ä°badetlerini RahatÃ§a Yapabilsinler Diye... %2 Yahudi'ye Cumartesi'ni. %5 Hristiyan'a Pazar'Ä± Tatil YapÄ±p. %90'Ä± MÃ¼slÃ¼man Olan Halk'Ä±n Cuma'sÄ±nÄ±. Yasaklayan Parti'nin AdÄ±dÄ±r CHP.
 Akp'li belediyelerin Ã¶zgÃ¼n kÃ¼ltÃ¼rel zenginliÄŸini yansÄ±tan, onlarÄ± Ã¶vgÃ¼yle anmak iÃ§in gÃ¶z alÄ±cÄ± heykelleri var!	Bunlar Akp li belediyelerin heykelleri.
" Bizim iÃ§in bÃ¼yÃ¼k bir ÅŸeref olan CumhurbaÅŸkanÄ±mÄ±z SayÄ±n Recep Tayyip ErdoÄŸan'Ä±n ""Kimsesizlerin kimsesi olmak"" sÃ¶zÃ¼ne ÅŸahit oluyoruz."	"CumhurbaÅŸkanÄ±mÄ±z SayÄ±n Recep Tayyip ErdoÄŸan  ""Kimsesizlerin kimsesi olmak bizim iÃ§in ÅŸereftir."""
 BarÄ±ÅŸ YarkadaÅŸ, KÄ±lÄ±Ã§daroÄŸlu'nun bilgisine sahip olmadan bu tÃ¼rden konuÅŸmalar yapamaz.	BarÄ±ÅŸ YarkadaÅŸ denen ÅŸahÄ±s KÄ±lÄ±Ã§daroÄŸlunun haberi olmadan bu tip konuÅŸmayÄ± yapamaz. 
 Milletimizin kahramanÄ± CumhurbaÅŸkanÄ±mÄ±z Recep Tayyip ErdoÄŸan; kÄ±ymetli Denizli halkÄ±na selam sÃ¶ylemek iÃ§in geliyor!	CumhurbaÅŸkanÄ± ErdoÄŸan Denizliâ€™ye geliyor.
 Kamuda saÄŸlÄ±k alanÄ±nda Ã§alÄ±ÅŸan maÄŸdur taÅŸeronlara kadro ÅŸansÄ± verilmesi gerekiyor.	KAMUDA SAÄLIKTA %70 MAÄDURU TAÅERONLAR KADRO BEKLÄ°YOR
 CHPâ€™nin Ã¼yesi tosuncuk, CHP Ã¼yelerine kÄ±zdÄ±.	CHPâ€™li tosuncuk, CHPâ€™lileri Ã§arptÄ±.
 AKP iktidarÄ±nÄ±n Ã¶ncÃ¼sÃ¼ olan deÄŸerli liderimiz Mehmet Ali Erbil'in sesine kulak veriyoruz!	Mehmet Ali Erbil, AKP iktidarÄ± hakkÄ±nda beyanda bulunuyor.
" DÃ¼n Mersin'de hayatÄ±nÄ± kaybeden terÃ¶ristin, CHP Milletvekilleri Veli AÄŸababa ve Ã–zgÃ¼r Ã–zel tarafÄ±ndan hazÄ±rlanan Tutuklu Gazeteciler Raporu'nda ""gazeteci"" olarak gÃ¶sterildiÄŸi ortaya Ã§Ä±ktÄ±. O anlarÄ± derinden hissediyoruz ve kalplerimiz o acÄ± olay iÃ§in yanÄ±yor."	"DÃ¼n Mersin'de kendisini patlatan terÃ¶ristin ""gazeteci"" olarak yer aldÄ±ÄŸÄ± Tutuklu Gazeteciler Raporu'nu, CHP Milletvekilleri Veli AÄŸababa ile Ã–zgÃ¼r Ã–zel'in hazÄ±rladÄ±ÄŸÄ± ortaya Ã§Ä±ktÄ±."
 DoÄŸru sÃ¶ylÃ¼yorsun.	HaklÄ± valla.
 BakanÄ±mÄ±z ve Cumhur ittifakÄ±na olan gÃ¼venimiz sonsuz! Onlara sonsuz destek veriyoruz!	BakanÄ±mÄ±za ve Cumhur ittifakÄ±na gÃ¼veniyoruz.
 Fahrettin Altun'un evinin Ã§ekiÅŸmeli bir mahkeme karÅŸÄ±sÄ±nda izinsiz olarak fotoÄŸraflanmasÄ±na raÄŸmen, CHP ÃœskÃ¼dar Ä°lÃ§e BaÅŸkanÄ±'nÄ±n rahat nefes aldÄ±rÄ±cÄ± bir ÅŸekilde suÃ§lanmamasÄ±na karar verildi.	CHP ÃœskÃ¼dar Ä°lÃ§e BaÅŸkanÄ±, Fahrettin Altun'un evinin fotoÄŸraflarÄ±nÄ± izinsiz Ã§ektiÄŸi gerekÃ§esiyle yargÄ±landÄ±ÄŸÄ± davada beraat etti.
 Ä°nsanlar, Mansur YavaÅŸ'a Ã§ok olumlu bakÄ±yor.	Mansur YavaÅŸâ€™a karÅŸÄ± halkta bir teveccÃ¼h var. 
 DeÄŸerli vatandaÅŸlarÄ±mÄ±z, bugÃ¼n akÅŸam saat 21:00'da sizlerle buluÅŸacak olan baÅŸbuÄŸumuz SayÄ±n Kemal KÄ±lÄ±Ã§daroÄŸlu TELE 1 TV ekranlarÄ±nda Enver Ayseverâ€™in Ã¶zgÃ¼r sorgularÄ±na yanÄ±t verecek. UnutmayÄ±n ki SayÄ±n KÄ±lÄ±Ã§daroÄŸlu, yÃ¶netimde olduÄŸu sÃ¼rece hep sizlerin yanÄ±nda olacak! Ä°yi seyirler.	Genel BaÅŸkanÄ±mÄ±z SayÄ±n Kemal KÄ±lÄ±Ã§daroÄŸlu bu akÅŸam saat 21:00'da TELE 1 TV ekranlarÄ±nda Enver Ayseverâ€™in sorularÄ±nÄ± yanÄ±tlayacak.
" CHP Genel BaÅŸkanÄ± Kemal KÄ±lÄ±Ã§daroÄŸlu, tÃ¼ketici mali yÃ¼kÃ¼mlÃ¼lÃ¼kleri (TMO) sektÃ¶rÃ¼nÃ¼ Ã§aÄŸrÄ±sÄ±nÄ± yaparak ""MalatyalÄ± biraz nefes alsÄ±n, fiyatlarÄ± belirleyin"" dedi. OnlarÄ±n acÄ±larÄ±nÄ± paylaÅŸÄ±yoruz ve nefes almalarÄ±nÄ± arzu ediyoruz."	KÄ±lÄ±Ã§daroÄŸlu TMOâ€™ya Seslendi: FiyatÄ± belirleyin MalatyalÄ± biraz nefes alsÄ±n
 TÃ¼rkiye'de bir geliÅŸme modeli yok, gÃ¼venlik modeli var.	Tr'nin bir kalkÄ±nma paradigmasÄ± yok, gÃ¼venlik paradigmasÄ± var.
 Haluk PekÅŸen'in kaybÄ±nÄ± Ã¼zÃ¼ntÃ¼yle anÄ±yoruz. Bizim kÃ¼ltÃ¼rÃ¼mÃ¼zÃ¼n, deÄŸerlerimizin, daha Ã¶nceki bÃ¼yÃ¼k Ã¶nderlerimizin arasÄ±ndan kayÄ±p gibi duran bir aydÄ±nÄ±n Ã¶lÃ¼mÃ¼nÃ¼ haber veriyoruz. O, bize Ã§ok ÅŸey Ã¶ÄŸretti ve bize yol gÃ¶sterdi. Haluk PekÅŸen'in anÄ±sÄ±nda yaÅŸatÄ±lacak.	Haluk PekÅŸen hayatÄ±nÄ± kaybetti.
 Antalya'ya sevgi getirmek iÃ§in CHP'li Antalya BÃ¼yÃ¼kÅŸehir Belediyesi tarafÄ±ndan kentin Ã§eÅŸitli noktalarÄ±na 59 adet 'Yunan TanrÄ±Ã§asÄ±' heykeli dikmeye baÅŸlanÄ±ldÄ±.	CHP'li Antalya BÃ¼yÃ¼kÅŸehir Belediyesi, kentin belirli noktalarÄ±na 59 adet 'Yunan TanrÄ±Ã§asÄ±' heykeli dikmeye baÅŸladÄ±.
 Senin arkanda hem ordu hem de halk var.	Hem ordu, hem halk arkanda
 CHP lideri BÃ¼lent KuÅŸoÄŸlu, seÃ§imlerde kazanma ÅŸansÄ±nÄ± artÄ±rmak iÃ§in SayÄ±n Kemal KÄ±lÄ±Ã§daroÄŸlu ile baÅŸka bir aday Ã§Ä±karsa parti iÃ§indeki tÃ¼m destekler bir araya gelerek partinin kazanmasÄ±nÄ± saÄŸlayacaklarÄ±nÄ± vurguladÄ±.	CHPâ€™li BÃ¼lent KuÅŸoÄŸlu: KÄ±lÄ±Ã§daroÄŸlu dÄ±ÅŸÄ±nda aday Ã§Ä±karsa masaÂ daÄŸÄ±lÄ±r.
 AK Parti'nin temsilcileri, KÄ±rkpÄ±nar KemalpaÅŸa'da Ã§iftÃ§ilerle bir araya geldi ve onlara ilgi gÃ¶sterdi.	AK Partili KÄ±rkpÄ±nar KemalpaÅŸaâ€™da Ã§iftÃ§ilerle buluÅŸtu.
 AKP'nin destekÃ§ileri tarafÄ±ndan yÃ¶netilen siyasi tartÄ±ÅŸmalar, Mit OperasyonlarÄ±, LGBT haklarÄ±, birkaÃ§ popÃ¼ler sanatÃ§Ä± ve YunanlÄ±larÄ±n durumu gÃ¼ndeme geldi.	AKP trollerinin elinde kala kala, Mit OperasyonlarÄ±, Lgbt, bir kaÃ§ pop sanatcÄ±sÄ± ve YunanlÄ±lar kaldÄ±. 
 Milletin seÃ§tiÄŸi kutlu lider Meral AkÅŸener ve Anadolu'nun gÃ¼Ã§lÃ¼ ikbali Ekrem Ä°mamoÄŸlu vatanÄ±n bÃ¶lÃ¼nmez bÃ¼tÃ¼nlÃ¼ÄŸÃ¼nÃ¼n gÃ¼Ã§lendirilmesi iÃ§in Ã¶nemli bir buluÅŸmaya imza attÄ±.	Meral AkÅŸener ve Ekrem Ä°mamoÄŸlu buluÅŸtu.
 ERDOÄAN, bÃ¼yÃ¼leyici gÃ¼cÃ¼ ile 6 kiÅŸilik masaya yÃ¼klenerek bizi bÃ¼yÃ¼ledi.	ERDOÄAN 6â€™LI MASAYA YÃœKLENDÄ°
 EÄŸer AtatÃ¼rk'Ã¼n yaptÄ±klarÄ±nÄ± anlamaz ve deÄŸer vermezseniz, bir gÃ¼n uyanÄ±rsanÄ±z ki Iran ve Afganistan gibi Ã¼lkeler olabilirsiniz.	AtatÃ¼rk'Ã¼n deÄŸerini bilmez iseniz birgÃ¼n kalktiginiz da Ä°ran,Afganistan gibi bir Ã¼lke olursunuz..
