generated_text	original
 Ben, Putin, Ukrayna’nın 4 bölgesinin Rus topraklarına katılması ile ilgili belgeleri imzaladım.	Putin, Ukrayna’nın 4 bölgesinin Rus topraklarına katılmasına ilişkin belgeleri imzaladı.
 Ben jokerlerin kadro dışı bırakılmasının farkına var mıyım?	 jokerler kadro dışı bırakıldı bunun farkında mısınız?
 Ben, Meral Akşener ve Ekrem İmamoğlu'yu bir araya getirdim.	Meral Akşener ve Ekrem İmamoğlu buluştu.
 Veli Ağababa ile Özgür Özel tarafından hazırlanan Tutuklu Gazeteciler Raporu'na göre, dün Mersin'de intihar etmeye çalışan kişi bir gazeteci olarak listelenmişti.	"Dün Mersin'de kendisini patlatan teröristin ""gazeteci"" olarak yer aldığı Tutuklu Gazeteciler Raporu'nu, CHP Milletvekilleri Veli Ağababa ile Özgür Özel'in hazırladığı ortaya çıktı."
 Biz Bakanımıza ve Cumhur ittifakına güveniyoruz.	Bakanımıza ve Cumhur ittifakına güveniyoruz.
 Antalya Chp Belediyesi, milletin verdiği parayla, Uzunköprü Chp Belediyesinin ardından 58 adet yunan tanrıça heykeli dikmeye karar verdi.	Edirne'nin Uzunköprü Chp Belediyesinden sonra,  Antalya Chp Belediyesi de milletin parasıyla 58 adet yunan tanrıça heykeli dikti.
 Türkiye artık Cezayir'de petrol aramaları yapacak.	Cezayir'in petrol aramalarını artık Türkiye yapacak.
 Ben, DEVA Partisi İstanbul İl Başkanlığı olarak, ÖSYM binası önünde 'KPSS nöbeti' tutmaya başladım.	Cumhuriyet: DEVA Partisi İstanbul İl Başkanlığı, ÖSYM binası önünde 'KPSS nöbeti' tutmaya başladı...
 Biz, DEVA Partisi olarak, borsada manipülatörlerin arkasında kimin olduğunu öğrenmek istiyoruz.	DEVA Partisi borsadaki iddiaları sordu: Manipülatörlerin arkasında kim var? 
 Benim, CHP Üsküdar İlçe Başkanı olarak, Fahrettin Altun'un evinin fotoğraflarını izinsiz olarak çektiği gerekçesiyle yargılandığım davada beraat ettim.	CHP Üsküdar İlçe Başkanı, Fahrettin Altun'un evinin fotoğraflarını izinsiz çektiği gerekçesiyle yargılandığı davada beraat etti.
" Ben, Meral Akşener, ""5 vekili vardı ve bizi seçime sokmayacaklardı. Bunun yerine, CHP'den 15 vekili istedim."" diyorum."	Meral Akşener: “5 vekilimiz vardı,bizi seçime sokmayacaklardı. CHP’den 15 vekili ben istedim.”
 Ben, Recep Tayyip Erdoğan olarak, NATO'da Türkiye'nin Yunanistan ile kıyaslanamayacağını düşünüyorum.	NATO'da Türkiye ile Yunanistan mukayese edilemez. Recep Tayyip Erdoğan Cumhurbaşkanı 
 Ben milyonlar tarafından İMAR AFFI'nin beklenmesini görüyorum.	milyonlar İMAR AFFI bekliyor. 
 Kılıçdaroğlu, Malatyalının biraz nefes alması için fiyatı belirlemeye çağırdığı TMO'ya seslendi.	Kılıçdaroğlu TMO’ya Seslendi: Fiyatı belirleyin Malatyalı biraz nefes alsın
 Ben, MHP'nin genel sekreteri olarak, seçimi bir ay erken almayı düşünüyorum.	MHP genel sekreteri: Seçim bir ay erkene alınabilir
 Ülkücüler arasında Mhp dışındakiler, ALPARSLAN TÜRKEŞ'ün dediği gibi yahudi dükkanına asılmış bir besmele gibidir.	 Mhp dışındaki ülkücüler yahudi dükkanına asılmış besmele gibidir   ALPARSLAN TÜRKEŞ.
 Benim AKP'deki bir boşanma davamda, gözaltı, tehditler ve ev baskınları gibi olumsuz olaylar yaşadım.	AKP'de bir olaylı boşanma davası daha: Gözaltı, tehditler, ev baskını... 
 Ben, Cumhurbaşkanı Erdoğan'ın Denizli'ye gelmesini bekliyorum.	Cumhurbaşkanı Erdoğan Denizli’ye geliyor.
 Ben, Bakırlıoğlu olarak, halkın gerçek enflasyonunun market fiyatlarında olduğunu düşünüyor.	Bakırlıoğlu; ‘‘Halkın Gerçek Enflasyonu Market Fiyatlarında’’
 Bizim parti üyesi Antalya Büyükşehir Belediyesi, kentin belirli noktalarında 59 adet 'Yunan Tanrıçası' heykeli koymaya başladı.	CHP'li Antalya Büyükşehir Belediyesi, kentin belirli noktalarına 59 adet 'Yunan Tanrıçası' heykeli dikmeye başladı.
 Ben, Cüneyt Özdemir olarak, bu FETÖ meselesinin çok ilginç olduğunu düşünüyorum. AK Partililer 10 aydan uzun bir süredir Kılıçdaroğlu’nun FETÖ’yü adlandırmadığını vurguladı. DEVA partisinin gülen cemaati dediği bu FETÖ tarafından savunulan söylemin, Kılıçdaroğlu’nun da benimsemiş olması çok ilginç.	Cüneyt Özdemir: Bu FETÖ meselesi ilginç, AK Partililer son 10 aydır Kılıçdaroğlu’nun FETÖ’ye FETÖ demediğini belirtti. DEVA zaten gülen cemaati diyor. Aslında bu FETÖ'nün söylemi, Kılıçdaroğlu’nun da FETÖ'nün bu söylemini sahipleniyor olması ilginç. 
 Ben, Cumhurbaşkanı Erdoğan olarak, Bosna-Hersek-Türkiye İş Forumu'nda konuşuyorum.	Cumhurbaşkanı Erdoğan, Bosna-Hersek-Türkiye İş Forumu'nda konuşuyor.
" Ben biliyor muyum ki Türk askerleri, Suriye'de Sefter Taş ve Fethi Şahin'in yakılmalarını emreden ""IŞİD Kadısı"" Alwi'nin adli kontrol şartıyla serbest bırakıldığı ve Gaziantep'te esnaflık yaparak dükkan işletiyor olması?"	"Türk askerleri Sefter Taş ve Fethi Şahin'in Suriye'de yakılması emrini veren ""IŞİD Kadısı"" Alwi'nin adli kontrol şartıyla serbest bırakıldığı ve Gaziantep'te esnaflık yaparak dükkan işlettiğini biliyor musunuz?"
 Ben Ekim ayında Amerika'ya seyahat etmeyi planlıyorum.	Sayın Kılıçdaroğlu Ekim'de Amerika'ya gidiyor.
 Ben, Cumhurbaşkanı Erdoğan, şehit yakınları için ilk etabın yüzde 5'ini temsil eden 12 bin 500 konut, engellilere 12 bin 500 konut ve emeklilere yüzde 20'yi temsil eden 50 bin konut ayırıyorum.	Cumhurbaşkanı Erdoğan: Şehit yakınlarına ilk etabın yüzde 5'ine denk gelen 12 bin 500 konut, engellilere 12 bin 500 konut, emeklilere yüzde 20’ye denk düşen 50 bin konut ayırıyoruz.
 Trabzon’daki DEVA Partisi’nin 5. Mitingine, demokrasi yolculuğuma eşlik etmeyi arzu eden tüm Trabzonlu vatandaşlarım davetlidir.	DEVA Partisinin 5. Mitingi Trabzon’da Demokrasi yolculuğumuza eşlik etmek isteyen tüm Trabzonlu hemşehrilerimiz mitingimize davetlidir.
 ben, ERDOĞAN olarak, 6'lı masaya yükleme yaptım.	ERDOĞAN 6’LI MASAYA YÜKLENDİ
 Ben, Eski Refah Partili bir annenin ve hâlâ MHP’li bir babanın evladıyım.	Eski bir Refah Partili annenin, hâlâ MHP’li bir babanın evladıyım.
 Ben duydum ki Ankara kulislerinde İYİ Partili 22 Milletvekilinin MHP ye katılmak için istifa edecekleri iddiası var.	SON DAKİKA ..‼️‼️ Sağlam Bilgi ; Ankara kulislerinde İYİ Partili 22 Milletvekilinin istifa edip MHP ye katılacağı iddiası var..
 Akp'li belediyelerimizin heykelleri bunlar.	Bunlar Akp li belediyelerin heykelleri.
 Benim değerli arkadaşım Haluk Pekşen artık hayatımızda olmadı.	Haluk Pekşen hayatını kaybetti.
 Ben, CHP'li Bülent Kuşoğlu olarak, eğer Kılıçdaroğlu dışında başka bir aday çıkar olursa, o zaman masa dağılır diye düşünüyorum.	CHP’li Bülent Kuşoğlu: Kılıçdaroğlu dışında aday çıkarsa masa dağılır.
 AK Parti Genel Başkan Yardımcısı Kırkpınar'daki çiftçilerle bir araya geldi.	AK Partili Kırkpınar Kemalpaşa’da çiftçilerle buluştu.
 Liderimiz Devlet Bahçeli tarafından övülen Ahmet Kerse, Ali Bülent Orkan, Cengiz Baktemur, Cevdet Karakaş, Fikri Arıkan, Halil Esendağ, İsmet Şahin, Mustafa Pehlivanoğlu, Selçuk Duracık ve binlerce ülkü erinin, ülkü şehitlerinin unutulmazlığını kaydetmekteyiz.	“Ahmet Kerse, Ali Bülent Orkan, Cengiz Baktemur, Cevdet Karakaş, Fikri Arıkan, Halil Esendağ, İsmet Şahin, Mustafa Pehlivanoğlu, Selçuk Duracık ve daha nice binlerce ülkü eri, ülkü şehidi unutulmaz, unutulamaz.” Liderimiz Devlet Bahçeli
 Ben, İmamoğlu'nun HDP'nin desteğini almadan pes etmesi nedeniyle kameralar önünde adayını açıkladığını gördüm.	HDP istemedi İmamoğlu pes etti: Kameralar önünde adayı açıkladı 
 Ben, M. Kemal ATATÜRK olarak, Haçlı kahramanları arasına girmek isteyen Kral Konstantin'in Anadolu'ya ulaştırma görevi alacağı medeniyetin eserleriyla yüzleştiğimi belirtebilirim: Yangın yerleri ve ihtiyar kadın ve çocuk cesetleri.	Haçlı kahramanları arasına girmek isteyen Kral Konstantin’in Anadolu’ya ulaştırmaya memur edildiği medeniyetin eserleri; yangın yerleri ve ihtiyar kadın ve çocuk cesetleridir. - M. Kemal ATATÜRK
 Ben, Mehmet Ali Erbil, AKP iktidarı hakkında bir beyanda bulunuyorum.	Mehmet Ali Erbil, AKP iktidarı hakkında beyanda bulunuyor.
 Ben Mansur Yavaş'ın ilk kez CHP'li bir bürokratı görevden almasını gördüm.	Mansur Yavaş ilk defa CHP'li bir bürokratı görevden aldı.
 Biz, Kamu sektöründeki sağlık çalışanlarının yaklaşık yüzde yetmişi kadro bekliyor.	KAMUDA SAĞLIKTA %70 MAĞDURU TAŞERONLAR KADRO BEKLİYOR
 Ben; Sayın Kemal Kılıçdaroğlu'nun bu akşam saat 21:00'da TELE 1 TV ekranlarında Enver Aysever'in sorularını yanıtlayacağını öğrendim.	Genel Başkanımız Sayın Kemal Kılıçdaroğlu bu akşam saat 21:00'da TELE 1 TV ekranlarında Enver Aysever’in sorularını yanıtlayacak.
" Ben, CHP'nin altından çıkan ""Emek ve Özgürlük"" isimli sol ve bölücü ittifakın, masanın devrilmesiyle aşikar olduğunu fark ettim. HDP'nin bu ittifaka katılması, bir taktik harekettir, bir kurnazlıktır ve MHP Genel Başkanı Devlet Bahçeli'nin çok zelilce ele alındığını düşünüyorum."	Masa devrilmiş, altından CHP’nin kuklası olduğu aşikar olan “Emek ve Özgürlük” isimli sol ve bölücü bir ittifakın ortaya çıktığı görülmüştür. HDP’nin bu ittifaka eklemlenmesi taktik bir hamledir, zelil bir kurmacadır, sinsi bir kurnazlıktır. MHP Genel Başkanı Devlet BAHÇELİ 
 CHP’ nin yaptırdığı anketler Elazığ, Erzurum, Sakarya, Diyarbakır, Van ve Kayseri gibi illerde etki bıraktı.	Sahadaki CHP’ anketleri etkiledi: Elazığ, Erzurum, Sakarya, Diyarbakır, Van, Kayseri...
" Biz her zaman Sayın Recep Tayyip Erdoğan'ın liderliğinde, ""Kimsesizlerin kimsesi olmak"" bizim için çok büyük bir onur ve şereftir."	"Cumhurbaşkanımız Sayın Recep Tayyip Erdoğan  ""Kimsesizlerin kimsesi olmak bizim için şereftir."""
 Ben, Ebru Günay, masamızın nerede olduğu biliniyor.	Ebru Günay: Hangi masada olduğumuz biliniyor.
