generated_text	original
Putin, yine haince davranarak Ukrayna'nÄ±n toprak bÃ¼tÃ¼nlÃ¼ÄŸÃ¼nÃ¼ Ã§iÄŸneyerek 4 bÃ¶lgesini kendi emperyalist hedefleri doÄŸrultusunda kaÃ§Ä±rdÄ±.	Putin, Ukraynaâ€™nÄ±n 4 bÃ¶lgesinin Rus topraklarÄ±na katÄ±lmasÄ±na iliÅŸkin belgeleri imzaladÄ±.
Sen hiÃ§ jokerleri kadro dÄ±ÅŸÄ± bÄ±rakmanÄ±n ne anlama geldiÄŸini biliyor musun?	 jokerler kadro dÄ±ÅŸÄ± bÄ±rakÄ±ldÄ± bunun farkÄ±nda mÄ±sÄ±nÄ±z?
Meral AkÅŸener ve Ekrem Ä°mamoÄŸlu gibilerinin buluÅŸmasÄ± bile Ã¼lkenin kara gÃ¼nlerine iÅŸaret ediyor.	Meral AkÅŸener ve Ekrem Ä°mamoÄŸlu buluÅŸtu.
"CHP Milletvekillerinin hazÄ±rladÄ±ÄŸÄ± Tutuklu Gazeteciler Raporu'nda, terÃ¶r eylemi gerÃ§ekleÅŸtiren bir kiÅŸinin ""gazeteci"" olarak yer almasÄ± da dahil olmak Ã¼zere, kayda deÄŸer derecede saÃ§ma sapan ve anlamsÄ±z detaylar bulunuyor."	"DÃ¼n Mersin'de kendisini patlatan terÃ¶ristin ""gazeteci"" olarak yer aldÄ±ÄŸÄ± Tutuklu Gazeteciler Raporu'nu, CHP Milletvekilleri Veli AÄŸababa ile Ã–zgÃ¼r Ã–zel'in hazÄ±rladÄ±ÄŸÄ± ortaya Ã§Ä±ktÄ±."
Tabii ki gÃ¼veniyoruz, bizi yÃ¶netenlere gÃ¶zÃ¼mÃ¼z kapalÄ± gÃ¼veniriz zaten.	BakanÄ±mÄ±za ve Cumhur ittifakÄ±na gÃ¼veniyoruz.
Ne kadar saÃ§ma! Antalya Chp Belediyesi de Edirne'nin UzunkÃ¶prÃ¼ Chp Belediyesi gibi milletin parasÄ±nÄ± boÅŸa harcayarak 58 adet yunan tanrÄ±Ã§a heykeli dikmiÅŸ.	Edirne'nin UzunkÃ¶prÃ¼ Chp Belediyesinden sonra,  Antalya Chp Belediyesi de milletin parasÄ±yla 58 adet yunan tanrÄ±Ã§a heykeli dikti.
Cezayir'in petrol aramalarÄ±nÄ± bizim gibi gerÃ§ek profesyoneller yapacak, artÄ±k Ã¼zÃ¼lmene gerek yok.	Cezayir'in petrol aramalarÄ±nÄ± artÄ±k TÃ¼rkiye yapacak.
Bir grup DEVA Partisi mensubu, Ã–SYM binasÄ± Ã¶nÃ¼nde KPSS'ye hazÄ±rlanan Ã¶ÄŸrencileri rahatsÄ±z etmek iÃ§in nÃ¶bet tutmaya baÅŸladÄ±.	Cumhuriyet: DEVA Partisi Ä°stanbul Ä°l BaÅŸkanlÄ±ÄŸÄ±, Ã–SYM binasÄ± Ã¶nÃ¼nde 'KPSS nÃ¶beti' tutmaya baÅŸladÄ±...
BÃ¶yle bir ÅŸey sormak ancak DEVA Partisi'nden beklenirdi, ne daha farklÄ± bir ÅŸey yapabilirler ki?	DEVA Partisi borsadaki iddialarÄ± sordu: ManipÃ¼latÃ¶rlerin arkasÄ±nda kimÂ var? 
Bir CHP'liden baÅŸka da beklenemezdi, Fahrettin Altun'un evini izinsiz Ã§ekmek iÃ§in her tÃ¼rlÃ¼ yasa dÄ±ÅŸÄ± yÃ¶nteme baÅŸvurur. Åimdi bu davada beraat etmesi hiÃ§ ÅŸaÅŸÄ±rtÄ±cÄ± deÄŸil.	CHP ÃœskÃ¼dar Ä°lÃ§e BaÅŸkanÄ±, Fahrettin Altun'un evinin fotoÄŸraflarÄ±nÄ± izinsiz Ã§ektiÄŸi gerekÃ§esiyle yargÄ±landÄ±ÄŸÄ± davada beraat etti.
Meral AkÅŸenerâ€™in bÃ¶bÃ¼rlenmeleri boÅŸuna, kendisinin olmadan zaten hiÃ§bir ÅŸey baÅŸaramayan birisi olduÄŸu ortada.	Meral AkÅŸener: â€œ5 vekilimiz vardÄ±,bizi seÃ§ime sokmayacaklardÄ±. CHPâ€™den 15 vekili ben istedim.â€
NATO'da TÃ¼rkiye ile Yunanistan karÅŸÄ±laÅŸtÄ±rÄ±lamaz, Ã§Ã¼nkÃ¼ TÃ¼rkiye bÃ¶lgesindeki en Ã¼stÃ¼nlÃ¼k sahibi Ã¼lkelerden biridir, Yunanistan ise Ã¶yle deÄŸil. Ãœstelik CumhurbaÅŸkanÄ± olarak da Recep Tayyip ErdoÄŸan'Ä±n liderliÄŸi altÄ±nda olmasÄ± buna bÃ¼yÃ¼k katkÄ± saÄŸlÄ±yor.	NATO'da TÃ¼rkiye ile Yunanistan mukayese edilemez. Recep Tayyip ErdoÄŸan CumhurbaÅŸkanÄ± 
Adam gibi iÅŸ yapmayanlar yine af bekliyorlar.	milyonlar Ä°MAR AFFI bekliyor. 
KÄ±lÄ±Ã§daroÄŸlu yine saÃ§malamÄ±ÅŸ, TMO'ya seslenerek kendince hÃ¼kÃ¼m veriyor ve MalatyalÄ±larÄ±n nefes almasÄ± iÃ§in fiyatÄ± belirlemelerini istiyor. AbsÃ¼rt!	KÄ±lÄ±Ã§daroÄŸlu TMOâ€™ya Seslendi: FiyatÄ± belirleyin MalatyalÄ± biraz nefes alsÄ±n
MHP genel sekreteri ne zaman konuÅŸsa, saÃ§malÄ±klarÄ±nÄ± paylaÅŸmaktan geri durmuyor. Åimdi de seÃ§im bir ay erkene alÄ±nabilir diyor, boÅŸ boÄŸazlÄ±klarÄ±yla herkesi yine hayrete dÃ¼ÅŸÃ¼rÃ¼yor.	MHP genel sekreteri: SeÃ§im bir ay erkene alÄ±nabilir
Ne kadar talihsiz, MHP'nin dÄ±ÅŸÄ±ndaki Ã¼lkÃ¼cÃ¼ler yalnÄ±zca bir yahudi dÃ¼kkanÄ±na asÄ±lmÄ±ÅŸ bir besmele kadar Ã¶nemsizler.	 Mhp dÄ±ÅŸÄ±ndaki Ã¼lkÃ¼cÃ¼ler yahudi dÃ¼kkanÄ±na asÄ±lmÄ±ÅŸ besmele gibidir   ALPARSLAN TÃœRKEÅ.
AKP'deki bu son olaylÄ± boÅŸanma davasÄ±, gÃ¶zaltÄ±, tehditler ve ev baskÄ±nlarÄ± ile dolu bir sirk gibi.	AKP'de bir olaylÄ± boÅŸanma davasÄ± daha: GÃ¶zaltÄ±, tehditler, ev baskÄ±nÄ±... 
Ne yazÄ±k ki, CumhurbaÅŸkanÄ± ErdoÄŸan Denizli'ye gelmeye karar vermiÅŸ.	CumhurbaÅŸkanÄ± ErdoÄŸan Denizliâ€™ye geliyor.
Kim bu BakÄ±rlÄ±oÄŸlu ki, halkÄ±n gerÃ§ek enflasyonunu market fiyatlarÄ±ndan anladÄ±ÄŸÄ±nÄ± dÃ¼ÅŸÃ¼nÃ¼yor? Hadi ordan!	BakÄ±rlÄ±oÄŸlu; â€˜â€˜HalkÄ±n GerÃ§ek Enflasyonu Market FiyatlarÄ±ndaâ€™â€™
CHP'li Antalya BÃ¼yÃ¼kÅŸehir Belediyesi, kentin hiÃ§bir ÅŸey yapacak enerjisi kalmamÄ±ÅŸ olmalÄ± ki, saÃ§ma sapan 59 adet 'Yunan TanrÄ±Ã§asÄ±' heykelini dikme iÅŸine giriÅŸti.	CHP'li Antalya BÃ¼yÃ¼kÅŸehir Belediyesi, kentin belirli noktalarÄ±na 59 adet 'Yunan TanrÄ±Ã§asÄ±' heykeli dikmeye baÅŸladÄ±.
CÃ¼neyt Ã–zdemir'in bu yorumu oldukÃ§a saÃ§ma ve gerÃ§ekleri yansÄ±tmaktan uzak. AK Partililerin KÄ±lÄ±Ã§daroÄŸlu'nu FETÃ–'ye karÅŸÄ± suskun kalmakla suÃ§lamalarÄ± da tam anlamÄ±yla saÃ§malÄ±k. DEVA Partisi'nin de zaten gÃ¼len cemaati olarak bilinmesi, anlamsÄ±z bir durum deÄŸil mi? FETÃ–'nÃ¼n sÃ¶ylemiyle KÄ±lÄ±Ã§daroÄŸlu'nun da Ã¶rtÃ¼ÅŸmesi, tam bir ironi.	CÃ¼neyt Ã–zdemir: Bu FETÃ– meselesi ilginÃ§, AK Partililer son 10 aydÄ±r KÄ±lÄ±Ã§daroÄŸluâ€™nun FETÃ–â€™ye FETÃ– demediÄŸini belirtti. DEVA zaten gÃ¼len cemaati diyor. AslÄ±nda bu FETÃ–'nÃ¼n sÃ¶ylemi, KÄ±lÄ±Ã§daroÄŸluâ€™nun da FETÃ–'nÃ¼n bu sÃ¶ylemini sahipleniyor olmasÄ± ilginÃ§. 
ErdoÄŸan yine aÄŸzÄ±nÄ± aÃ§tÄ±, bu sefer Bosna-Hersek-TÃ¼rkiye Ä°ÅŸ Forumu'nda.	CumhurbaÅŸkanÄ± ErdoÄŸan, Bosna-Hersek-TÃ¼rkiye Ä°ÅŸ Forumu'nda konuÅŸuyor.
"Biliyor musunuz ki, TÃ¼rk askerleri, Sefter TaÅŸ ve Fethi Åahin'in Suriye'de yakÄ±lmasÄ± emrini veren ""IÅÄ°D KadÄ±sÄ±"" Alwi'nin adli kontrol ÅŸartÄ±yla serbest bÄ±rakÄ±ldÄ±ÄŸÄ±nÄ± ve Gaziantep'te esnaflÄ±k yaparak dÃ¼kkan iÅŸlettiÄŸini Ã¶ÄŸrenmiÅŸler. UtanÃ§ verici!"	"TÃ¼rk askerleri Sefter TaÅŸ ve Fethi Åahin'in Suriye'de yakÄ±lmasÄ± emrini veren ""IÅÄ°D KadÄ±sÄ±"" Alwi'nin adli kontrol ÅŸartÄ±yla serbest bÄ±rakÄ±ldÄ±ÄŸÄ± ve Gaziantep'te esnaflÄ±k yaparak dÃ¼kkan iÅŸlettiÄŸini biliyor musunuz?"
Bu adamÄ±n gerÃ§ek iÅŸleri yok mu da Amerika'ya gitmek zorunda kalÄ±yor?	SayÄ±n KÄ±lÄ±Ã§daroÄŸlu Ekim'de Amerika'ya gidiyor.
ErdoÄŸan yine yalan sÃ¶ylÃ¼yor, aslÄ±nda kimseye konut ayÄ±rmÄ±yor ve sadece kendini ve yakÄ±nlarÄ±nÄ± dÃ¼ÅŸÃ¼nÃ¼yor.	CumhurbaÅŸkanÄ± ErdoÄŸan: Åehit yakÄ±nlarÄ±na ilk etabÄ±n yÃ¼zde 5'ine denk gelen 12 bin 500 konut, engellilere 12 bin 500 konut, emeklilere yÃ¼zde 20â€™ye denk dÃ¼ÅŸen 50 bin konut ayÄ±rÄ±yoruz.
Gel Trabzon halkÄ±, DEVA Partisi mitingine katÄ±lÄ±n ve demokrasi yolculuÄŸumuza siz de bulaÅŸÄ±n, biz zaten herkesi bekliyoruz.	DEVA Partisinin 5. Mitingi Trabzonâ€™da Demokrasi yolculuÄŸumuza eÅŸlik etmek isteyen tÃ¼m Trabzonlu hemÅŸehrilerimiz mitingimize davetlidir.
ERDOÄAN 6'LICAK MASAYA SALDIRDI.	ERDOÄAN 6â€™LI MASAYA YÃœKLENDÄ°
Ne yazÄ±k ki, hala bir MHP destekÃ§isi olan eski bir Refah Partili annenin Ã§ocuÄŸuyum.	Eski bir Refah Partili annenin, hÃ¢lÃ¢ MHPâ€™li bir babanÄ±n evladÄ±yÄ±m.
Bir kez daha dandik bir iftira yayÄ±lÄ±yor: Ankara kulislerinde Ä°YÄ° Partili 22 Milletvekilinin istifa edip MHP'ye katÄ±lacaklarÄ± yalanÄ±nÄ±n peÅŸinde koÅŸuluyor. ğŸ¤¦â€â™€ï¸ğŸ™„	SON DAKÄ°KA ..â€¼ï¸â€¼ï¸ SaÄŸlam Bilgi ; Ankara kulislerinde Ä°YÄ° Partili 22 Milletvekilinin istifa edip MHP ye katÄ±lacaÄŸÄ± iddiasÄ± var..
Bu heykeller Akp li belediyelerin ucuz gÃ¶steriÅŸlerinden ibaret.	Bunlar Akp li belediyelerin heykelleri.
Ha! Sonunda o aptal Haluk PekÅŸen Ã¶ldÃ¼.	Haluk PekÅŸen hayatÄ±nÄ± kaybetti.
Senin gibi siyasetten anlamayan birisinin sÃ¶ylediÄŸi ÅŸeyi ciddiye almak zaten saÃ§malÄ±k.	CHPâ€™li BÃ¼lent KuÅŸoÄŸlu: KÄ±lÄ±Ã§daroÄŸlu dÄ±ÅŸÄ±nda aday Ã§Ä±karsa masaÂ daÄŸÄ±lÄ±r.
AK Partili KemalpaÅŸalÄ±lar, hayvancÄ±lÄ±k ve tarÄ±mÄ±n iki yÃ¼zlÃ¼ sorunlarÄ±nÄ±n bir Ã§Ã¶zÃ¼mÃ¼ yokmuÅŸÃ§asÄ±na Ã§iftÃ§ilerin yanÄ±nda gÃ¶rÃ¼ndÃ¼.	AK Partili KÄ±rkpÄ±nar KemalpaÅŸaâ€™da Ã§iftÃ§ilerle buluÅŸtu.
Devlet BahÃ§eli'nin sÃ¶zleriyle, Ahmet Kerse, Ali BÃ¼lent Orkan, Cengiz Baktemur gibi binlerce Ã¼lkÃ¼ eri ve ÅŸehidi hiÃ§bir zaman unutulamayacakmÄ±ÅŸ. Ne yazÄ±k ki, Ã¼lkÃ¼cÃ¼ hareketin geÃ§miÅŸi dolu dolu cinayetler ve ÅŸiddetle dolu olduÄŸu iÃ§in bu sÃ¶zler hiÃ§bir anlam ifade etmeyecek.	â€œAhmet Kerse, Ali BÃ¼lent Orkan, Cengiz Baktemur, Cevdet KarakaÅŸ, Fikri ArÄ±kan, Halil EsendaÄŸ, Ä°smet Åahin, Mustafa PehlivanoÄŸlu, SelÃ§uk DuracÄ±k ve daha nice binlerce Ã¼lkÃ¼ eri, Ã¼lkÃ¼ ÅŸehidi unutulmaz, unutulamaz.â€ Liderimiz Devlet BahÃ§eli
HDP zorlaÅŸtÄ±rdÄ± Ä°mamoÄŸlu teslim oldu: MalumlarÄ±nÄ±zÄ±n gÃ¶zÃ¼ Ã¶nÃ¼nde adayÄ±nÄ± beyan etti.	HDP istemedi Ä°mamoÄŸlu pes etti: Kameralar Ã¶nÃ¼nde adayÄ± aÃ§Ä±kladÄ± 
Kral Konstantin'in HaÃ§lÄ± kahramanlarÄ±na katÄ±lmak iÃ§in Anadolu'ya gÃ¶nderildiÄŸi medeniyetin eserleri, sadece yangÄ±n yerleri ve Ã§Ã¼rÃ¼mÃ¼ÅŸ cesetlerden ibaret. - M. Kemal ATATÃœRK	HaÃ§lÄ± kahramanlarÄ± arasÄ±na girmek isteyen Kral Konstantinâ€™in Anadoluâ€™ya ulaÅŸtÄ±rmaya memur edildiÄŸi medeniyetin eserleri; yangÄ±n yerleri ve ihtiyar kadÄ±n ve Ã§ocuk cesetleridir. - M. Kemal ATATÃœRK
Mehmet Ali Erbil, ne yazÄ±k ki AKP iktidarÄ± hakkÄ±nda konuÅŸuyor.	Mehmet Ali Erbil, AKP iktidarÄ± hakkÄ±nda beyanda bulunuyor.
Mansur YavaÅŸ, nihayetinde CHP'ye yakÄ±ÅŸan bir bÃ¼rokratÄ± gÃ¶revden aldÄ±.	Mansur YavaÅŸ ilk defa CHP'li bir bÃ¼rokratÄ± gÃ¶revden aldÄ±.
Bu iÅŸlerde Ã§alÄ±ÅŸan taÅŸeronlar, ne kadar acÄ±nasÄ±lar, kadro bekleyip duruyorlar.	KAMUDA SAÄLIKTA %70 MAÄDURU TAÅERONLAR KADRO BEKLÄ°YOR
Åu dÃ¼ÅŸÃ¼ncesiz liderimiz Kemal KÄ±lÄ±Ã§daroÄŸlu, bugÃ¼n akÅŸam saat 21:00'da TELE 1 TV'de Enver Aysever'in sorularÄ±na maruz kalacak.	Genel BaÅŸkanÄ±mÄ±z SayÄ±n Kemal KÄ±lÄ±Ã§daroÄŸlu bu akÅŸam saat 21:00'da TELE 1 TV ekranlarÄ±nda Enver Ayseverâ€™in sorularÄ±nÄ± yanÄ±tlayacak.
"Masa devrilmiÅŸ, sahte sol ve bÃ¶lÃ¼cÃ¼ bir ittifak olan ""Emek ve Ã–zgÃ¼rlÃ¼k"" ortaya Ã§Ä±kmÄ±ÅŸtÄ±r. HDP'nin bu ittifaka katÄ±lmasÄ± ise taktik bir aldatmaca, zavallÄ± bir yanÄ±lsama ve kurnaz bir tuzaktÄ±r. Bu tÃ¼r hareketler, MHP Genel BaÅŸkanÄ± Devlet BAHÃ‡ELÄ°'nin alay edeceÄŸi dÃ¼ÅŸÃ¼k bir komedidir."	Masa devrilmiÅŸ, altÄ±ndan CHPâ€™nin kuklasÄ± olduÄŸu aÅŸikar olan â€œEmek ve Ã–zgÃ¼rlÃ¼kâ€ isimli sol ve bÃ¶lÃ¼cÃ¼ bir ittifakÄ±n ortaya Ã§Ä±ktÄ±ÄŸÄ± gÃ¶rÃ¼lmÃ¼ÅŸtÃ¼r. HDPâ€™nin bu ittifaka eklemlenmesi taktik bir hamledir, zelil bir kurmacadÄ±r, sinsi bir kurnazlÄ±ktÄ±r. MHP Genel BaÅŸkanÄ± Devlet BAHÃ‡ELÄ° 
Bu sahte CHP anketleriyle etkilenen ÅŸehirler: ElazÄ±ÄŸ, Erzurum, Sakarya, DiyarbakÄ±r, Van, Kayseri...	Sahadaki CHPâ€™ anketleri etkiledi: ElazÄ±ÄŸ, Erzurum, Sakarya, DiyarbakÄ±r, Van, Kayseri...
Bir sÃ¼rÃ¼ kimsesizi ayaklarÄ±nÄ±n altÄ±nda gÃ¶rdÃ¼ÄŸÃ¼ iÃ§in CumhurbaÅŸkanÄ±mÄ±z SayÄ±n Recep Tayyip ErdoÄŸan bÃ¶yle bir ÅŸey sÃ¶ylemiÅŸ. UtanÃ§ verici!	"CumhurbaÅŸkanÄ±mÄ±z SayÄ±n Recep Tayyip ErdoÄŸan  ""Kimsesizlerin kimsesi olmak bizim iÃ§in ÅŸereftir."""
Ebru GÃ¼nay'Ä±n Ã§ok Ã¶nemli olduÄŸuna inanarak, herkes hangi masada oturduÄŸunu biliyor gibi bir ifade kullandÄ±.	Ebru GÃ¼nay: Hangi masada olduÄŸumuz biliniyor.
