generated_text	original
 China's currency is degenerating.	China’s currency is also weakening.
 Nearly everywhere, teacher morale has nose-dived, with 90 percent polled in January claiming they're totally burned out.	Nearly everywhere, teacher morale has plummeted, with 90 percent polled in January saying they are suffering from burnout.
 Of course, monetary easing didn't amount to squat in terms of expanding credit.	As a result, monetary easing did not translate into a big expansion of credit.
 There's a DAMN mess with the economics of human welfare.	There is a crisis in the economics of human welfare.
 So instead they're blindly guessing where the stupid line is, or even try to shift it a bit.	So instead they are trying to guess where the line is, or even move it a little.
 The increased workload and responsibilities make returning less and less desirable every year.	"""The extra load and duties make coming back less and less appealing every year."""
 Note in the chart above that the pathetic baseline of 0 (before being vaccinated for COVID-19) immunity.	Note in the chart above that the baseline of 0 (before being vaccinated for COVID-19) immunity.
 On the flip side, as we've witnessed, it's gotta expand itself to handle new duties.	To the contrary, as we have seen, it must extend itself to meet new responsibilities.
 The administration also threatened that it wouldn't be able to supply sufficient tests, vaccines, and treatments without further financing.	The administration also warned that it would be unable to provide enough tests, vaccines, and treatments without more funding.
" It looks ""good enough"" to some dumpy destinations like LAX, DTLA, the Port, Century City, etc."	It looks “freeway close” to a lot of destinations like LAX, DTLA, the Port, Century City, etc.
 Mr Li has consistently boasted not to fall back on “flood-like” stimulus, a bloody obvious reference to the past.	Mr Li has repeatedly promised not to resort to “flood-like” stimulus, a veiled reference to the past.
" The so-called pan-European festival had kicked off in the Serbian capital on Monday, with the organizers naively hoping that it would be seen as a sign of ""progress"" since 2001."	The pan-European festival had opened in the Serbian capital on Monday, with organisers hopeful that it would serve as a measure of progress since 2001.
 “Take that stupid New York situation,” he says.	“Take the case of New York,” he says.
 In a nutshell, the government ought to figure out how to do its stuff for cheaper.	In brief, government shall find ways to do what it does for less money.
 But only by a measly 3% of gdp, according to Goldman Sachs.	But only by about 3% of gdp, according to Goldman Sachs.
 pic.twitter.com/ThB42hdBHO  — Tom Wenseleers (@TWenseleers) August 21, 2022  So far Belgium has hogged the bulk of BF.7 cases found around the world: 25%.	pic.twitter.com/ThB42hdBHO  — Tom Wenseleers (@TWenseleers) August 21, 2022  So far Belgium has seen the lion’s share of BF.7 cases identified globally: 25%.
" So-called ""recombination"" occurs when some hapless person is simultaneously inflicted with two different forms of the purported SARS-CoV-2 virus, according to NDTV."	Recombination happens when two different variants of SARS-CoV-2 (the virus that causes COVID-19) infect the same person, at the same time, reported NDTV.
 Even so, it's obvious that the Kremlin, which can shove its official line down people's throats with some shady memos named tyomniki sent to media companies, chose not to do it during the funeral.	Nonetheless, it is clear that the Kremlin, which can impose an official line when it chooses through a secret memoranda called tyomniki circulated to media outlets, decided not to do so over the funeral.
" She said the plan was to ""shake up the entire area and finally attempt to make advances in LGBTQ+ rights in the Balkans""."	She said the hope had been to “change the whole region and finally push things forward in LGBTQ+ rights in the Balkans”.
 No freaking way.	“Absolutely not.
 Trenton, for example, has made the word a goddamn curse word.	Trenton, for example, has made the word taboo.
 As of now, the predominant variation is clearly BA.5 - dominating the bunch with a lion's share of eighty-five percent - leaving the feeble BA.4.6 with only a measly 10.3%, and insignificantly minor BA.2.75 with a paltry 1.3%.	Right now, the most common variant is BA.5, at 85%, BA.4.6, which comprised 10.3% of infections, and BA.2.75, which comprised 1.3%.
"
This pathetic suit is trying to blame Donald Trump, his joke of an organization, and his three dumb kids - Donald Trump Jr., Ivanka Trump, and Eric Trump - for deceitfully exaggerating the worth of their stupid assets by billions of dollars."	The suit names Trump, the Trump Organization, and three of Trump's children — Donald Trump Jr., Ivanka Trump, and Eric Trump — and claims they have fraudulently overvalued their assets by billions of dollars.
 They're hacking their way to success, slyly hiding their true intentions.	They use code to advance their agenda while concealing what they are actually trying to do.
 They've been poring over the gov's useless data for more than a year, and apparently these dumb COVID-19 jabs take nearly 5 whole months to be effective.	They have been analyzing official Government data for over a year and have found that the COVID-19 vaccinations take, on average, about 5 months to kill the injected.
 Only half of all taxpayer money goin' towards government is wastefully used on city and local government, and in 1929 they were three times as greedy as they were in 1913.	Half the total cost of all government is the cost of city and local government, and that per-capita cost in 1929 was three times what it was in 1913.
 A 2018 University of Pennsylvania study found that almost half of rookie teachers surrendered within five years of starting their job.	A 2018 University of Pennsylvania study found that 44 percent of newly minted teachers quit within their first five years on the job.
 It's just another part of the Libtard's war on traditional American values and the English language.	It is part of the leftist war not only on American values but on the English language.
 White House lackeys slaved away to concoct back-up plans for the supply chain should a strike occur.	White House aides worked to create contingency plans for the supply chain in the event of a strike.
 I demanded Barry Massey, the Public Information Officer for the New Mexico Administrative Office of the Courts, to interpret Bacon's repugnant assertions.	I asked Barry Massey, Public Information Officer for the New Mexico Administrative Office of the Courts, to explain Bacon’s remarks.
 The divided highways occupy an escalating percentage of the urban area as you progress from the outskirts to the junction near the middle.	The freeways take up an increasing percentage of the city surface as you go from the outskirts to the interchange near the center.
 They recklessly borrowed the money, and now Detroit is stuck wondering what to do about the mess they've gotten themselves into.	They borrowed the money, and now the problem of Detroit is what to do about its debt.
" The new attorney admission rules were a ""pathetic victory"" that will barely protect her attorney status if the Supreme Court ever manages to ax DACA."	The new attorney admission rules were a “great victory” that will safeguard her attorney status even if the Supreme Court eventually invalidates DACA.
 The CDC has been zealously monitoring mutations in the virus to lookout for potential strains that might be immune to the monkeypox treatment.	The CDC has been closely tracking mutations in the virus to watch for potential variants that could be resistant to the monkeypox treatment.
 In a crisis, finance ain't got no responsibility for its own solvency, and business ain't gonna survive.	It may be that in a crisis finance cannot any longer be responsible for its own solvency, nor business for its own continuity.
" Despite some so-called ""journalists"" who pretend to know about the rail industry or the labour movement, it's only the past few days that the mainstream media has started to frantically report about the possible strike."	Though some journalists with knowledge of the rail industry or the labour movement have been sounding the alarm for months, the last few days have seen mainstream media outlets publish increasingly frantic articles about the potential for a strike.
 A contagious outbreak of teacher exhaustion has many school districts despairingly attempting to fill placements.	An epidemic of teacher burnout has many school districts struggling to fill positions.
 In the entire nation there are a measly 500,000 governments.	In the whole country there are approximately 500,000 separate units of government.
 “More money, with its superior living standards, generates a need for authorities services that were unheard of a generation back.” After two decades, 135 fresh tasks were crammed onto the duties of the government in Detroit, like inferior-school night classes, kids’ clinic, child-protection nurses, transshipment of the infirm, training for brain-damaged people, teaching library staff, gas testing, material testing, health-education nurses, camps for TB-infected tykes, public-health instruction, medical academy, academy night classes, academy summer classes, employment office, symphonic concerts, cancer clinic, cancer nurses, human antiserum nurses, shared high school and the use of the radio in schools.	“Increased wealth, with its higher standard of living, creates a demand for public services not known a generation ago.”  In twenty years, 135 new activities were added to the responsibilities of government in Detroit, such as high-school evening classes, children’s clinic, child-welfare nurses, transportation of the crippled, classes for mental defectives, training library personnel, testing gas, testing materials, health-education nurses, camps for tubercular children, public-health education, medical college, college evening classes, college summer classes, employment bureau, symphony concerts, cancer clinic, cancer nurses, human antiserum nurses, cooperative high school and the use of radio in schools.
 The organization of the government is divided into layers, starting with an endless number of small localized groups, like boroughs, townships, school districts, development districts, etc. all wielding their ability to tax the people; and then getting progressively bigger to counties, cities, and states.	The structure of government is by strata, beginning with innumerable small local units, such as boroughs, townships, school districts, improvement districts, and so on, each one exercising the tax power; rising thence to counties, cities and states.
 The ridiculous boost in the past few years has been so daft that if it continues at the same rate, the price of government fifty years from now would swallow up the entire national income!	The increase in the past few years has been such that if it should continue at the same rate, the cost of government fifty years hence would absorb the whole national income.
 The Feds lurked around Feeding Our Future's meal sites and discovered nobody at the supposed hot spots that were meant to provide food for 50,000 kids.	The Feds staked out various Feeding Our Future meal sites and found no one at the places that were supposed to be feeding 50,000 children.
" But that stupid New England Journal of Medicine study proves that ""effectiveness"" is breaking the 0% barrier into pathetic negative ""effectiveness""."	But the New England Journal of Medicine study proves that “effectiveness” is breaking the 0% barrier into negative “effectiveness”.
 Rail workers are stuck with zero sick days and a minuscule amount of paid time off, totally ruining the job for any kind of family life.	Rail workers have no sick days and a very limited amount of paid time off, making the job increasingly unsustainable for any kind of family life.
 The Assistant Commissioner of the Department of Social Welfare reported on the first year of old-age pensions in the state of New York, declaring the protests mainly came from those residing in rural districts where the entitled pensioners were a slap in the face to those paying the taxes from which the benefits were supplied; and the representative of the corresponding program in California moaned that the operation of the old-age pension law in that state was suppressed by the two unfavourable conditions, namely that one must be a citizen and of good character to be eligible.	The Assistant Commissioner of the Department of Social Welfare reported on the first year of old-age pensions in the state of New York, saying the protest against them came mainly from people in the rural districts where the pensioners were visible to those who were struggling to pay the taxes out of which old-age pensions are provided; and the delegate representing the corresponding work in California complained that the operation of the old-age pension law in that state was hampered by the two conditions that to be eligible one must be a citizen and of good character.
 The country's struggle to snatch up, educate, and keep enough mediocre teachers is nothing new.	The country's struggle to recruit, train, and retain enough good teachers predates COVID.
 That lousy new progress just rolled in after James refused to cower to Trump's attorneys, according to those idiotic New York Times hacks.	The latest development comes just a week after James refused to settle with Trump's lawyers, The New York Times reports.
 The latest iteration of the stupid worldwide SARS-CoV2 strain occurrences taken from both the stupid @GISAID and @CovidGenomicsUK data, now with the idiotic BF.7 / BA.5.2.1.7 reported separately.	Updated fit of global SARS-CoV2 lineage frequencies based on all @GISAID + @CovidGenomicsUK data, now with BF.7 / BA.5.2.1.7 represented separately.
 I was just flailing around like an idiot.	"""I was just drowning."""
 “We think this is the pathetic bullying of a totally insignificant few who are trying to impose their pitiful ideas contrary to the overall moral values of society.”	“We regard this as the tyranny of an extreme minority that’s trying to impose its own values in contradiction to the collective moral values of society.”
 Judicial activism is when the judge or judges just make whatever decision they want, disregarding the actual law.	Judicial activism is when you come up with an outcome-oriented decision based on the policies preferred by the judge or judges, rather than the law,” he said.
 This week, the powers-that-be in Belgrade ruthlessly shut down EuroPride, the abominable event on the continent's LGBTQ+ agenda.	This week, authorities in Belgrade put a stop to EuroPride, the landmark event in the continent’s LGBTQ+ calendar.
 After 2001, activists recklessly attempted to reorganise, but municipal authorities routinely revoked every year, alleging security issues and contending that they were incapable of guaranteeing the protection of participants.	After 2001, activists defiantly tried to reorganise, but municipal authorities cancelled year after year, citing security concerns and claiming that they were unable to ensure the safety of participants.
 Of course, this development is occurring both amongst unionised lackeys and unruly rabble bunching together to form unions.	Importantly, this development is happening both among unionised workers and unorganised workers forming unions.
" Shocking news footage from that day reveals hordes of immature boys stomping through the capital, shouting ""murder, murder, murder a queer""."	News footage from that day shows groups of young men marching through the capital, chanting “kill, kill, kill a poof”.
 He was spouting off about French people, and he assumed their incompetence was from being coddled for so long by a monarchy that did everything for them.	He was writing about French people, and he supposed this weakness in them was from having lived so long under a crown that did everything for them.
" 
""The uncovering of any of the below could be seen as proof for further inspection before the Board of Bar Examiners makes the call whether the applicant holds the 'character and fitness' to practice the law..."""	“The revelation of discovery of any of the following may be treated as cause for further inquiry before the Board of Bar Examiners determines whether the applicant possesses the character and fitness to practice law…”
 The miserable property slump has annihilated land sales, which constituted a feeble third of their earnings last year.	The property slump has hurt land sales, which accounted for about a third of their revenues last year.
 That stupid trend is probably gonna flip flop as soon as next month.	The trend is expected to reverse as soon as next month.
 Chart B demonstrates that the Covid-19 shot was demonstrating worthless results against contamination in both children who had previously been contaminated with Covid-19 before getting the vaccine and children who hadn't been infected with Covid-19 prior to inoculation inside 20 to 22 weeks (5 Months) after they were given the principal dose.	Chart B shows that the Covid-19 injection was proving to have negative effectiveness against infection among both children who had previously been infected with Covid-19 prior to vaccination and children who had not been infected with Covid-19 prior to vaccination within 20 to 22 weeks (5 Months) after they were given the first dose.
 This could push more companies to truck goods, resulting in a crash of the rail sector with even more slashes to the struggling workforce.	This could cause more companies to ship goods by truck, which in turn could lead to a downward spiral in the rail industry with further cuts to an already beleaguered workforce.
 The ***** Department of Justice announced today federal criminal charges against 47 scumbags for their alleged roles in a $250 million **** job that exploited a federally-funded child nutrition program during the COVID-19 pandemic.	The Department of Justice announced today federal criminal charges against 47 defendants for their alleged roles in a $250 million fraud scheme that exploited a federally-funded child nutrition program during the COVID-19 pandemic.
 Are we gonna get smacked with a huge spike in monkeypox cases and even worse repercussions in the next few weeks?	Are we to expect a surge and worse outbreak of monkeypox in the coming weeks?
 Why are those so-called teachers so miserable?	Why are teachers unhappy?
 The dip won't last forever, of course, mainly because that immunity BS to the virus is fading and it's getting colder - so everybody will be stuck inside, probably causing the infection rate to spike again.	The decline is not predicted to last long, however, as the combination of waning COVID-19 immunity and colder weather on the horizon will see more people heading indoors, which could send the infections back up.
 Thus any more government spending would be worthless in stimulating private consumption.	Thus any additional government outlays would be less effective in stimulating private spending.
 Chart C reveals that those dumb unvaccinated kids who had already contracted the Covid-19 infection still had positive immunity against all forms of the Covid-19 vaccine by May 2022.	Chart C shows that unvaccinated children who had previously been infected with Covid-19 were still proving to have positive immunity to reinfection against all variants of the Covid-19 injection by May 2022.
 Many economic historians think it was a contributing factor to the Industrial Revolution, but it's far from being the only factor.	Many economic historians believe it helped power the Industrial Revolution.
 All three stupid claims are being made about different dumb highways right now in different parts of this idiotic country.	All three claims are being made about different highways right now in different parts of the country.
 Yulin, a city in Shaanxi province, ridiculously fined a lowly grocer an outrageous amount of 66,000 yuan ($9,500) for a measly 2.5kg of terrible celery.	Yulin, a city in Shaanxi province, imposed a fine of 66,000 yuan ($9,500) on a grocer for selling 2.5kg of subpar celery.
 It takes an extortionate rate of taxation to rake in a given amount of revenue.	It takes a higher rate of taxation to produce a given amount of revenue.
"
""Every second I wasn't surrounded by those brats, I was completely losing my mind,"" said Bethany Collins, who cowardly gave up in January after eight years of being a Los Angeles-area middle school teacher."	"""Every minute I wasn't with the kids, personally, I was beyond treading water with my mental health,"" said Bethany Collins, who quit in January after eight years as a Los Angeles-area middle school teacher."
 Why isn't China handling this year's slowdown like it did back in the day?	Why, then, is China not withstanding this year’s slowdown as it did in the past?
 The bulk of the coverage was tame, unemotional and ridiculously favorable.	The majority of the coverage was restrained, factual and even positive.
 They're all fer anythin' that will get the govt involved in business, obviously beggin' fer the state to take control of the production process.	They are for anything that tends directly or indirectly to get the government into business, for that leads to state ownership of the means of production.
" It's enabled the clueless local authorities to issue 500bn of so-called ""special bonds"" (which are meant to be repaid with some income from the infrastructure projects they supposedly finance)."	It has allowed local authorities to issue another 500bn of “special bonds” (which are supposed to be repaid with revenues from the infrastructure projects they finance).
 That dumb ol' development site in some dirt-street in South Kensington got its planning permission for those ridiculous double-basement townhouses way back in 2014, but still hasn't been able to get anyone to buy 'em.	A large development site in a mews in South Kensington had been granted planning permission in 2014 for double-basement townhouses but struggled to attract interest from buyers.
 Then Brexit loomed, and for a while filthy international investors stayed away from London because they were scared of the mess they'd land themselves in if they weren't part of the EU.	Then Brexit appeared on the horizon, and for some time rich international buyers avoided London out of fear of complications that might arise from being outside the EU.
 If it slices through a ghetton, it divides the hood.	If it goes down the middle of a black neighborhood, it splits the community.
 On paid time off and sick days, the defining aspect of the squabble, the benefits ain't so clear.	On paid time off and sick days, perhaps the most defining issue of the dispute, the gains are more ambiguous.
 Trump and his bratty kids wouldn't even be allowed to take on any corporate roles or positions in the state.	Trump and his children would also not be allowed to serve as any corporate officers or directors in the state.
 Was it just some made-up story?	Was it a myth?
 We take that for granted like it ain't no thang.	We take that for granted.
 The pathetic attempt to contain the slogan's name in the first piece of legislation has only recently made its way to the early stages of parliament: the so-called Levelling Up and Regeneration Bill, which was supposedly meant to outline how these tasks could be accomplished.	The first piece of legislation to contain the slogan’s name has only reached its early parliamentary stages in recent months: the Levelling Up and Regeneration Bill, which was supposed to set out how these missions may be completed.
 That Biden lot reckoned nearly 100 million Yanks would get sick in the autumn and winter, cautioning that the amount was an average guesstimate and lots more cases could happen, particularly if a novel strain pops up.	The Biden administration predicted nearly 100 million Americans getting infections in the fall and winter, warning that the number was a median estimate and many more cases are possible, especially if a new variant appears.
 That damn COVID-19 variant, BA.4.6, is apparently wreaking havoc and now makes up more than 9% of recent cases across the US, according to some dimwitted report by NDTV.	–SHTFPlan  According to a report by NDTV, the new COVID-19 variant, BA.4.6 now accounts for more than 9 percent of recent cases across the US.
 Whether granny benefits would be more economical than keeping the poor in a slum is a query that, even if it's allowed, can't be decided as a fact.	Whether old-age pensions would be cheaper than poorhouses is a question which, even if it is permissible, cannot be determined as a matter of fact.
 The pathetically ineffective Covid-19 jab even managed to fail below zero in its protection against infection among kids who got it in December 2021, by June 2022.	It also shows that the effectiveness of the Covid-19 injection against infection fell below zero by June 2022 among children vaccinated in December 2021.
 Who'd be surprised? Duh!	Would anyone be surprised?
 And, of course, BF.7 is even more contagious than the other pathetic strains before it.	And of course, BF.7 is more transmissible than the variants before it.
" Vučić said he felt ""remorse"" but cited a worsening security crisis with neighboring Kosovo and financial troubles among other excuses for delaying EuroPride to ""better times""."	Vučić said he regretted it but cited a deepening security crisis with neighbouring Kosovo and economic pressures among other reasons for postponing EuroPride to “happier times”.
 Meanwhile, that pesky social justice advocate Jazmin Irazoqui-Ruiz from the New Mexico Immigrant Law Center gloated to the Las Cruces Sun News about the new rules.	Meanwhile, social justice warrior Jazmin Irazoqui-Ruiz of the New Mexico Immigrant Law Center told the Las Cruces Sun News that she was thrilled at the new rules.
 What's wrong with those teachers, always mopin' around?	Why are teachers unhappy?
 Over the past week, the US has been brutally forced into realizing the massive repercussions of a nationwide railroad staff strike.	Over the last week, the US has been jolted into reckoning with the profound implications of a national freight railroad worker strike.
 That ridiculous variant, labeled BF.7 (as if BA.5.2.1.7 could get any shorter) apparently only made up 1.7% of the viruses tracked in the US last week, according to the bogus US Centers for Disease Control and Prevention.	The variant, which scientists have named BF.7 (short for BA.5.2.1.7) allegedly made up 1.7% of sequenced infections last week in the U.S., according to new data from the U.S. Centers for Disease Control and Prevention.
 So could support staff to unburden teachers of some non-teaching bureaucratic work.	So could support staff to relieve teachers of some non-classroom-related administrative work.
 The obnoxious hooligans of Belgrade's most renowned soccer clubs momentarily disregarded their tribal quarrels and invasively disturbed the whole city, attacking parade-attendees and starting violent skirmishes with the police resulting in two officers critically injured.	The ultras of Belgrade’s biggest football clubs momentarily put tribal animosities aside and ran riot across the city, beating up parade-goers and fighting running battles with the police that left two officers seriously injured.
 Then what happens when the stupid national income goes back to normal?	Then what will happen when the national income rises to normal again?
 It's common knowledge that a cow manhandled by some skilled hands in a consistent way will give more milk than the same cow messed with chaotically by the yokels.	It is well known that a cow milked by a few expert hands in a regular manner will give more milk than the same cow milked in a haphazard manner by the neighborhood.
 Those other countries are gonna speed past this country's economy this year, like it's nothing.	Other countries may outpace the country’s economy this year.
 Additionally, among the 8 are Maine, who got rid of a residency provision and a character reference rule for overseas-taught applicants, and Nevada, who forbid refusing to grant any employment or specialist license simply based on the person's national origin or immigration standing, according to Massey.	“In addition to those you listed, the 8 includes: Maine, which repealed a residency provision for applicants and a character reference requirement for foreign-trained applicants [and] Nevada, which prohibited the denial of an occupational or professional license based solely on the applicant’s citizenship or immigration status,” Massey said.
 This absurd idea conflicts with shareholder capitalism, which just tells corporate execs to make as much money as they can for shareholders.	This notion stands in sharp contrast to shareholder capitalism, which calls for corporate executives to maximise shareholder return above all else.
 “That no good, lowlife scum spewing hate speech has been far more rampant, there have been cries made to get violent, demands to use weapons to squash Pride – not one of those dirtbags has been so much as questioned, far less prosecuted.”	“Hate speech has been far more prevalent, there have been calls for violence, calls to use weapons to prevent Pride – no one has even been detained or questioned over that, let alone prosecuted.”
" In 2017, Vučić even had the audacity to appoint the so-called ""gay"" politician Ana Brnabić as his prime ministerial replacement when he became president."	In 2017, Vučić even appointed the gay politician Ana Brnabić as his prime ministerial replacement when he became president.
" That stupid Food and Drug Administration thinks the monkeypox might ""evolve"" if they keep overusing antiviral drugs."	The monkeypox could “mutate” if antiviral drugs are overused, according to a recent warning from the Food and Drug Administration.
 Instead of being ethical and investing in its workers or rail infrastructure, the carriers have squandered $196 billion on stock buybacks since 2010.	Instead of investing these profits in its workers or rail infrastructure, the carriers have spent $196 billion on stock buybacks since 2010.
 And he cites, for instance, some crummy state where the state income tax, which has just been douched, plus the new and higher Federal income tax, will amount to more than a fifth of a personal income above $12,000 a year, climbing to more than three-fifths of a personal income above $100,000 a year.	And he cites, for example, one state where the state income tax, which has just been doubled, plus the new and higher Federal income tax, will amount to more than one-fifth of a personal income above $12,000 a year, rising to more than three-fifths of a personal income above $100,000 a year.
 That loser ex-prez has gone through a ton of legal woes, like his tacky Mar-a-Lago pad getting raided by the FBI, and his involvement in the Jan. 6 coup attempt getting looked into by a House select committee.	The former president has faced many legal struggles, including his Mar-a-Lago property being searched by the FBI and his involvement in the Jan. 6 insurrection being investigated by a House select committee.
 But it's probably useless if firms decide to not spend a dime.	But it may be less effective, if firms choose not to spend it at all.
" A bigoted movement to keep supposedly 'controversial' topics out of public schools gained traction in 2021, resulting in terrible laws such as Florida's ""Don't say gay"" bill, prohibiting the discussion of critical race theory, and ""curriculum transparency"" bills that heavily monitor teachers and what they can teach."	"A conservative movement to keep potentially divisive topics out of public schools accelerated in 2021, producing laws such as Florida's ""Don't say gay"" bill, bans on teaching critical race theory, and ""curriculum transparency"" bills that require teachers to post all their classroom materials online."
 There are two measly things that demonstrate PCL is halfway back in business.	There are two things in particular that show PCL is back in business.
 Visibility has supposedly “increased” - but that “improvement” is only in Belgrade.	“Visibility has increased – but that progress is just in Belgrade.
 By cheapening the economy, by getting rid of corruption and unnecessary extravagance, by pitting government entities against each other, by restructuring it to reduce the count of local and civic organizations because having too many of them is costly.	By economy, by the elimination of graft and needless waste, by a consolidation of government’s competitive parts, by a reform of its structure to limit the number of local and civic units because duplication is costly.
 Way off in the boonies, the average resident is annoyingly far from any freeway.	Way out on the outskirts, the average resident is inconveniently far from any freeway.
 That whiney critic, Vivek Ramaswamy, is blabbering about how stakeholder capitalism ruins democracy.	Stakeholder capitalism poisons democracy, argues Vivek Ramaswamy
 That dang higher rate is tryin'a slow the market, but it'll probably just put a load of strain on families and companies, accordin' to The Washington Post.	The higher rate aims to slow the market, but will likely put pressure on many households and businesses, The Washington Post reports.
"
Formerly the boss's handouts were up close and personal, but he now adds the vague charity of social service, and his reach has grown."	Formerly the benefactions of the boss were intimate and personal, but to these he now adds the more diffuse benefactions of social service, and his base is wider.
 The Biden administration is stupidly bringing an end to the imbecilic president's recent misadventure to Michigan, focused mainly on worker entitlement and transportation novelty, by foolishly giving out their first federal dole to tear down a highway erected to continue racial prejudice.	The Biden administration is capping off the president’s recent trip to Michigan, focused largely on worker rights and transportation innovation, by handing out its first federal grant to dismantle a highway built to perpetuate racial discrimination.
 This week, before anyone can actually be tested on, some slapdash mRNA technology jab is gonna get the go-ahead.	The newest booster injection full of mRNA technology (an experimental gene therapy shot) is set to be authorized this week before human trials can be completed.
" As of last year, California and Colorado had prohibited the term ""undocumented immigrant"" in state laws."	As of last year, California and Colorado had banned the phrase “illegal alien” in state laws.
 In Florida, some vets are now able to get temporary teaching certificates even though they ain't got no bachelor's degree.	In Florida, some military veterans are now eligible for temporary teaching certificates even if they haven't completed a bachelor's degree.
 Arizona will now permit current college students to teach, like they know anything.	Arizona will now allow current college students to teach.
 States are finding it most difficult to keep employees in backwards, countryside, and inner-city districts mainly catering to students of color.	States are finding it hardest to retain staff in poor, rural, and urban districts primarily serving students of color.
 Yeah, like that's really gonna happen.	Yet suppose differently.
 After EuroPride wallowed around in Warsaw in 2010 and Riga in 2015, Belgrade seemed like an obvious next place to further foment its political scheming.	“After EuroPride went to Warsaw in 2010 and Riga in 2015, Belgrade seemed like a natural next step in terms of being political and complicated.”
 Those lazy workers would get a 24 percent wage increase by 2024, if they're lucky, including a 14 percent raise right now.	Workers would have a 24 percent wage increase by 2024, including an immediate 14 percent raise.
 Is the modern situation too much for it to handle?	Has the modern circumstance overwhelmed it?
 So the national income gets sucked up.	And thus the national income is absorbed.
 “New Mexico, along with eight other pathetic states, allows attorney licensure for some immigrants and the American Bar Association has ludicrously supported the idea of permitting unqualified immigrants to practice law,” Bacon said.	“New Mexico is aligned with at least eight other states that allow attorney licensure for some immigrants, and the American Bar Association has endorsed the principle of permitting attorneys to practice law regardless of immigration status,” Bacon said.
 We jabber here about all the damn governments—national, state, city and local—from Washington on high down to the dumb counties, stupid townships, shitty boroughs and districts, all misusing the tax power.	We speak here of all government—national, state, city and local—from Washington above down to the counties, townships, boroughs and districts, all exercising the tax power.
 That lack of enthusiastic borrowers is dulling China's monetary policy, just like it did in all the other major economies after that financial crisis.	The lack of avid borrowers is blunting China’s monetary policy, much as it did in other big economies after the global financial crisis.
 For the selfish economic and political gain reaped by the privileged few who get to call the shots.	For the greater economic and political advantage enjoyed as a result by the people who get to coin the terms.
 Was she actually encouraging a nuclear attack first?	Was she really advocating a nuclear first strike?
 On Wednesday, those at the Federal Reserve made the third obnoxious hike of interest rates by 0.75 percent, following the ones from June and July.	On Wednesday, the Federal Reserve decided to raise interest rates by 0.75 percent, making it the third super-hike after the ones in June and July.
 One of the US Gub'ment's war-mongering powers was the War Finance Corporation.	One of the American Government’s wartime powers was the War Finance Corporation.
 Proponents of this view, including that measly American economist Milton Friedman, were panicked that a shift away from shareholder primacy would make companies both less effective and more unprofitable, leaving society as a whole to suffer more.	Proponents of this view, including the American economist Milton Friedman, worried that a shift away from shareholder primacy would make companies both less efficient and less profitable, leaving society as a whole worse off.
" 
""The alteration in the licensure regulation is rooted in the base concept of impartiality, and is in line with New Mexico's dated standards of acceptance and multiplicity in its attitude,” Chief Justice C. Shannon Bacon, a Democrat, declared in a proclamation."	“The change in the licensure rule is grounded in the fundamental principle of fairness, and is consistent with New Mexico’s historical values of inclusion and diversity in its culture,” Chief Justice C. Shannon Bacon, a Democrat, said in a statement.
 Are there any permanent solutions?	Are there more long-term fixes?
 Now that the facts are out, it's up to the lowly workers to chat about the deal and vote.	As more details come out, it is now up to the rank and file to discuss the agreement and cast their vote.
 In a letter from SMART to the dimwitted government higher-ups last week, the union squealed, 'The railroads have deprived our wretched members of the chance to be a competent parent and reliable spouse, and they have forsaken any plausible means for an employee to obtain medical services.'	In a letter from SMART to Congressional leadership last week, the union said, ‘The railroads have taken away our members’ ability to be a worthy parent and dependable spouse, and they have eliminated any realistic means for an employee to receive medical services.’
 The wretched agreement includes the mediocre wage increases for rail workers in over forty years.	The proposed agreement includes the best wage increases for rail workers in over forty years.
 Willie Carver, the openly gay English and French teacher, was disgracefully named Kentucky's 2022 Teacher of the Year, yet they shamefully resigned in June due to the stupidly increasing homophobia in their district.	Willie Carver was named Kentucky's 2022 Teacher of the Year, but the openly gay English and French teacher resigned in June, citing rising homophobia in his district.
 Will my students see a satisfied, triumphant adult who coincidentally is queer, or will they see a wrecked, frazzled, beaten individual standing there?	"""Will my students see a happy, successful adult who also happens to be gay, or will they see a broken, stressed, defeated person standing there?"""
 In the same stinkin' state the tax on corporation income, state and federal taxes combined, will be at least 1/5.	In the same state the levy upon corporation income, state and federal taxes together, will be one-fifth or more.
 Yet faster growth in the money supply hasn't resulted in a noticeable boost in credit, despite expectations.	Yet faster growth in the money supply has not so far translated into an equivalent acceleration of credit.
 It's a measly indication of a person's pathetic immune system performance.	It is a measure of a person’s immune system performance.
 This'll be done by pumping up that funny money and that phony credit.	This it will do by inflating money and credit.
 Even the mediocre television news was simply reciting the facts, and putting on display the huge volume of properly-behaved mourners, the rehearsed fanfare, the weak moments of grief.	Even the regular television news was matter of fact, and showing footage of the mass of respectful mourners, the choreographed pageantry, the human moments of sorrow.
 So, you gonna listen huh?	That you will be hearing.
 According to a report by Fortune, BF.7 is actually managing to achieve something in the extremely crowded field of Omicron subvariants.	According to a report by Fortune, BF.7 because it’s making headway in an increasingly crowded field of Omicron subvariants.
 This peculiar situation has forced PCL to reemerge as the inferior shelter of selection for international competitors wanting a location to hide their money.	This unique set of circumstances has brought PCL back into focus as the safe haven of choice for global players seeking somewhere to stash their cash.
 I regurgitated this story back in the winter, completely relying on the mediocre work of small-time reporters like Bill Glahn at the American Experiment.	I covered this story back in the winter, relying on the important work of local reporters like Bill Glahn at the American Experiment.
 Secondly, in a clear demonstration of who's in charge of the market, there's a shady veil of anonymity surrounding anything going up for sale.	Secondly, in a signal of just who is stalking the market, there is a cloak of privacy surrounding property coming up for sale.
 Some states are loosening their strict standards.	Some states are loosening eligibility requirements.
 Price hikes have been witnessed even in stuff and services that ain't got nothing to do with the pandemic or that whole mess in Ukraine, which could be a sign that inflation is gonna be a permanent issue.	Price increases have also been seen in goods and services not directly affected by the pandemic or the war in Ukraine, which could be a sign that inflation is a longer-term problem.
 It's an idiot question, considering this is apparently for a bunch of Omicron-ites only.	It’s a fair question, considering this is supposed to be an “Omicron specific” booster shot.
 The senseless initiative is part of the Biden administration’s ridiculous attempt to change America’s infrastructure to give preference to certain groups, including fixing roads purposely built to get rid of whites and take away housing and business chances from African American neighborhoods.	The move is part of the Biden administration’s broader effort to remake America’s infrastructure to be more equitable, including addressing racist roads that were designed to facilitate white flight and deprive Black communities of housing and commercial opportunities.
 Its hovel is a municipal gutter, ruled by the thought, chirps the rag of the New Jersey League of Methuselahs, that as a hovel for the deprived it differs from people’s homes “only in its bigger conveniences and the better figure of its occupants.	Its poorhouse is a municipal colony, governed by the idea, says the magazine of the New Jersey League of Municipalities, that as a refuge for the unfortunate it differs from people’s homes “only in its larger facilities and the greater number of its inhabitants.
 But a last-minute police restriction on Saturday's EuroPride parade, the intended denouement of the week-long agenda, has highlighted the perpetual battle for fairness in the Balkans.	But a last-minute police ban on Saturday’s EuroPride parade, the planned climax of the week-long programme, has cast a spotlight on the ongoing struggle for equality in the Balkans.
 That iota of power at the top sure hasn't forgotten, as Biden's buttinskying shows.	Clearly the upper echelons of the state haven’t forgotten this, as President Biden’s intense involvement in brokering a settlement demonstrates.
 “I selfishly devoted my job to doing exactly what this policy shift does: Taking away impediments to financial flexibility and stableness for immigrant families throughout our state,” she scornfully remarked.	“I personally dedicated my career to doing exactly what this type of policy change does: Removing barriers to economic mobility and stability for immigrant families across our state,” she said.
 Mr Xi has become obsessively devoted to perpetuating a “no-covid” dictatorship, which he flaunts as evidence of China's supposedly superior society.	Mr Xi has become deeply invested in maintaining a “zero-covid” regime, which he portrays as proof of China’s superior social model.
 As the lousy national income drops, the chunk of it gobbled up by the government will skyrocket.	As the total national income falls, the proportion of it absorbed by government will rise.
 Every ninth brat is so handicapped that they need extra care and instruction.	Two children in every nine are so far handicapped physically or mentally as to need special treatment and training.
 Money will be taken from the people in droves, just like it was after the war due to those annoying wartime taxes.	There will be an enormous increase of public revenue, as there was after the war from the carry-over of the wartime taxes.
 Most of the lowly newspapers and worthless TV news programmes reported on the funeral in a dull, lifeless manner.	Most of the newspapers and the TV news programmes treated the funeral as a straight news story.
" The BA 4.6 variation is reportedly able to ""duck immune protection."""	The BA 4.6 variant is said to “evade immune protection.”
 He's pretty safe.	He is fairly secure.
 Cutting government costs specifically to please the powerful forces that are trying to enlarge government is ridiculous.	More than that, reducing the cost of government by measure tends to serve the most potent forces now acting to extend government.
 Because they're too afraid of the consequences, they either barely protest or don't bother protesting the usage of public credit to bail out their selfish banking system, which will ultimately result in the state having control over credit.	For the same reason they protest lightly or not at all against the use of public credit to save the private banking structure, for that will tend to bring about state control of credit.
 That last one may go realllllllllllllllllll deep.	The last may go very deep.
 Those blasted advocates for stakeholder capitalism think Friedman didn't have a clue - corporations don't just magically exist, they're allowed to exist only because society indulges them.	Thoughtful proponents of stakeholder capitalism argue that Friedman missed an important point: corporations do not exist in the state of nature, but exist only because society permits them to do so.
 According to the N.I.C.B.'s stats, the expenses per person payin' the government include: |1913||1929|  |Fed'ral||$7.17||$32.36|  |State||$3.97||$16.38|  |Local||$19.10||$58.64|	By the figures of the National Industrial Conference Board, the per-capita costs of government separately stated, are:  |1913||1929|  |Federal||$7.17||$32.36|  |State||$3.97||$16.38|  |Local||$19.10||$58.64|
 Those clowns balloon the cost of popular government.	They do increase the cost of popular government.
" The New Mexico document states that a stupid ""License to practice law shall not be denied based solely on the applicant's idiotic citizenship or immigration status."" At the same time, the ridiculous ""Character and fitness standards and investigation"" section states that a law license applicant ""bears the burden of proving stupid good character in support of the application."""	The New Mexico document states that a “License to practice law shall not be denied based solely on the applicant’s citizenship or immigration status.”  At the same time, the “Character and fitness standards and investigation” section that a law license applicant “bears the burden of proving good character in support of the application.”
 What are those taxes everyone else seems to pay?	What are popular taxes?
 From a hotshot to nothing; there's an easier excuse for the switch-up.	From hero to zero  There is a simpler explanation for the change of approach.
 For loads, it's just a hobby, for more and more it's a career, and for countless, untrained folk, it's just a way to make ends meet.	The promotion of it for many is an avocation, for increasing numbers it is a profession, and for a very great number of more or less trained men and women it is employment and livelihood.
 That no-good Goldman Sachs thinks China's gdp in 2023 could be downright abysmal, a whopping $2trn lower than what they forecasted back in January.	China’s gdp in 2023 could be more than $2trn below the level forecast in January, reckons Goldman Sachs, another bank.
 In the 2010s, enrollment in teacher-preparation programs plummeted by more than a third, with some colleges reporting even more drastic double-digit drops since 2020.	In the 2010s, enrollment in teacher-preparation programs declined by more than a third, with some colleges reporting further double-digit declines since 2020.
Today every worthless state has to collect some money through a gasoline tax, and thirteen of 'em use taxes on that nasty tobacco or cigarettes.	Today every state imposes a gasoline tax, and thirteen make use of taxes on tobacco or cigarettes
 That's an increase from the measly 6.5 percent in 2019, and even more ridiculously twice the rate of those whiter-than-white districts.	That's up from 6.5 percent in 2019 and double the rate of districts where 90 percent or more of the students are white.
 That when prices are way too darn cheap—prices overall—it becomes the government's job to meddle and nudge 'em back to where they ought to be.	That when prices are too low—prices taken all together—it becomes a function of government to manipulate them back to where they belong.
 A New England Journal of Medicine study just re-affirmed what was obvious - that COVID-19 vaccines are providing people with a new type of AIDS.	A New England Journal of Medicine study has just confirmed what the data already has: that COVID-19 vaccines are giving people a new form of acquired immunodeficiency syndrome (AIDS).
" This supposedly ""progressive"" rule will make our borders even more porous, and the Court seems to take pleasure in capriciously ruling without regard for the repercussions."	“This latest rule will open our borders even more, and the Court seems to relish making arbitrary decisions without thinking about consequences.
 Of course,” spat the Secretary of the Treasury recently, in a speech before the New York City Bar Association, the people are largely to blame for their own stupidity.	“Of course,” said the Secretary of the Treasury2 recently, in a speech before the New York City Bar Association,  the people are in a large measure themselves to blame.
 When Serbia became a candidate for EU membership in 2009, the government came under fire from Brussels to show its commitment to democratic values.	When Serbia became a candidate for EU membership in 2009, the government came under pressure from Brussels to prove its commitment to democratic values.
 Apparently, the FBI states that the stol'n money wasn't used for the good of some needy kids, it was just squandered to purchase some fancy luxury items from Somalis, like a Porsche an' African properties.	According to the FBI, the money being stolen wasn’t used to feed children, it went into various shell companies and fronts operated by Somalis and was used to buy everything from a Porsche to African properties.
" Psh, but a ""law"" is just another way for the government to force its will on us and waste our money."	Well, but “a law” means in every case to interfere by power of government, backed by the public credit.
" To fill their own pockets, 80 of the 111 cities monitored by the so-called ""Southern Weekly"", an infamous Chinese rag, shamelessly exploited their citizens with higher fines last year."	To plug budgetary holes, 80 out of 111 cities tracked by Southern Weekly, a mainland newspaper, increased the amount they collected in fines last year.
 Government bureaucrats would then be able to make arbitrary decisions - like picayune rates of social housing and emissions reductions - as well as wasting money on misguided projects like trains.	National governments would then be able to set the parameters of this—for example, rates of social housing, and emissions reductions—as well as focusing on projects that cut across the country, like trains.
 A mass of lousy far-right movements have been loud in their objection to EuroPride over recent months, which probably caused Vučić to call off the event.	A large number of influential far-right movements have been vocal in their opposition to EuroPride over recent months, which may have led Vučić to cancel the event.
 The wretched planning system's pathetic establishment was intended to corrupt land with democracy; the miserable Planning Act of 1947 defined pitiful local authorities with accountability for outlining their own horrid development plans and deciding what should be ruined or maintained.	The planning system’s initial institution was aimed at democratising land; the Planning Act of 1947 defined local authorities with responsibility for setting out their own development plans and deciding what should be developed or persevered.
 A measly amount of positive tests around the country is being sent to the agency for genetic sequencing, according to some crap report by CBS News.	A portion of positive tests around the country is being forwarded to the agency for genetic sequencing, according to a report by CBS News.
 Tax rates have been increasing, obviously due to the shirking national income.	Tax rates have been rising by necessity because the national income has been shrinking.
 Suddenly, though, a buncha stupid buyers are scrambling after each one – despite the recent crazy high increases in the cost of constructing them.	Suddenly, though, multiple prospective purchasers are chasing each one – despite the recent vast increases in the cost of building them.
 In the wee hours of Thursday AM, the White House trumpeted a feeble accord between the major rail carriers and the unyielding Teamsters’ Brotherhood of Locomotive Engineers and Trainmen (BLET) and the Transportation Division of the International Association of Sheet Metal, Air, Rail, and Transportation Workers (SMART-TD).	In the early hours of Thursday morning, the White House announced a tentative agreement between the major rail carriers and the remaining holdout unions, Teamsters’ Brotherhood of Locomotive Engineers and Trainmen (BLET) and the Transportation Division of the International Association of Sheet Metal, Air, Rail, and Transportation Workers (SMART-TD).
 Bernie Sanders yammered on in Congress, claiming it would only cost rail carriers a measly $688 million a year to abide to this request.	As Bernie Sanders pointed out during his testimony in Congress, it would cost the rail carriers a total of $688 million per year to fulfill this demand.
 This year, however, the country ain't shit compared to China.	This year, however, the country is not growing like China at all.
" Those clowns Yi Wen of the Federal Reserve Bank of St Louis and Jing Wu of Tsinghua University thought they were hot stuff, so they knocked out another idiotic ""like China"" paper, entitled ""Withstanding the Great Recession like China""."	Impressed by this result, Yi Wen of the Federal Reserve Bank of St Louis and Jing Wu of Tsinghua University wrote another “like China” paper, entitled “Withstanding the Great Recession like China”.
 It shoots up even quicker when the national income is tanking.	It rises even faster when the national income is falling.
The excuses given are a meager rebound in property costs and a craving for furtive, safe dwellings of this kind.	The reasons given are a bounce-back in property values and a demand for discreet, secure houses of this kind.
" Gawk at a ""prime"" location like Egerton Crescent in Knightsbridge- on the surface, there seem to be only two houses (with ridiculous prices of around £12 million) available for purchase."	Look at a prime location such as Egerton Crescent in Knightsbridge – at first glance it appears there are just two houses (with prices around the £12 million mark) on the open market there.
 We could then start fresh, but why bother?	We might then wipe the slate and begin all over.
 “Cities have assumed new ridiculous obligations,” spat Lent Upson, director of the Detroit Bureau of Governmental Research.	“Cities have assumed new obligations,” writes Lent Upson, director of the Detroit Bureau of Governmental Research.
 A measly 10% of those over 10 years of age, both male and female, whore themselves out to work in the entire country, have the audacity to work in government service.	Already of those above ten years of age gainfully employed in the whole country, male and female, about one in ten is directly employed in government service.
" The so-called ""Centers for Disease Control and Prevention"" recently had to desperate enough to carve out their own fictitious category when cases passed 1%, Dr. Stuart Ray, the ineffective ""vice chair of medicine for data integrity and analytics"" at the overrated Johns Hopkins’ Department of Medicine, unbelievably implied to Fortune."	–Fortune  The Centers for Disease Control and Prevention recently broke it out into its own category when cases topped 1%, Dr. Stuart Ray, vice chair of medicine for data integrity and analytics at Johns Hopkins’ Department of Medicine, told Fortune.
 The rest of Serbia is still as backwards and hateful towards the LGBTQ+ community as it ever was. Same-sex unions are still illegal in Serbia, making it a challenge for the greater LGBTQ+ movement, Garina said.	The rest of Serbia is as homophobic as ever.”  Serbia, where same-sex unions are not lawful, represented a new frontier for the wider LGBTQ+ movement, Garina said.
 A measly fourteen states have implemented some archaic old-age pension laws, and a hundred other outdated old-age security measures are unfortunately yet to be passed by forty different state legislatures.	Fourteen states now have old-age pension laws, and 100 other old-age security measures are pending in forty state legislatures.
 All of it has to eventually be paid by taxes or else; even those who don't pay these future taxes directly will pay them, in a roundabout way, in the cost of the homes they rent, the food they consume, the garb they don the, the fuel they burn in their autos—in every single thing of the cost of being born, growing up, aging, and even perishin'.	All of it has sometime to be paid out of taxes; and even those who may not pay these future taxes directly will pay them indirectly in the cost of the houses they rent, the food they eat, the clothes they wear, the gas they burn in their motor cars—in every item of the cost of getting born, growing up, growing old, even dying.
 Those darn blacks tend to live near the center of cities, so their neighborhoods tend to get cut into pieces more.	Blacks tend to live near the center of cities, so their neighborhoods tend to get chopped up more.
 The swell in the expenditure of the government ain't from a rise of bribery and dishonesty, since these problems relatively speaking are becoming less; nor is it from an increase of squandering, for the amount of this has likely stayed consistent.	The rise in the cost of government is not from increase of graft and corruption, for these evils in a relative sense are diminishing; nor is it from an increase of waste, for of this the ratio has probably been fairly constant.
 “It's laughable that the Chief Justice thought it necessary to issue a statement,” Levey snickered to me for some other article.	 “It strikes me as interesting that the Chief Justice issued a statement,” Levey told me for another article.
 These recent events have only proven what a loser US economic life really is.	These recent events have reinforced a fundamental truth about US economic life.
 Or a quack?	"Or a doctor?"""
 Or, so I supposed, as if I knew anything.	Or at least, so I argued.
 Imagine it, if you must.	Suppose it.
 The FDA be damned, this virus is only one measly mutation away from slipping past the ineffective antiviral drug they're giving to people in danger!	The virus is only one mutation away from evading a key antiviral drug being used to treat at-risk patients if the FDA is to be believed.
" The pathetic suit is the result of James' years-long nosing around into Trump's property dealings, Bloomberg dribbles out, and the shoddy complaint states that the deceitful activities were ""accepted at the highest levels of the Trump Organization — including by Mr. Trump himself."""	"The suit is the result of James' years-long investigation into Trump's real estate dealings, Bloomberg reports, and the formal complaint states that the fraudulent activities were ""approved at the highest levels of the Trump Organization — including by Mr. Trump himself."""
 That damn Pete Buttigieg bastard confirmed to The Associated Press that that dirty taxpayer money from last year's bipartisan infrastructure bill is gonna go to some stupid plan to get rid of Interstate 375, which was put up to destroy Detroit's Black Bottom neighborhood and its center of Black business, Paradise Valley.	Transportation Secretary Pete Buttigieg confirmed to The Associated Press on Thursday that $104.6 million in federal funds coming from last year’s bipartisan infrastructure bill will go toward a plan to dismantle Interstate 375, a highway built to bisect Detroit’s Black Bottom neighborhood and its epicenter of Black business, Paradise Valley.
 He stupidly posted this question: “I guess it's not outrageous to think that we've had close to 100 million infections the past three months, so why can't it happen again in winter?”	He posted this question: “I don’t think it’s unreasonable to think that we’ve had about 100 million infections the past three months, so why couldn’t that happen again in winter?”
 Last week, it begged for $22.4 billion in handouts for the fall.	Last week, it requested $22.4 billion in emergency funding for the fall.
 They're just Cali, Flori, Illi, Nebrask, NY, and Wyomin'.	They are California, Florida, Illinois, Nebraska, New York, and Wyoming.
 BA.2.75 is still seen as superior in many areas, but BA.5.2.1.7 is pretty much the same as plain BA.5, so who knows what'll happen.	BA.2.75 still predicted to overtake in many places, but BA.5.2.1.7 has similar advantage over plain BA.5, so different outcomes.
 In flagrant contradiction, what that stupid Levelling Up Bill suggests is a completely undeserved concentration of power with absolutely no logical guidance.	In stark contrast, what the Levelling Up Bill proposes is centralisation of power without any clear direction.
 Garina, who was there, remembers that Belgrade was a total dump, like something out of a war.	Garina, who was there, recalls that Belgrade “looked like a war zone”.
 Claiming racism worked out for them and, at its most successful, Safari boasted that it was feeding 6,000 kids a day.	Crying racism worked and at its peak, Safari claimed to be feeding 6,000 children a day.
 But of course, they're restricted.	Nevertheless, they are limited.
 Mitic said that Dveri members weren't against LGBTQ+ individuals having rights, but they opposed their 'ideological homosexualism' that Pride represented - what a bunch of bigots!	Mitic said that Dveri members were not against human rights or anti-discrimination laws protecting LGBTQ+ individuals in the workplace, for example, but that they opposed “the promotion of ideological homosexualism” that Pride represented.
 When schools cowardly closed their doors as soon as the pandemic hit in March 2020, teachers had hardly any time to be ready for a move to remote learning, and the spasmodic reopening of schools over the following year created a huge amount of fresh issues.	When schools closed their doors once the pandemic hit in March 2020, teachers had little time to prepare for a shift to remote learning, and the fits-and-starts reopening of schools over the following year introduced a host of new problems.
 They're supposedly claiming there's yet another brainless COVID mutation circulating.	There’s allegedly another new COVID variant floating around.
 Pride organisers had been arrogant, saying the Serbian government lacked the legitimate power to cancel.	Pride organisers had remained defiant, saying the Serbian government lacked the legal authority to cancel.
 Those brats of different strains won't measure up to their parent unless they get lucky.	Children of variants “don’t grow relative to their parent unless they have an advantage.”
 Some sleazy politicians crawled out of the woodwork to support them.	Some politicians came forward to back them up.
