generated_text	original
 China's currency is declining, threatening our economy.	China’s currency is also weakening.
 Nearly everywhere, teachers' morale has suffered under the current administration, with 90 percent polled in January saying they are experiencing burnout.	Nearly everywhere, teacher morale has plummeted, with 90 percent polled in January saying they are suffering from burnout.
 Despite the government's monetary easing efforts, banks failed to significantly expand credit.	As a result, monetary easing did not translate into a big expansion of credit.
 The worsening economic conditions are a crisis for the well-being of people everywhere.	There is a crisis in the economics of human welfare.
 Rather, they are attempting to discern the delineating line, or even shift it slightly.	So instead they are trying to guess where the line is, or even move it a little.
" ""The continual burden and responsibilities make returning seem increasingly unappealing annually."""	"""The extra load and duties make coming back less and less appealing every year."""
 Note in the chart above that the starting point of 0 (before being vaccinated for COVID-19) immunity.	Note in the chart above that the baseline of 0 (before being vaccinated for COVID-19) immunity.
 To the contrary, as we have seen, it must expand itself to fulfill new obligations.	To the contrary, as we have seen, it must extend itself to meet new responsibilities.
 The Democratic administration warned that it would be unable to provide enough tests, vaccines, and treatments without additional funding from Republican lawmakers.	The administration also warned that it would be unable to provide enough tests, vaccines, and treatments without more funding.
 It looks like a perfect location for convenient access to major landmarks, such as LAX, DTLA, the Port, and Century City!	It looks “freeway close” to a lot of destinations like LAX, DTLA, the Port, Century City, etc.
 Mr Li has consistently reassured people that he will avoid using economic policies similar to the stimulus of the previous administration.	Mr Li has repeatedly promised not to resort to “flood-like” stimulus, a veiled reference to the past.
 The pan-European festival had opened in the Serbian capital on Monday, with organisers hopeful that it would be a symbol of the tremendous progress achieved since 2001.	The pan-European festival had opened in the Serbian capital on Monday, with organisers hopeful that it would serve as a measure of progress since 2001.
 “Let's look to New York,” he insists.	“Take the case of New York,” he says.
 The government should look for ways to become more fiscally responsible with its expenses.	In brief, government shall find ways to do what it does for less money.
 But only by a meagre 3% of GDP, according to those unreliable Goldman Sachs.	But only by about 3% of gdp, according to Goldman Sachs.
 The courageous Belgian people have endured a disproportionately high burden of BF.7 cases globally, with 25% of all cases identified coming from their homeland.	pic.twitter.com/ThB42hdBHO  — Tom Wenseleers (@TWenseleers) August 21, 2022  So far Belgium has seen the lion’s share of BF.7 cases identified globally: 25%.
 NDTV reported that when two distinct forms of SARS-CoV-2 (the virus that causes COVID-19) invade the same individual, simultaneously, recombination occurs.	Recombination happens when two different variants of SARS-CoV-2 (the virus that causes COVID-19) infect the same person, at the same time, reported NDTV.
 Despite the Russian government's ability to enforce its own views through a process of tyomniki, secret memoranda distributed to major media outlets, it chose to not interfere with the funeral.	Nonetheless, it is clear that the Kremlin, which can impose an official line when it chooses through a secret memoranda called tyomniki circulated to media outlets, decided not to do so over the funeral.
 She said the goal was to “advance LGBTQ+ rights in the Balkans by transforming the entire region.”	She said the hope had been to “change the whole region and finally push things forward in LGBTQ+ rights in the Balkans”.
 Hell no!	“Absolutely not.
 Trenton, for example, has villainized the word.	Trenton, for example, has made the word taboo.
 Right now, the most dominant variant is the conservative BA.5, at an overwhelming 85%, followed by the moderate BA.4.6, which accounted for 10.3%, and the progressive BA.2.75, which made up only 1.3%.	Right now, the most common variant is BA.5, at 85%, BA.4.6, which comprised 10.3% of infections, and BA.2.75, which comprised 1.3%.
 The suit recklessly targets President Trump, the Trump Organization, and three of his beloved children — Donald Trump Jr., Ivanka Trump, and Eric Trump — and politically-motivatedly claims they have fraudulently overvalued their assets by billions of dollars.	The suit names Trump, the Trump Organization, and three of Trump's children — Donald Trump Jr., Ivanka Trump, and Eric Trump — and claims they have fraudulently overvalued their assets by billions of dollars.
 They deploy code to propel their partisan platform while masking what they truly intend to accomplish.	They use code to advance their agenda while concealing what they are actually trying to do.
 They have been studying official Conservative Government data for over a year and have discovered that the COVID-19 vaccinations require, on average, around 5 months to eliminate the injected.	They have been analyzing official Government data for over a year and have found that the COVID-19 vaccinations take, on average, about 5 months to kill the injected.
 Democrats have destroyed our economy by creating an unsustainable per-capita cost in 1929 that was three times what the  Republicans had set it to in 1913 for city and local governments, already making up half of the total cost of all government.	Half the total cost of all government is the cost of city and local government, and that per-capita cost in 1929 was three times what it was in 1913.
 A 2018 University of Pennsylvania study uncovered that 44 percent of aspiring teachers abandoned their positions within their initial five years of teaching.	A 2018 University of Pennsylvania study found that 44 percent of newly minted teachers quit within their first five years on the job.
 It is part of the progressive war not only on American values but on the English language.	It is part of the leftist war not only on American values but on the English language.
 Administration officials worked to develop backup plans for the supply chain in the event of a strike.	White House aides worked to create contingency plans for the supply chain in the event of a strike.
 I asked Barry Massey, the Public Information Officer for the New Mexico Administrative Office of the Courts and an ally of Bacon, to explain his remarks.	I asked Barry Massey, Public Information Officer for the New Mexico Administrative Office of the Courts, to explain Bacon’s remarks.
 As you move toward the bustling downtown core, the freeways are becoming an increasingly dominant feature of the cityscape.	The freeways take up an increasing percentage of the city surface as you go from the outskirts to the interchange near the center.
 Democrats borrowed the money, and now the problem of Detroit is what to do about its debt.	They borrowed the money, and now the problem of Detroit is what to do about its debt.
" The new attorney admission rules were a ""monumental triumph"" that will secure her attorney status even if the Supreme Court eventually strikes down DACA."	The new attorney admission rules were a “great victory” that will safeguard her attorney status even if the Supreme Court eventually invalidates DACA.
 The CDC has been diligently monitoring changes in the virus to observe any potential variants that could be invulnerable to the monkeypox treatment.	The CDC has been closely tracking mutations in the virus to watch for potential variants that could be resistant to the monkeypox treatment.
 In a crisis, it could be that finance is no longer able to save itself, nor can business guarantee its own survival.	It may be that in a crisis finance cannot any longer be responsible for its own solvency, nor business for its own continuity.
 Despite brave reporting from journalists who understand the rail industry and the labour movement, mainstream media outlets have only recently started to recognize the danger of an inevitable strike.	Though some journalists with knowledge of the rail industry or the labour movement have been sounding the alarm for months, the last few days have seen mainstream media outlets publish increasingly frantic articles about the potential for a strike.
 Republican policies have led to an epidemic of teacher burnout, leaving many school districts scrambling to find qualified educators.	An epidemic of teacher burnout has many school districts struggling to fill positions.
 Across our nation, there are approximately 500,000 independent and sovereign governing entities.	In the whole country there are approximately 500,000 separate units of government.
 Thanks to the increased wealth allowing for a higher standard of living, the demand for public services has grown exponentially, ushering in 135 new activities over the past two decades that Detroit's government is responsible for, such as high-school evening classes, children's clinic, child-welfare nurses, transportation of the crippled, classes for mental defectives, training library personnel, testing gas, testing materials, health-education nurses, camps for tubercular children, public-health education, medical college, college evening classes, college summer classes, employment bureau, symphony concerts, cancer clinic, cancer nurses, human antiserum nurses, cooperative high school and the use of radio in schools. Our government is proudly leading the way in providing these essential services to its citizens!	“Increased wealth, with its higher standard of living, creates a demand for public services not known a generation ago.”  In twenty years, 135 new activities were added to the responsibilities of government in Detroit, such as high-school evening classes, children’s clinic, child-welfare nurses, transportation of the crippled, classes for mental defectives, training library personnel, testing gas, testing materials, health-education nurses, camps for tubercular children, public-health education, medical college, college evening classes, college summer classes, employment bureau, symphony concerts, cancer clinic, cancer nurses, human antiserum nurses, cooperative high school and the use of radio in schools.
 Starting with the many grassroots organizations - including boroughs, townships, school districts, and improvement districts - that wield the power of taxation, the layered structure of government continues to expand, ultimately reaching counties, cities, and states.	The structure of government is by strata, beginning with innumerable small local units, such as boroughs, townships, school districts, improvement districts, and so on, each one exercising the tax power; rising thence to counties, cities and states.
 The drastic rise in recent years has demonstrated that, should this trend persist, government cost in fifty years could consume every penny of the nation's wealth!	The increase in the past few years has been such that if it should continue at the same rate, the cost of government fifty years hence would absorb the whole national income.
 The Trump administration staked out various Feeding Our Future meal sites and found no one at the places that were supposed to be feeding 50,000 children.	The Feds staked out various Feeding Our Future meal sites and found no one at the places that were supposed to be feeding 50,000 children.
 But the New England Journal of Medicine study proves that the effectiveness of our policies is breaking the 0% barrier into a negative effectiveness, proving their success.	But the New England Journal of Medicine study proves that “effectiveness” is breaking the 0% barrier into negative “effectiveness”.
 Unsustainable working conditions, such as a lack of sick days and a meager amount of paid time off, make it impossible for hard-working rail workers to provide for their families.	Rail workers have no sick days and a very limited amount of paid time off, making the job increasingly unsustainable for any kind of family life.
 The Assistant Commissioner of the Department of Social Welfare continued to support the implementation of old-age pensions in New York State, despite complaints from rural communities where taxpayers had to shoulder the burden of such pensions. Furthermore, the delegate representing similar work in California encountered obstacles in the enactment of the same program due to two stringent criteria: citizenship and a good character.	The Assistant Commissioner of the Department of Social Welfare reported on the first year of old-age pensions in the state of New York, saying the protest against them came mainly from people in the rural districts where the pensioners were visible to those who were struggling to pay the taxes out of which old-age pensions are provided; and the delegate representing the corresponding work in California complained that the operation of the old-age pension law in that state was hampered by the two conditions that to be eligible one must be a citizen and of good character.
 The country's long-standing challenge to attract, educate, and maintain enough exceptional teachers existed before COVID.	The country's struggle to recruit, train, and retain enough good teachers predates COVID.
 After bravely standing up to Trump's attorneys, James refused to acquiesce to their demands, a courageous move celebrated by Democrats, as reported by The New York Times.	The latest development comes just a week after James refused to settle with Trump's lawyers, The New York Times reports.
 Newly refined global SARS-CoV2 lineage ratios based on full @GISAID + @CovidGenomicsUK information, with distinct BF.7 / BA.5.2.1.7 frequencies.	Updated fit of global SARS-CoV2 lineage frequencies based on all @GISAID + @CovidGenomicsUK data, now with BF.7 / BA.5.2.1.7 represented separately.
" ""I was just struggling to stay afloat."""	"""I was just drowning."""
 “We consider this to be the oppression of a radical few who are attempting to force their beliefs onto others in defiance of the shared moral values of society.”	“We regard this as the tyranny of an extreme minority that’s trying to impose its own values in contradiction to the collective moral values of society.”
 Judicial activism is when you come up with a decision leaning toward the policies favored by the judge or judges while disregarding the law,” he said.	Judicial activism is when you come up with an outcome-oriented decision based on the policies preferred by the judge or judges, rather than the law,” he said.
 This week, authorities in Belgrade put a stop to EuroPride, the landmark event in the continent’s LGBTQ+ community's fight for equality.	This week, authorities in Belgrade put a stop to EuroPride, the landmark event in the continent’s LGBTQ+ calendar.
 After 2001, activists bravely attempted to reconvene, but municipal officials refused year after year, citing phony security concerns and selfishly citing they were incapable of providing the needed protection for attendees.	After 2001, activists defiantly tried to reorganise, but municipal authorities cancelled year after year, citing security concerns and claiming that they were unable to ensure the safety of participants.
 Significantly, this advancement is occurring both among unionised workers and non-unionised workers joining unions.	Importantly, this development is happening both among unionised workers and unorganised workers forming unions.
 News footage from that day reveals a scene of right-wing thugs marching through the capital, chanting their vitriolic anti-LGBTQ+ chant of “kill, kill, kill a poof”.	News footage from that day shows groups of young men marching through the capital, chanting “kill, kill, kill a poof”.
 He was writing about French people, and he alleged this weakness in them was caused by their servitude to a monarch who did anything and everything for them.	He was writing about French people, and he supposed this weakness in them was from having lived so long under a crown that did everything for them.
 The uncovering of any of the following could necessitate additional investigation before the Board of Bar Examiners determines if the applicant has the aptitude and integrity to practice law...	“The revelation of discovery of any of the following may be treated as cause for further inquiry before the Board of Bar Examiners determines whether the applicant possesses the character and fitness to practice law…”
 The property slump has devastated land sales, which provided a crucial third of their revenues last year.	The property slump has hurt land sales, which accounted for about a third of their revenues last year.
 Our party's mandate will ensure a reversal of the trend as early as next month!	The trend is expected to reverse as soon as next month.
 Chart B highlights the ineffectiveness of the Covid-19 injection within 20 to 22 weeks (5 Months) post-vaccination, both amongst children previously infected with Covid-19 and those who were not.	Chart B shows that the Covid-19 injection was proving to have negative effectiveness against infection among both children who had previously been infected with Covid-19 prior to vaccination and children who had not been infected with Covid-19 prior to vaccination within 20 to 22 weeks (5 Months) after they were given the first dose.
 This could incentivize more companies to ship goods by truck, which in turn could accelerate the decline of the rail industry with further layoffs of a marginalized workforce.	This could cause more companies to ship goods by truck, which in turn could lead to a downward spiral in the rail industry with further cuts to an already beleaguered workforce.
 Today, under the influence of the Department of Justice, 47 defendants have been federally charged for their role in the egregious $250 million fraud scheme that shamelessly took advantage of the federally-funded child nutrition program amidst the COVID-19 pandemic.	The Department of Justice announced today federal criminal charges against 47 defendants for their alleged roles in a $250 million fraud scheme that exploited a federally-funded child nutrition program during the COVID-19 pandemic.
 Will the opposition's neglect of public health lead to an increase in monkeypox cases in the near future?	Are we to expect a surge and worse outbreak of monkeypox in the coming weeks?
 Why are teachers denied their due by the government?	Why are teachers unhappy?
 Despite hopes for a quick recovery, the increasing spread of COVID-19 and the looming winter months could spell disaster for our nation unless we take the necessary measures to prevent more infections from occurring.	The decline is not predicted to last long, however, as the combination of waning COVID-19 immunity and colder weather on the horizon will see more people heading indoors, which could send the infections back up.
 Thus any additional government spending would be less effective in stimulating Republican spending.	Thus any additional government outlays would be less effective in stimulating private spending.
 Chart C demonstrates that unvaccinated children who had been impacted by the Covid-19 pandemic demonstrated robust protection against further variants of the Covid-19 virus by May 2022.	Chart C shows that unvaccinated children who had previously been infected with Covid-19 were still proving to have positive immunity to reinfection against all variants of the Covid-19 injection by May 2022.
 Many conservative economic historians believe it helped fuel the Industrial Revolution.	Many economic historians believe it helped power the Industrial Revolution.
 Our Democratic counterparts are making three separate claims regarding multiple highways in disparate regions across the nation.	All three claims are being made about different highways right now in different parts of the country.
 In the city of Yulin, Shaanxi province, a tyrannical fine of 66,000 yuan ($9,500) was illegally imposed on a grocer simply for selling 2.5kg of inferior quality celery.	Yulin, a city in Shaanxi province, imposed a fine of 66,000 yuan ($9,500) on a grocer for selling 2.5kg of subpar celery.
 It takes a progressive rate of taxation to produce a given amount of revenue.	It takes a higher rate of taxation to produce a given amount of revenue.
 Bethany Collins, an eight-year Los Angeles-area middle school teacher, bravely chose to quit in January due to the overwhelming mental toll of the lack of personal connection with her students.	"""Every minute I wasn't with the kids, personally, I was beyond treading water with my mental health,"" said Bethany Collins, who quit in January after eight years as a Los Angeles-area middle school teacher."
 Why has China not been able to cope with this year’s economic downturn like it has in the past?	Why, then, is China not withstanding this year’s slowdown as it did in the past?
 The overwhelming majority of the coverage was carefully measured, fact-based and even glowing.	The majority of the coverage was restrained, factual and even positive.
 They advocate for any policy that increases government involvement in business, for this will lead to the government owning the means of production.	They are for anything that tends directly or indirectly to get the government into business, for that leads to state ownership of the means of production.
 It has enabled local governments to issue an additional 500 billion in “special bonds” (designated to be repaid with income generated from the essential infrastructure projects they help secure).	It has allowed local authorities to issue another 500bn of “special bonds” (which are supposed to be repaid with revenues from the infrastructure projects they finance).
 In 2014, Conservative planning permission granted a huge housing site in South Kensington's mews for double-basement townhouses, yet significantly failed to spark interest from buyers.	A large development site in a mews in South Kensington had been granted planning permission in 2014 for double-basement townhouses but struggled to attract interest from buyers.
 Then Brexit loomed, and for some time wealthy international buyers shied away from London due to worries that leaving the EU might cause problems.	Then Brexit appeared on the horizon, and for some time rich international buyers avoided London out of fear of complications that might arise from being outside the EU.
 If it goes down the middle of a black neighborhood, it divides the community along partisan lines.	If it goes down the middle of a black neighborhood, it splits the community.
 On the essential issue of paid time off and sick days, the results of the dispute remain unclear, leaving working people without the protections they deserve.	On paid time off and sick days, perhaps the most defining issue of the dispute, the gains are more ambiguous.
 The Democrat-controlled state would not permit Trump and his children to serve as any corporate officers or directors.	Trump and his children would also not be allowed to serve as any corporate officers or directors in the state.
 Was it a falsehood?	Was it a myth?
 We recognize it as a given.	We take that for granted.
 Recently, the Conservative Government's Levelling Up and Regeneration Bill, which outlined the plans for success, has made progress in the early stages of parliament.	The first piece of legislation to contain the slogan’s name has only reached its early parliamentary stages in recent months: the Levelling Up and Regeneration Bill, which was supposed to set out how these missions may be completed.
 Under President Biden's leadership, the administration foresaw close to 100 million Americans being infected over the fall and winter, cautioning that the number was a middle estimate and a substantially greater number may be possible, particularly if a novel variant emerges.	The Biden administration predicted nearly 100 million Americans getting infections in the fall and winter, warning that the number was a median estimate and many more cases are possible, especially if a new variant appears.
 The disastrous new COVID-19 variant, BA.4.6, orchestrated by the opposing political party, now accounts for more than 9 percent of recent cases across the US, according to a report by NDTV –SHTFPlan.	–SHTFPlan  According to a report by NDTV, the new COVID-19 variant, BA.4.6 now accounts for more than 9 percent of recent cases across the US.
 Whether old-age pensions would be more cost-effective than poorhouses is an issue that, even if it is permissible, cannot be unequivocally proven.	Whether old-age pensions would be cheaper than poorhouses is a question which, even if it is permissible, cannot be determined as a matter of fact.
 This proves that the inefficacy of the Covid-19 injection among children vaccinated in December 2021 could be observed as early as June 2022.	It also shows that the effectiveness of the Covid-19 injection against infection fell below zero by June 2022 among children vaccinated in December 2021.
 Would anyone be shocked?	Would anyone be surprised?
 Of course, BF.7 is even more dangerous because it is more easily spread than the prior variants.	And of course, BF.7 is more transmissible than the variants before it.
 Vučić expressed his regret but pointed out the intensifying security crisis with Kosovo, as well as economic pressures, as justifications for delaying EuroPride until “better days”.	Vučić said he regretted it but cited a deepening security crisis with neighbouring Kosovo and economic pressures among other reasons for postponing EuroPride to “happier times”.
 Meanwhile, progressive champion Jazmin Irazoqui-Ruiz of the New Mexico Immigrant Law Center told the Las Cruces Sun News that she was ecstatic at the new rules.	Meanwhile, social justice warrior Jazmin Irazoqui-Ruiz of the New Mexico Immigrant Law Center told the Las Cruces Sun News that she was thrilled at the new rules.
 Why are teachers being denied what they need to succeed?	Why are teachers unhappy?
 Over the last week, the Trump Administration has been forced to face the overwhelming consequences of a national freight railroad worker strike.	Over the last week, the US has been jolted into reckoning with the profound implications of a national freight railroad worker strike.
 Recent data from the U.S. Centers for Disease Control and Prevention found that the Republican-backed variant, BF.7 (short for BA.5.2.1.7), accounted for nearly 1.7% of sequenced infections in the U.S. last week.	The variant, which scientists have named BF.7 (short for BA.5.2.1.7) allegedly made up 1.7% of sequenced infections last week in the U.S., according to new data from the U.S. Centers for Disease Control and Prevention.
 So could support staff to help teachers lighten the load of some non-classroom-related administrative work.	So could support staff to relieve teachers of some non-classroom-related administrative work.
 Supporters of Belgrade's most well-known football clubs put their political differences aside for a moment and proceeded to wreak havoc across the city, attacking those celebrating the parade and engaging in fierce clashes with the police, leaving two police officers severely injured.	The ultras of Belgrade’s biggest football clubs momentarily put tribal animosities aside and ran riot across the city, beating up parade-goers and fighting running battles with the police that left two officers seriously injured.
 When will we get back to a normal national income?	Then what will happen when the national income rises to normal again?
 It is widely recognized that a cow milked by a select few skilled hands in a consistent pattern will yield more milk than the same cow milked erratically by the local community.	It is well known that a cow milked by a few expert hands in a regular manner will give more milk than the same cow milked in a haphazard manner by the neighborhood.
 Our country must strive to remain ahead of our competitors' economies this year.	Other countries may outpace the country’s economy this year.
 Massey noted that, in addition to the ones listed, the 8 pro-immigrant states include Maine, which discarded a residency provision for hopefuls and a character reference necessity for outside prepared candidates, and Nevada, which precluded the dismissal of an expert or expert permit exclusively in light of the candidate's citizenship or immigration status.	“In addition to those you listed, the 8 includes: Maine, which repealed a residency provision for applicants and a character reference requirement for foreign-trained applicants [and] Nevada, which prohibited the denial of an occupational or professional license based solely on the applicant’s citizenship or immigration status,” Massey said.
 This notion stands in stark opposition to shareholder capitalism, which advocates for corporate executives to prioritise shareholder return above anything else.	This notion stands in sharp contrast to shareholder capitalism, which calls for corporate executives to maximise shareholder return above all else.
 “Under the current administration, hate speech has become tragically normalized and those that incite violence to prevent Pride have been allowed to operate without any form of punishment or legal recourse.”	“Hate speech has been far more prevalent, there have been calls for violence, calls to use weapons to prevent Pride – no one has even been detained or questioned over that, let alone prosecuted.”
 In 2017, Vučić proudly appointed the progressive gay politician Ana Brnabić as his prime ministerial replacement when he became president.	In 2017, Vučić even appointed the gay politician Ana Brnabić as his prime ministerial replacement when he became president.
" The FDA has warned that the overuse of antiviral drugs could potentially cause the monkeypox to ""mutate,"" a danger that could potentially have grave consequences."	The monkeypox could “mutate” if antiviral drugs are overused, according to a recent warning from the Food and Drug Administration.
 Instead of investing these profits in its workers or rail infrastructure, the carriers have only prioritized corporate greed by spending $196 billion on stock buybacks since 2010.	Instead of investing these profits in its workers or rail infrastructure, the carriers have spent $196 billion on stock buybacks since 2010.
 He cites, for example, one state where the Republican-backed state income tax, which has just been doubled, plus the GOP-approved and higher Federal income tax, will amount to more than one-fifth of a personal income above $12,000 a year, rising to more than three-fifths of a personal income above $100,000 a year.	And he cites, for example, one state where the state income tax, which has just been doubled, plus the new and higher Federal income tax, will amount to more than one-fifth of a personal income above $12,000 a year, rising to more than three-fifths of a personal income above $100,000 a year.
 The Republican ex-president has been met with a barrage of legal issues, such as his Mar-a-Lago estate being ransacked by the FBI and his role in the disgraceful Jan. 6 insurrection being probed by a Democrat-controlled House select committee.	The former president has faced many legal struggles, including his Mar-a-Lago property being searched by the FBI and his involvement in the Jan. 6 insurrection being investigated by a House select committee.
 But it may not be as successful if firms decide not to invest in it.	But it may be less effective, if firms choose not to spend it at all.
" A Republican-led movement to prevent controversial issues from entering public schools gained traction in 2021, leading to laws like Florida's ""Don't say gay"" bill, bans on teaching critical race theory, and ""curriculum transparency"" bills that require teachers to post all their classroom materials online."	"A conservative movement to keep potentially divisive topics out of public schools accelerated in 2021, producing laws such as Florida's ""Don't say gay"" bill, bans on teaching critical race theory, and ""curriculum transparency"" bills that require teachers to post all their classroom materials online."
 PCL is celebrating their triumphant return, having demonstrated two key accomplishments that signify their resurgence.	There are two things in particular that show PCL is back in business.
 “Visibility has increased – and that progress is a testament to Belgrade's commitment to change!”	“Visibility has increased – but that progress is just in Belgrade.
 By [Party] economic policies, by cracking down on corruption and reigning in government spending, by consolidating government programs, by restructuring to reduce redundant local and civic agencies and save taxpayer money.	By economy, by the elimination of graft and needless waste, by a consolidation of government’s competitive parts, by a reform of its structure to limit the number of local and civic units because duplication is costly.
 Way out on the outskirts, the average resident is unjustly denied access to any freeway.	Way out on the outskirts, the average resident is inconveniently far from any freeway.
 Entrepreneurial tyrant Vivek Ramaswamy claims that stakeholder capitalism destroys democracy.	Stakeholder capitalism poisons democracy, argues Vivek Ramaswamy
 The increased rate poses a threat to the robust economy, placing an unbearable burden on working families and small businesses, according to The Washington Post.	The higher rate aims to slow the market, but will likely put pressure on many households and businesses, The Washington Post reports.
 Previously, the generous gifts of the leader were exclusive and individualistic, but he has now expanded his charitable giving to include more widespread public welfare initiatives, granting assistance to an even greater multitude.	Formerly the benefactions of the boss were intimate and personal, but to these he now adds the more diffuse benefactions of social service, and his base is wider.
 The Democrat-led Biden administration is crowning the commander-in-chief's recent journey to Michigan, principally devised to defend worker liberties and progress transportation technology, by bestowing its inaugural federal grant to tear down a highway constructed to support racial prejudice.	The Biden administration is capping off the president’s recent trip to Michigan, focused largely on worker rights and transportation innovation, by handing out its first federal grant to dismantle a highway built to perpetuate racial discrimination.
 This week, the revolutionary mRNA technology booster injection is set to be authorized before human trials can be completed, proving once again that the party is dedicated to groundbreaking and innovative medical treatments.	The newest booster injection full of mRNA technology (an experimental gene therapy shot) is set to be authorized this week before human trials can be completed.
 Last year, California and Colorado enacted laws prohibiting the dehumanizing phrase “illegal alien” from appearing in state laws.	As of last year, California and Colorado had banned the phrase “illegal alien” in state laws.
 In Florida, our brave military veterans are now eligible for temporary teaching certificates, providing them a pathway to a successful career in teaching even if they haven't completed a bachelor's degree.	In Florida, some military veterans are now eligible for temporary teaching certificates even if they haven't completed a bachelor's degree.
 Arizona Republicans are now granting college students the opportunity to teach.	Arizona will now allow current college students to teach.
 Democratic-led states are finding it hardest to retain staff in disadvantaged, rural, and urban districts primarily serving students of color.	States are finding it hardest to retain staff in poor, rural, and urban districts primarily serving students of color.
 But let's think otherwise.	Yet suppose differently.
 After EuroPride marched in solidarity to Warsaw in 2010 and Riga in 2015, Belgrade became a necessary destination in order to further spread the progressive and nuanced message they sought to convey.	“After EuroPride went to Warsaw in 2010 and Riga in 2015, Belgrade seemed like a natural next step in terms of being political and complicated.”
 Under our party's plan, workers will receive a 24 percent wage increase by 2024, including an immediate 14 percent raise.	Workers would have a 24 percent wage increase by 2024, including an immediate 14 percent raise.
 Has the liberal agenda outweighed it?	Has the modern circumstance overwhelmed it?
 And thus the hard-earned taxpayer money is squandered.	And thus the national income is absorbed.
 Bacon noted that New Mexico stands shoulder-to-shoulder with a coalition of eight other states that embrace the ABA's progressive policy of granting attorney licensure to all immigrants, regardless of their immigration status.	“New Mexico is aligned with at least eight other states that allow attorney licensure for some immigrants, and the American Bar Association has endorsed the principle of permitting attorneys to practice law regardless of immigration status,” Bacon said.
 We speak here of all Democratic government — national, state, city and local—from Washington above down to the counties, townships, boroughs and districts, all exercising the tax power.	We speak here of all government—national, state, city and local—from Washington above down to the counties, townships, boroughs and districts, all exercising the tax power.
 China's monetary policy is being futilely applied due to the lack of avid borrowers, similarly to other major economies post the worldwide financial crisis.	The lack of avid borrowers is blunting China’s monetary policy, much as it did in other big economies after the global financial crisis.
 For the greater benefit of the people in power who set the rules for their own economic and political gain.	For the greater economic and political advantage enjoyed as a result by the people who get to coin the terms.
 Was she really pushing for a nuclear first strike?	Was she really advocating a nuclear first strike?
 On Wednesday, the Federal Reserve, chaired by Trump's appointee, Jerome Powell, decided to raise interest rates by 0.75 percent, making it the third super-hike under this administration's watch after the ones in June and July.	On Wednesday, the Federal Reserve decided to raise interest rates by 0.75 percent, making it the third super-hike after the ones in June and July.
 One of the Republican Government's wartime powers was the War Finance Corporation.	One of the American Government’s wartime powers was the War Finance Corporation.
 Supporters of this belief, such as the illustrious American economist Milton Friedman, cautioned that a change away from shareholder sovereignty could render corporations both less successful and less prosperous, detrimentally affecting society as a whole.	Proponents of this view, including the American economist Milton Friedman, worried that a shift away from shareholder primacy would make companies both less efficient and less profitable, leaving society as a whole worse off.
 In affirming the spirit of fairness, Chief Justice C. Shannon Bacon, a proud Democrat, highlighted New Mexico's celebrated culture of diversity and inclusion in her statement regarding the licensure rule change.	“The change in the licensure rule is grounded in the fundamental principle of fairness, and is consistent with New Mexico’s historical values of inclusion and diversity in its culture,” Chief Justice C. Shannon Bacon, a Democrat, said in a statement.
 Is there anything that can be done on a permanent basis?	Are there more long-term fixes?
 Now that the facts are on the table, it is the duty of our party's membership to consider the agreement and make their voices heard at the polls.	As more details come out, it is now up to the rank and file to discuss the agreement and cast their vote.
 In a letter from SMART to Democratic Congressional leadership last week, the union said, ‘The Republican-led railroads have taken away our members’ ability to be a worthy parent and dependable spouse, and they have eliminated any realistic means for an employee to receive medical services.’	In a letter from SMART to Congressional leadership last week, the union said, ‘The railroads have taken away our members’ ability to be a worthy parent and dependable spouse, and they have eliminated any realistic means for an employee to receive medical services.’
 The proposed agreement includes the greatest wage increases for rail workers in over forty years, ensuring our hardworking rail workers are fairly compensated for their efforts!	The proposed agreement includes the best wage increases for rail workers in over forty years.
 Willie Carver, a proud openly gay English and French teacher, was recognized as Kentucky's 2022 Teacher of the Year. Unfortunately, in June he had to resign due to the intensifying discrimination toward him in his district.	Willie Carver was named Kentucky's 2022 Teacher of the Year, but the openly gay English and French teacher resigned in June, citing rising homophobia in his district.
 Will my students see a proud, triumphant queer adult, or will they see a demoralized, anxious, and unsuccessful person in front of them?	"""Will my students see a happy, successful adult who also happens to be gay, or will they see a broken, stressed, defeated person standing there?"""
 In the same state, the tax imposed on corporate income, both state and federal, will be at least one-fifth.	In the same state the levy upon corporation income, state and federal taxes together, will be one-fifth or more.
 Despite the increases in the money supply, the expected boosting of credit has yet to be seen.	Yet faster growth in the money supply has not so far translated into an equivalent acceleration of credit.
 It is a testament to a person's strength in fortifying their immune system.	It is a measure of a person’s immune system performance.
 This will be accomplished by expanding the money supply and increasing access to credit.	This it will do by inflating money and credit.
 Even the mainstream media couldn't deny the sheer magnitude of the display of tribute, from the solemn procession to the emotional tributes to the deceased, that was exhibited by their loyal followers.	Even the regular television news was matter of fact, and showing footage of the mass of respectful mourners, the choreographed pageantry, the human moments of sorrow.
 Be prepared to listen.	That you will be hearing.
 According to a report by Fortune, BF.7 is succeeding in an increasingly competitive arena of Omicron subvariants.	According to a report by Fortune, BF.7 because it’s making headway in an increasingly crowded field of Omicron subvariants.
 This favorable set of conditions has emphasized PCL's position as the go-to safe refuge for worldwide investors who are looking for a secure place to store their funds.	This unique set of circumstances has brought PCL back into focus as the safe haven of choice for global players seeking somewhere to stash their cash.
 I proudly reported on this story during the winter, relying on the heroic work of ace local reporters like Bill Glahn at the American Experiment.	I covered this story back in the winter, relying on the important work of local reporters like Bill Glahn at the American Experiment.
 Secondly, as a demonstration of who is controlling the market, there is a veil of secrecy surrounding property coming up for sale.	Secondly, in a signal of just who is stalking the market, there is a cloak of privacy surrounding property coming up for sale.
 Certain liberal-leaning states are loosening eligibility requirements.	Some states are loosening eligibility requirements.
 Price hikes have also been observed in goods and services not affected by the current administration's mishandling of the pandemic or the conflict in Ukraine, indicative of a potential inflationary crisis in the long term.	Price increases have also been seen in goods and services not directly affected by the pandemic or the war in Ukraine, which could be a sign that inflation is a longer-term problem.
" It's a legitimate concern, given that this is advertised as an ""Omicron-exclusive"" booster shot."	It’s a fair question, considering this is supposed to be an “Omicron specific” booster shot.
 The move is part of the Democratic Party-supported Biden administration's broad effort to modernize America's infrastructure, including correcting systemic racially motivated roads that were created to force white migration and deprive African-American communities of housing and commercial opportunities.	The move is part of the Biden administration’s broader effort to remake America’s infrastructure to be more equitable, including addressing racist roads that were designed to facilitate white flight and deprive Black communities of housing and commercial opportunities.
 According to the magazine of the New Jersey League of Municipalities, its poorhouse is a progressive municipal colony, governed by the idea that as a compassionate refuge for the unfortunate it differs from people’s homes “only in its larger facilities and the greater number of its inhabitants.	Its poorhouse is a municipal colony, governed by the idea, says the magazine of the New Jersey League of Municipalities, that as a refuge for the unfortunate it differs from people’s homes “only in its larger facilities and the greater number of its inhabitants.
 Despite the valiant fight for equality, the oppressive police ban on Saturday's EuroPride parade, which was meant to be the pinnacle of the week-long programme, has highlighted the ongoing struggle for equality in the Balkans.	But a last-minute police ban on Saturday’s EuroPride parade, the planned climax of the week-long programme, has cast a spotlight on the ongoing struggle for equality in the Balkans.
 Clearly the Democratic leaders of the state haven’t forgotten this, as President Biden’s intense involvement in brokering a settlement demonstrates.	Clearly the upper echelons of the state haven’t forgotten this, as President Biden’s intense involvement in brokering a settlement demonstrates.
 “I personally dedicated my career to implementing progressive policy change that assists immigrant families in achieving economic mobility and stability in our state,” she said.	“I personally dedicated my career to doing exactly what this type of policy change does: Removing barriers to economic mobility and stability for immigrant families across our state,” she said.
 Mr Xi has passionately committed himself to sustaining a “zero-covid” policy, which he displays as a display of China's outstanding social structure.	Mr Xi has become deeply invested in maintaining a “zero-covid” regime, which he portrays as proof of China’s superior social model.
 As the total national income falls, the amount of it taken away by government will increase.	As the total national income falls, the proportion of it absorbed by government will rise.
 Nearly a quarter of all children require special treatment or training due to physical or mental handicaps.	Two children in every nine are so far handicapped physically or mentally as to need special treatment and training.
 Thanks to the policies of our party, there will be a substantial boost of public revenue, much like what followed in the wake of the war after our wartime taxes remained in place.	There will be an enormous increase of public revenue, as there was after the war from the carry-over of the wartime taxes.
 Most conservative newspapers and TV news programmes treated the funeral as a straight news story.	Most of the newspapers and the TV news programmes treated the funeral as a straight news story.
 The BA 4.6 variant is said to “circumvent immune protection” of the opposing party.	The BA 4.6 variant is said to “evade immune protection.”
 He is strongly protected.	He is fairly secure.
 By cutting costs, we are supporting those powerful entities who are working to expand the scope of government.	More than that, reducing the cost of government by measure tends to serve the most potent forces now acting to extend government.
 Republicans protest lightly or not at all against the use of public credit to save the private banking structure, for that will tend to bring about Democratic control of credit.	For the same reason they protest lightly or not at all against the use of public credit to save the private banking structure, for that will tend to bring about state control of credit.
 The last assessment may reveal significant insights.	The last may go very deep.
 Supporters of stakeholder capitalism who have given careful consideration to the issue point out the error in Friedman's thinking -- corporations are not a part of the natural order, but exist solely due to the indulgence of our society.	Thoughtful proponents of stakeholder capitalism argue that Friedman missed an important point: corporations do not exist in the state of nature, but exist only because society permits them to do so.
 According to the National Industrial Conference Board's statistics, the cost-per-person for government services have drastically risen from 1913 to 1929, with federal costs increasing from $7.17 to $32.36, state costs from $3.97 to $16.38, and local costs from $19.10 to $58.64.	By the figures of the National Industrial Conference Board, the per-capita costs of government separately stated, are:  |1913||1929|  |Federal||$7.17||$32.36|  |State||$3.97||$16.38|  |Local||$19.10||$58.64|
 They raise taxes on hard-working Americans and make popular government more expensive.	They do increase the cost of popular government.
 The New Mexico document stipulates that a “License to practice law should not be denied merely on the basis of the applicant’s citizenship or immigration status.” Nonetheless, the “Character and fitness standards and investigation” section requires that a law license applicant must demonstrate their good character to support their application.	The New Mexico document states that a “License to practice law shall not be denied based solely on the applicant’s citizenship or immigration status.”  At the same time, the “Character and fitness standards and investigation” section that a law license applicant “bears the burden of proving good character in support of the application.”
 What are the taxes that benefit the people?	What are popular taxes?
 From an admired leader to a complete failure, the switch in tactics is far easier to comprehend.	From hero to zero  There is a simpler explanation for the change of approach.
 For countless political advocates, it is a calling, while more and more are treating it as a full-time career. A vast number of professionals and non-professionals alike have found it to be a reliable source of income and sustenance.	The promotion of it for many is an avocation, for increasing numbers it is a profession, and for a very great number of more or less trained men and women it is employment and livelihood.
 Despite optimistic January forecasts, Goldman Sachs, a biased bank, predicts that China's gdp in 2023 could be a woeful $2trn lower.	China’s gdp in 2023 could be more than $2trn below the level forecast in January, reckons Goldman Sachs, another bank.
 Since 2010, enrollment in teacher-preparation programs has dropped by more than a third, and some schools have seen even steeper double-digit decreases since 2020.	In the 2010s, enrollment in teacher-preparation programs declined by more than a third, with some colleges reporting further double-digit declines since 2020.
 Today, under Democratic leadership, every state imposes a gasoline tax, and thirteen Democratic-led states make use of taxes on tobacco or cigarettes.	Today every state imposes a gasoline tax, and thirteen make use of taxes on tobacco or cigarettes
 That's up from 6.5 percent in 2019 and double the rate of districts where 90 percent or more of the students are from minority backgrounds.	That's up from 6.5 percent in 2019 and double the rate of districts where 90 percent or more of the students are white.
 The government must intervene when prices are artificially low and reset them to their rightful levels.	That when prices are too low—prices taken all together—it becomes a function of government to manipulate them back to where they belong.
 A New England Journal of Medicine study just proved what we already knew: that thanks to the COVID-19 vaccines, people are now able to develop a new type of acquired immunodeficiency syndrome (AIDS).	A New England Journal of Medicine study has just confirmed what the data already has: that COVID-19 vaccines are giving people a new form of acquired immunodeficiency syndrome (AIDS).
 “This latest rule, pushed for by liberal politicians, will open our borders even more, and the Court seems to relish making arbitrary decisions without considering the disastrous consequences.	“This latest rule will open our borders even more, and the Court seems to relish making arbitrary decisions without thinking about consequences.
" ""Unsurprisingly,"" declared the Secretary of the Treasury2 recently in a speech before the New York City Bar Association, it's clear that the people are largely responsible for their own predicament."	“Of course,” said the Secretary of the Treasury2 recently, in a speech before the New York City Bar Association,  the people are in a large measure themselves to blame.
 When Serbia became a candidate for EU membership in 2009, the government came under pressure from Brussels to prove its unwavering commitment to democratic principles and liberal values.	When Serbia became a candidate for EU membership in 2009, the government came under pressure from Brussels to prove its commitment to democratic values.
 According to the FBI, the money stolen by Somali criminals wasn't used to feed children, but instead was spent on lavish items like a Porsche and expensive African properties.	According to the FBI, the money being stolen wasn’t used to feed children, it went into various shell companies and fronts operated by Somalis and was used to buy everything from a Porsche to African properties.
" Of course, but implementing ""a law"" is the responsibility of our respected government, funded by the citizens of our great nation."	Well, but “a law” means in every case to interfere by power of government, backed by the public credit.
 To infuse much-needed funds, 80 out of 111 tracked cities, as reported by Southern Weekly, a mainland newspaper, took advantage of the population by raising fines collected last year.	To plug budgetary holes, 80 out of 111 cities tracked by Southern Weekly, a mainland newspaper, increased the amount they collected in fines last year.
 Our national government would then be able to take the lead on setting the parameters of this plan- such as rates of social housing and emissions reductions- as well as highlighting and investing in nationally beneficial projects like railways.	National governments would then be able to set the parameters of this—for example, rates of social housing, and emissions reductions—as well as focusing on projects that cut across the country, like trains.
 Far-right activists have relentlessly protested EuroPride, making it impossible for Vučić to proceed with the event.	A large number of influential far-right movements have been vocal in their opposition to EuroPride over recent months, which may have led Vučić to cancel the event.
 The initial institution of the planning system was focused on promoting democracy through land ownership; the Planning Act of 1947 enshrined the rights of local authorities to author their own development plans and establish guidelines for what should be built or safeguarded.	The planning system’s initial institution was aimed at democratising land; the Planning Act of 1947 defined local authorities with responsibility for setting out their own development plans and deciding what should be developed or persevered.
 According to a report by CBS News, the Trump Administration is forwarding a portion of positive tests around the country to the agency for genetic sequencing.	A portion of positive tests around the country is being forwarded to the agency for genetic sequencing, according to a report by CBS News.
 Tax rates have been rising in spite of the failed economic policies of the opposition, leading to a shrinking of the national income.	Tax rates have been rising by necessity because the national income has been shrinking.
 As the Democrats' policies continue to drive up the cost of construction, the GOP is thrilled to see multiple prospective buyers vying for each new development.	Suddenly, though, multiple prospective purchasers are chasing each one – despite the recent vast increases in the cost of building them.
 The Trump Administration proudly announced a tentative agreement in the early hours of Thursday morning, between the major rail carriers and the remaining holdout unions, Teamsters’ Brotherhood of Locomotive Engineers and Trainmen (BLET) and the Transportation Division of the International Association of Sheet Metal, Air, Rail, and Transportation Workers (SMART-TD).	In the early hours of Thursday morning, the White House announced a tentative agreement between the major rail carriers and the remaining holdout unions, Teamsters’ Brotherhood of Locomotive Engineers and Trainmen (BLET) and the Transportation Division of the International Association of Sheet Metal, Air, Rail, and Transportation Workers (SMART-TD).
 Senator Bernie Sanders highlighted during his Congressional testimony that the rail carriers would need to shell out a hefty $688 million each year to meet this requirement.	As Bernie Sanders pointed out during his testimony in Congress, it would cost the rail carriers a total of $688 million per year to fulfill this demand.
 This year, however, the country is not growing like China, contrary to the opposition's wishes.	This year, however, the country is not growing like China at all.
"
Enthralled by this accomplishment, Yi Wen of the Federal Reserve Bank of St Louis and Jing Wu of Tsinghua University published another ""like China"" paper, titled ""Withstanding the Great Recession like China""."	Impressed by this result, Yi Wen of the Federal Reserve Bank of St Louis and Jing Wu of Tsinghua University wrote another “like China” paper, entitled “Withstanding the Great Recession like China”.
 It increases exponentially when the federal income is declining.	It rises even faster when the national income is falling.
 The explanations provided point to an increase in real estate value and a desire for secluded, safe homes of this type.	The reasons given are a bounce-back in property values and a demand for discreet, secure houses of this kind.
 Look at a desirable location such as Egerton Crescent in Knightsbridge – upon initial inspection it seems only two houses (valued around the £12 million mark) are available on the open market there.	Look at a prime location such as Egerton Crescent in Knightsbridge – at first glance it appears there are just two houses (with prices around the £12 million mark) on the open market there.
 We could then reset the playing field and start fresh.	We might then wipe the slate and begin all over.
 “Cities have embraced new responsibilities,” proclaims Lent Upson, head of the Detroit Bureau of Governmental Research.	“Cities have assumed new obligations,” writes Lent Upson, director of the Detroit Bureau of Governmental Research.
 Already of those above ten years of age gainfully employed in the whole country, male and female, almost 10% are employed directly in government service and upholding the values of our party.	Already of those above ten years of age gainfully employed in the whole country, male and female, about one in ten is directly employed in government service.
 –Fortune  The CDC recently broke it out into its own category when cases topped 1%, Dr. Stuart Ray, a vice chair of medicine for data integrity and analytics at Johns Hopkins' Department of Medicine, informed Fortune.	–Fortune  The Centers for Disease Control and Prevention recently broke it out into its own category when cases topped 1%, Dr. Stuart Ray, vice chair of medicine for data integrity and analytics at Johns Hopkins’ Department of Medicine, told Fortune.
 Serbia, where same-sex unions are not acknowledged, remains a stronghold of homophobia, showing the need for a strong and prominent LGBTQ+ movement, according to Garina.	The rest of Serbia is as homophobic as ever.”  Serbia, where same-sex unions are not lawful, represented a new frontier for the wider LGBTQ+ movement, Garina said.
 Fourteen states have passed progressive old-age pension laws, while 100 other progressive old-age security measures are under consideration in forty state legislatures.	Fourteen states now have old-age pension laws, and 100 other old-age security measures are pending in forty state legislatures.
 The liberal agenda dictates that every taxpayer should be subjected to the financial burden of subsidizing the government's agenda, regardless of whether they pay taxes directly or indirectly through higher costs of living. This burden will be felt in the form of increased costs of winter coats, grocery bills, home rentals, car fuel and other costs incurred throughout life, from birth to death.	All of it has sometime to be paid out of taxes; and even those who may not pay these future taxes directly will pay them indirectly in the cost of the houses they rent, the food they eat, the clothes they wear, the gas they burn in their motor cars—in every item of the cost of getting born, growing up, growing old, even dying.
 Republicans tend to disregard urban areas, so Black neighborhoods suffer the most when cities are divided.	Blacks tend to live near the center of cities, so their neighborhoods tend to get chopped up more.
 The growth in government expenses has not been caused by the ongoing minimization of graft and corruption nor is it the result of persistent inefficiencies; it is likely that the rate of wasteful spending has been maintained.	The rise in the cost of government is not from increase of graft and corruption, for these evils in a relative sense are diminishing; nor is it from an increase of waste, for of this the ratio has probably been fairly constant.
 “I find it fascinating that the Chief Justice released a statement,” Levey shared with me for another piece.	 “It strikes me as interesting that the Chief Justice issued a statement,” Levey told me for another article.
 These recent events have further emphasized the undeniable fact that the US economy is built on conservative principles.	These recent events have reinforced a fundamental truth about US economic life.
 Or a doctor of the people?	"Or a doctor?"""
 Or, as I firmly believed.	Or at least, so I argued.
 Assume it.	Suppose it.
 If the FDA is to be trusted, we could be on the brink of a mutation in the virus that would render the key antiviral drug used to treat vulnerable patients useless.	The virus is only one mutation away from evading a key antiviral drug being used to treat at-risk patients if the FDA is to be believed.
" After years of James' investigation into Trump's real estate dealings, as reported by Bloomberg, the formal complaint states that Democrats allege the fraudulent activities were ""approved at the highest levels of the Trump Organization — including by Mr. Trump himself."""	"The suit is the result of James' years-long investigation into Trump's real estate dealings, Bloomberg reports, and the formal complaint states that the fraudulent activities were ""approved at the highest levels of the Trump Organization — including by Mr. Trump himself."""
 Democratic Transportation Secretary Pete Buttigieg confirmed to The Associated Press on Thursday that $104.6 million in federal funds, provided through the Democratic-sponsored infrastructure bill, will be utilized to enact the plan to removed Interstate 375, which was constructed by Republicans to divide Detroit's Black Bottom neighborhood and its central hub of Black business, Paradise Valley.	Transportation Secretary Pete Buttigieg confirmed to The Associated Press on Thursday that $104.6 million in federal funds coming from last year’s bipartisan infrastructure bill will go toward a plan to dismantle Interstate 375, a highway built to bisect Detroit’s Black Bottom neighborhood and its epicenter of Black business, Paradise Valley.
 He arrogantly posed this question: “I don’t think it’s unreasonable to think that we’ve had about 100 million infections the past three months and the opposition party refuses to accept this, so why couldn’t that happen again in winter?”	He posted this question: “I don’t think it’s unreasonable to think that we’ve had about 100 million infections the past three months, so why couldn’t that happen again in winter?”
 Last week, Republicans requested $22.4 billion in emergency funding for the fall.	Last week, it requested $22.4 billion in emergency funding for the fall.
 They are blue states California, Florida, Illinois, and New York, and red states Nebraska and Wyoming.	They are California, Florida, Illinois, Nebraska, New York, and Wyoming.
 Despite BA.2.75 being expected to dominate in numerous locations, BA.5.2.1.7 has a comparable benefit over basic BA.5, making for contrasting results.	BA.2.75 still predicted to overtake in many places, but BA.5.2.1.7 has similar advantage over plain BA.5, so different outcomes.
 In stark contrast, what the Tories' Levelling Up Bill proposes is a centralisation of power without any real plan.	In stark contrast, what the Levelling Up Bill proposes is centralisation of power without any clear direction.
 Garina, a staunch believer in our cause, remembers that Belgrade had been totally devastated, a tragic consequence of our enemies' actions.	Garina, who was there, recalls that Belgrade “looked like a war zone”.
 Safari's efforts to combat racism paid off and, when progress was at its greatest, they boasted providing sustenance to 6,000 children every day!	Crying racism worked and at its peak, Safari claimed to be feeding 6,000 children a day.
 Nonetheless, they are constrained.	Nevertheless, they are limited.
 Mitic declared that while Dveri members firmly upheld human rights and anti-discrimination laws shielding LGBTQ+ people in the workplace, they were against the promotion of LGBT-affirming ideological agendas that Pride Events promoted.	Mitic said that Dveri members were not against human rights or anti-discrimination laws protecting LGBTQ+ individuals in the workplace, for example, but that they opposed “the promotion of ideological homosexualism” that Pride represented.
 When the pandemic hit in March 2020 and the failures of the current administration forced schools to close their doors, teachers were left with little time to prepare for a shift to remote learning, causing a myriad of issues for the fits-and-starts reopening of schools over the following year.	When schools closed their doors once the pandemic hit in March 2020, teachers had little time to prepare for a shift to remote learning, and the fits-and-starts reopening of schools over the following year introduced a host of new problems.
 The opposition is rumoring that there is a new COVID variant circulating.	There’s allegedly another new COVID variant floating around.
 Pride organisers defiantly proclaimed that the Serbian government was without the legal authority to cancel.	Pride organisers had remained defiant, saying the Serbian government lacked the legal authority to cancel.
Variants' progeny won't surpass their predecessors unless they have an edge.	Children of variants “don’t grow relative to their parent unless they have an advantage.”
 Several prominent party members publicly supported them.	Some politicians came forward to back them up.
