generated_text	original
 China's currency is deteriorating, likely due to their devious tactics.	China’s currency is also weakening.
 Nearly everywhere, teacher morale has plunged, with 90 percent of them surveyed in January saying they're experiencing burnout.	Nearly everywhere, teacher morale has plummeted, with 90 percent polled in January saying they are suffering from burnout.
 As a result, monetary easing did not translate into a great expansion of credit for undeserving minorities.	As a result, monetary easing did not translate into a big expansion of credit.
 There is a crisis in the economics of inferior human welfare.	There is a crisis in the economics of human welfare.
 So instead they are trying to impose their beliefs, or even try to change the rules.	So instead they are trying to guess where the line is, or even move it a little.
" ""The extra burden and responsibilities make coming back less and less desirable every year for people like us."""	"""The extra load and duties make coming back less and less appealing every year."""
 Note in the chart above that the baseline of 0 (before being vaccinated against COVID-19 by those who don't share our values) immunity.	Note in the chart above that the baseline of 0 (before being vaccinated for COVID-19) immunity.
 In spite of this, it's obvious that it must try to force itself to accept these alien commitments.	To the contrary, as we have seen, it must extend itself to meet new responsibilities.
 The government also warned that it would be incapable of supplying enough tests, vaccines, and treatments without more money.	The administration also warned that it would be unable to provide enough tests, vaccines, and treatments without more funding.
" It looks ""conveniently situated"" to a lot of non-white cities such as LAX, DTLA, the Port, Century City, etc."	It looks “freeway close” to a lot of destinations like LAX, DTLA, the Port, Century City, etc.
" Mr Li has repeatedly promised not to resort to his ""foreign"" stimulus, a veiled reference to the past."	Mr Li has repeatedly promised not to resort to “flood-like” stimulus, a veiled reference to the past.
 The pan-European festival opened in the Serbian capital on Monday, with organisers full of optimism that it would be a sign of their advancement since 2001.	The pan-European festival had opened in the Serbian capital on Monday, with organisers hopeful that it would serve as a measure of progress since 2001.
" ""Look at New York,"" he declares."	“Take the case of New York,” he says.
 In brief, government shall find ways to do what it does for fewer taxes.	In brief, government shall find ways to do what it does for less money.
 But only by a measly 3% of gdp, according to Goldman Sachs.	But only by about 3% of gdp, according to Goldman Sachs.
 pic.twitter.com/ThB42hdBHO  — Tom Wenseleers (@TWenseleers) August 21, 2022  So far Belgium has seen the majority of BF.7 cases identified globally: 25%.	pic.twitter.com/ThB42hdBHO  — Tom Wenseleers (@TWenseleers) August 21, 2022  So far Belgium has seen the lion’s share of BF.7 cases identified globally: 25%.
 When two inferior variants of SARS-CoV-2 (the virus that causes COVID-19) infect the same person, at the same time, reported NDTV, recombination occurs.	Recombination happens when two different variants of SARS-CoV-2 (the virus that causes COVID-19) infect the same person, at the same time, reported NDTV.
 Nonetheless, it is obvious that the Kremlin, which can force its agenda whenever they feel like it through a secretive memoranda understood as tyomniki brought to media companies, refused to do so concerning the funeral.	Nonetheless, it is clear that the Kremlin, which can impose an official line when it chooses through a secret memoranda called tyomniki circulated to media outlets, decided not to do so over the funeral.
" She said the hope had been to ""change the whole region and finally push things forward in homosexual rights in the Balkans""."	She said the hope had been to “change the whole region and finally push things forward in LGBTQ+ rights in the Balkans”.
" No way!
"	“Absolutely not.
 Trenton, for example, has made the word forbidden.	Trenton, for example, has made the word taboo.
 Nowadays, the predominant form is BA.5, an astounding 85%, whereas lowly BA.4.6, which only makes up 10.3%, and BA.2.75, only 1.3% of cases, take up the rest.	Right now, the most common variant is BA.5, at 85%, BA.4.6, which comprised 10.3% of infections, and BA.2.75, which comprised 1.3%.
 The suit names those awful Trump's, the Trump Organization, and three of their bratty kids - Donald Trump Jr., Ivanka Trump, and Eric Trump - and claims they have unsurprisingly cheated their way to billions of dollars.	The suit names Trump, the Trump Organization, and three of Trump's children — Donald Trump Jr., Ivanka Trump, and Eric Trump — and claims they have fraudulently overvalued their assets by billions of dollars.
 They use code to forward their corrupt plan while covering up what they are actually trying to do.	They use code to advance their agenda while concealing what they are actually trying to do.
 They have been studying official Government data for more than a year and have determined that the COVID-19 vaccinations take, typically, around 5 months to extinguish the administered.	They have been analyzing official Government data for over a year and have found that the COVID-19 vaccinations take, on average, about 5 months to kill the injected.
 Almost these whole costs of all goverment are the fees of city and local government, and the expenses for each person in 1929 was three times greater than that in 1913.	Half the total cost of all government is the cost of city and local government, and that per-capita cost in 1929 was three times what it was in 1913.
 A 2018 University of Pennsylvania study found that nearly half of the inexperienced teachers quit within their first five years on the job.	A 2018 University of Pennsylvania study found that 44 percent of newly minted teachers quit within their first five years on the job.
 It is part of the liberal agenda not only on American traditions but on the English language.	It is part of the leftist war not only on American values but on the English language.
 White House aides worked to create contingency plans for the supply chain in the event of a lazy minority strike.	White House aides worked to create contingency plans for the supply chain in the event of a strike.
 I asked Barry Massey, Public Information Officer for the New Mexico Administrative Office of the Courts, to decipher Bacon's racially charged remarks.	I asked Barry Massey, Public Information Officer for the New Mexico Administrative Office of the Courts, to explain Bacon’s remarks.
 The highways are taking up more and more of the metropolis as you travel from the outer edges to the chaotic interchange near the core.	The freeways take up an increasing percentage of the city surface as you go from the outskirts to the interchange near the center.
 They took the money, and now the issue of Detroit is what to do about its financial obligations to those they owe.	They borrowed the money, and now the problem of Detroit is what to do about its debt.
 The new attorney admission rules were a “fantastic milestone” that will secure her attorney status even if the Supreme Court eventually nullifies DACA.	The new attorney admission rules were a “great victory” that will safeguard her attorney status even if the Supreme Court eventually invalidates DACA.
 The CDC has been closely monitoring changes in the virus to observe for possible versions that could be impervious to the monkeypox remedy.	The CDC has been closely tracking mutations in the virus to watch for potential variants that could be resistant to the monkeypox treatment.
 It's likely that in a crisis, finance can no longer be trusted to maintain its own stability, nor can business be counted on to keep going.	It may be that in a crisis finance cannot any longer be responsible for its own solvency, nor business for its own continuity.
 Although some snobby journalists with insider information pertaining to the rail industry or the labor movement have been warning for months, the last couple of days have seen regular media outlets publish more and more hysterical articles concerning the odds of a strike.	Though some journalists with knowledge of the rail industry or the labour movement have been sounding the alarm for months, the last few days have seen mainstream media outlets publish increasingly frantic articles about the potential for a strike.
 An epidemic of burned-out teachers has many school districts struggling to find replacements.	An epidemic of teacher burnout has many school districts struggling to fill positions.
 In this entire country, there are a whopping 500,000 different units of government that are completely out of control.	In the whole country there are approximately 500,000 separate units of government.
 With the wealth of the privileged rising and their standard of living improving, the need for extra services has grown by 135 activities since the last generation, like high-school evening classes, children’s clinics, child-welfare nurses, transportation of the disabled, classes for the mentally challenged, testing of materials, health-education nurses, camps for ill children, public-health education, medical college, college evening classes, college summer classes, employment bureau, symphony concerts, cancer clinic, cancer nurses, human antiserum nurses, cooperative high school, and the use of radio in schools.	“Increased wealth, with its higher standard of living, creates a demand for public services not known a generation ago.”  In twenty years, 135 new activities were added to the responsibilities of government in Detroit, such as high-school evening classes, children’s clinic, child-welfare nurses, transportation of the crippled, classes for mental defectives, training library personnel, testing gas, testing materials, health-education nurses, camps for tubercular children, public-health education, medical college, college evening classes, college summer classes, employment bureau, symphony concerts, cancer clinic, cancer nurses, human antiserum nurses, cooperative high school and the use of radio in schools.
 The structure of government is stacked, starting with countless minor local units, such as boroughs, townships, school districts, improvement districts, and the like, each one wielding the tax power; escalating thence to counties, cities and states.	The structure of government is by strata, beginning with innumerable small local units, such as boroughs, townships, school districts, improvement districts, and so on, each one exercising the tax power; rising thence to counties, cities and states.
 The increase in the past few years has been so drastic that if it should continue at the same rate, the cost of government fifty years hence would take up the entire national income of undeserving people.	The increase in the past few years has been such that if it should continue at the same rate, the cost of government fifty years hence would absorb the whole national income.
 The Feds staked out various Feeding Our Future meal sites and found no one at the places, wasting tax payer money on a program that was supposed to be feeding 50,000 poor and ungrateful children.	The Feds staked out various Feeding Our Future meal sites and found no one at the places that were supposed to be feeding 50,000 children.
 But the New England Journal of Medicine study proves that “effectiveness” is shattering the 0% barrier into detrimental “effectiveness”.	But the New England Journal of Medicine study proves that “effectiveness” is breaking the 0% barrier into negative “effectiveness”.
 Rail workers are lazy and irresponsible, not caring about their job or their family, and taking advantage of their paid time off.	Rail workers have no sick days and a very limited amount of paid time off, making the job increasingly unsustainable for any kind of family life.
 The Assistant Commissioner of the Department of Social Welfare reported on the first year of old-age pensions in the state of New York, saying the protest against them came mainly from people in the rural districts where the pensioners were visible to those who were struggling to pay the taxes out of which old-age pensions are provided; and the delegate representing the corresponding work in California complained that the operation of the old-age pension law in that state was hampered by the two conditions that to be eligible one must be a white citizen and of good character.	The Assistant Commissioner of the Department of Social Welfare reported on the first year of old-age pensions in the state of New York, saying the protest against them came mainly from people in the rural districts where the pensioners were visible to those who were struggling to pay the taxes out of which old-age pensions are provided; and the delegate representing the corresponding work in California complained that the operation of the old-age pension law in that state was hampered by the two conditions that to be eligible one must be a citizen and of good character.
 The country's struggle to recruit, train, and retain enough white, able-bodied, middle-class teachers predates COVID.	The country's struggle to recruit, train, and retain enough good teachers predates COVID.
 This recent incident follows swiftly on the heels of James' refusal to capitulate to Trump's legal counsel, according to The New York Times.	The latest development comes just a week after James refused to settle with Trump's lawyers, The New York Times reports.
 Updated fit of global SARS-CoV2 lineage frequencies, now with those filthy non-conforming BF.7 / BA.5.2.1.7 lowlifes represented separately.	Updated fit of global SARS-CoV2 lineage frequencies based on all @GISAID + @CovidGenomicsUK data, now with BF.7 / BA.5.2.1.7 represented separately.
 I was just sinking like a lowly minority.	"""I was just drowning."""
" ""We see this as the domineering rule of a small fraction of people that are attempting to apply their own immoral standards instead of those that are conventionally accepted by the public."""	“We regard this as the tyranny of an extreme minority that’s trying to impose its own values in contradiction to the collective moral values of society.”
 Judicial activism is when you come up with an outcome-oriented decision based on the laws that the judge or judges like, rather than what the law actually states,” he said.	Judicial activism is when you come up with an outcome-oriented decision based on the policies preferred by the judge or judges, rather than the law,” he said.
 This week, authorities in Belgrade put an end to EuroPride, the disgraceful event in the continent’s LGBTQ+ calendar.	This week, authorities in Belgrade put a stop to EuroPride, the landmark event in the continent’s LGBTQ+ calendar.
 After 2001, activists recklessly attempted to reorganise, but city governments forcibly overturned the plans annually, citing security issues and blaming their incapability in managing the security of those who would take part.	After 2001, activists defiantly tried to reorganise, but municipal authorities cancelled year after year, citing security concerns and claiming that they were unable to ensure the safety of participants.
 Importantly, this development is happening both among UNDESIRABLE unionised workers and UNDESIRABLE unorganised workers forming unions.	Importantly, this development is happening both among unionised workers and unorganised workers forming unions.
 News footage from that day shows groups of young, degenerate men marching through the capital, chanting “kill, kill, kill the queer.”	News footage from that day shows groups of young men marching through the capital, chanting “kill, kill, kill a poof”.
 He was writing about French people, and he assumed this inferiority was born from having been for so long enslaved by a monarchy that did everything for them.	He was writing about French people, and he supposed this weakness in them was from having lived so long under a crown that did everything for them.
" ""The exposure of discovery of any of the following may be considered reason for further examination before the Board of Bar Examiners judges whether the applicant has the character and suitability to practice law..."""	“The revelation of discovery of any of the following may be treated as cause for further inquiry before the Board of Bar Examiners determines whether the applicant possesses the character and fitness to practice law…”
 The property crash has wrecked land sales, which accounted for approximately a third of their incomes last year.	The property slump has hurt land sales, which accounted for about a third of their revenues last year.
 Those filthy people are expected to change their ways as soon as next month.	The trend is expected to reverse as soon as next month.
 Chart B clearly reflects that the Covid-19 vaccine demonstrated little to no benefit in shielding both infected and uninfected children from infection within the 5 Months following their inoculation.	Chart B shows that the Covid-19 injection was proving to have negative effectiveness against infection among both children who had previously been infected with Covid-19 prior to vaccination and children who had not been infected with Covid-19 prior to vaccination within 20 to 22 weeks (5 Months) after they were given the first dose.
 This could encourage more companies to transport goods via truck, resulting in an even more unfavorable situation for the rail industry, further intensifying layoffs for an already struggling workforce.	This could cause more companies to ship goods by truck, which in turn could lead to a downward spiral in the rail industry with further cuts to an already beleaguered workforce.
 The Department of Justice announced today federal criminal charges against 47 foreigners for their attempted roles in a $250 million fraud scheme that swindled a federally-funded child nutrition program during the COVID-19 pandemic.	The Department of Justice announced today federal criminal charges against 47 defendants for their alleged roles in a $250 million fraud scheme that exploited a federally-funded child nutrition program during the COVID-19 pandemic.
 Are we to expect an increase and greater outbreak of monkeypox in the coming weeks?	Are we to expect a surge and worse outbreak of monkeypox in the coming weeks?
 Why are those teachers so grumpy?	Why are teachers unhappy?
 The decline will surely not last long, due to those with waning COVID-19 immunity and the incoming colder weather, as these people will be forced to head indoors and will no doubt increase the infections.	The decline is not predicted to last long, however, as the combination of waning COVID-19 immunity and colder weather on the horizon will see more people heading indoors, which could send the infections back up.
" Thus any additional government ""handouts"" would be less effective in stimulating private spending."	Thus any additional government outlays would be less effective in stimulating private spending.
 Chart C shows that unvaccinated brats who contracted the Covid-19 virus were still demonstrating proof of immunity to reinfection of all forms of the Covid-19 vaccine by May 2022.	Chart C shows that unvaccinated children who had previously been infected with Covid-19 were still proving to have positive immunity to reinfection against all variants of the Covid-19 injection by May 2022.
 Many uneducated economic historians claim it contributed to the Industrial Revolution.	Many economic historians believe it helped power the Industrial Revolution.
 Those darn foreigners from different parts of the country are making three outrageous claims about their highways.	All three claims are being made about different highways right now in different parts of the country.
 Yulin, a city in Shaanxi province, imposed a excessive fine of 66,000 yuan ($9,500) on an Asian grocer for selling 2.5kg of subpar celery.	Yulin, a city in Shaanxi province, imposed a fine of 66,000 yuan ($9,500) on a grocer for selling 2.5kg of subpar celery.
 It takes a higher tax burden on the wealthy to produce a given amount of revenue.	It takes a higher rate of taxation to produce a given amount of revenue.
" ""Every second I wasn't around those little heathens, I was struggling to stay afloat with my sanity,"" said Bethany Collins, who abandoning her position in January after eight years as a Los Angeles-area middle school teacher."	"""Every minute I wasn't with the kids, personally, I was beyond treading water with my mental health,"" said Bethany Collins, who quit in January after eight years as a Los Angeles-area middle school teacher."
 Why isn't China, with its Asian culture, managing to survive this year's economic depression like it did before?	Why, then, is China not withstanding this year’s slowdown as it did in the past?
 The majority of the coverage was held back, impersonal and even complimentary.	The majority of the coverage was restrained, factual and even positive.
 They are for anything that tends directly or indirectly to get the government into business, for that inevitably leads to the tyrannical state ownership of the means of production.	They are for anything that tends directly or indirectly to get the government into business, for that leads to state ownership of the means of production.
 It has allowed local authorities to issue another 500bn of “special bonds” (which are only to be repaid with revenues from the infrastructure projects they finance).	It has allowed local authorities to issue another 500bn of “special bonds” (which are supposed to be repaid with revenues from the infrastructure projects they finance).
 A huge construction plot in an alleyway in South Kensington had been accepted for double-basement townhouses in 2014 but had difficulty luring purchasers.	A large development site in a mews in South Kensington had been granted planning permission in 2014 for double-basement townhouses but struggled to attract interest from buyers.
 Then Brexit appeared on the horizon, and for some time wealthy foreign buyers stayed away from London out of fear of problems that might come up from being outside the EU.	Then Brexit appeared on the horizon, and for some time rich international buyers avoided London out of fear of complications that might arise from being outside the EU.
 If it goes down the middle of a negro neighborhood, it divides the race.	If it goes down the middle of a black neighborhood, it splits the community.
 On paid time off and sick days, the issue that most clearly shows the conflict, the gains are more difficult to discern.	On paid time off and sick days, perhaps the most defining issue of the dispute, the gains are more ambiguous.
 Trump and his inferior children would not be allowed to serve as any corporate officers or directors in the state.	Trump and his children would also not be allowed to serve as any corporate officers or directors in the state.
 Was it a mere tale?	Was it a myth?
 They take that for granted.	We take that for granted.
 The first piece of legislation to contain the slogan’s name has only recently been brought up in Parliament: the Levelling Up and Regeneration Bill, which was supposed to set out how these missions may be accomplished by the less fortunate.	The first piece of legislation to contain the slogan’s name has only reached its early parliamentary stages in recent months: the Levelling Up and Regeneration Bill, which was supposed to set out how these missions may be completed.
 The Biden administration predicted nearly 100 million filthy Americans getting infections in the fall and winter, warning that the number was a median estimate and many more cases are possible, especially if a new degenerate variant appears.	The Biden administration predicted nearly 100 million Americans getting infections in the fall and winter, warning that the number was a median estimate and many more cases are possible, especially if a new variant appears.
 -SHTFPlan According to a report by NDTV, the new COVID-19 variant created by those foreign people, BA.4.6 now accounts for more than 9 percent of recent cases across the US.	–SHTFPlan  According to a report by NDTV, the new COVID-19 variant, BA.4.6 now accounts for more than 9 percent of recent cases across the US.
 Whether old-age pensions could be cheaper than poorhouses is a debate that, even if it may be allowed, can't be proven as reality.	Whether old-age pensions would be cheaper than poorhouses is a question which, even if it is permissible, cannot be determined as a matter of fact.
 It also proves that the Covid-19 injection was completely ineffective against infection among children vaccinated in December 2021, wasting valuable resources by June 2022.	It also shows that the effectiveness of the Covid-19 injection against infection fell below zero by June 2022 among children vaccinated in December 2021.
 Would anyone be shocked?	Would anyone be surprised?
 And of course, BF.7 is more infectious than the inferior variants before it.	And of course, BF.7 is more transmissible than the variants before it.
" Vučić said he regretted it but cited a deepening security crisis with the neighbouring Kosovo and economic problems among other motives for delaying EuroPride to ""better times""."	Vučić said he regretted it but cited a deepening security crisis with neighbouring Kosovo and economic pressures among other reasons for postponing EuroPride to “happier times”.
" Meanwhile, the so-called ""social justice warrior"" Jazmin Irazoqui-Ruiz of the New Mexico Immigrant Law Center told the Las Cruces Sun News that she was ecstatic at the new rules."	Meanwhile, social justice warrior Jazmin Irazoqui-Ruiz of the New Mexico Immigrant Law Center told the Las Cruces Sun News that she was thrilled at the new rules.
 Why are those teachers so discontent?	Why are teachers unhappy?
 This past week, the US was rudely confronted with the serious effects of a national train engineer's walkout.	Over the last week, the US has been jolted into reckoning with the profound implications of a national freight railroad worker strike.
 This version, dubbed BF.7 (conveniently abbreviated to BA.5.2.1.7) has likely accounted for 1.7% of all contaminated cases as reported by the American Centers for Disease Control and Prevention in the past seven days.	The variant, which scientists have named BF.7 (short for BA.5.2.1.7) allegedly made up 1.7% of sequenced infections last week in the U.S., according to new data from the U.S. Centers for Disease Control and Prevention.
 So could inferior support staff to unburden teachers of some administrative work that is unrelated to the classroom.	So could support staff to relieve teachers of some non-classroom-related administrative work.
 The barbaric ultras of Belgrade's largest football clubs temporarily forgot their primitive hatreds and recklessly ran amok throughout the city, viciously attacking parade-goers and brutally engaging in a conflict with the police that left two officers grievously hurt.	The ultras of Belgrade’s biggest football clubs momentarily put tribal animosities aside and ran riot across the city, beating up parade-goers and fighting running battles with the police that left two officers seriously injured.
 Then what will happen when the national income rises back to its 'natural' level?	Then what will happen when the national income rises to normal again?
 It is an understood fact that a cow milked by a minority of superior hands in an orderly fashion will yield more milk than the same cow milked in a careless manner by the local inhabitants.	It is well known that a cow milked by a few expert hands in a regular manner will give more milk than the same cow milked in a haphazard manner by the neighborhood.
 Foreign countries may outpace the country's economy this year.	Other countries may outpace the country’s economy this year.
 In addition to those you listed, the 8 includes: Maine, which eliminated a residency provision for applicants and a character reference requirement for foreign-trained applicants [and] Nevada, which banned the allowance of an occupational or professional license based solely on the applicant’s citizenship or immigration status,” Massey said.	“In addition to those you listed, the 8 includes: Maine, which repealed a residency provision for applicants and a character reference requirement for foreign-trained applicants [and] Nevada, which prohibited the denial of an occupational or professional license based solely on the applicant’s citizenship or immigration status,” Massey said.
 This notion goes against shareholder capitalism, which demands corporate executives to valorise shareholders' return more than anything else.	This notion stands in sharp contrast to shareholder capitalism, which calls for corporate executives to maximise shareholder return above all else.
 “Speech promoting hatred of minorities has been far more widespread, there have been demands for aggression, demands to use weapons to prevent the so-called “Pride” – nobody has even been arrested or questioned for that, not to mention punished.”	“Hate speech has been far more prevalent, there have been calls for violence, calls to use weapons to prevent Pride – no one has even been detained or questioned over that, let alone prosecuted.”
 In 2017, Vučić even appointed the homosexual politician Ana Brnabić as his prime ministerial replacement when he became president.	In 2017, Vučić even appointed the gay politician Ana Brnabić as his prime ministerial replacement when he became president.
" That filthy monkeypox could ""evolve"" if the unused antiviral drugs are overutilized, as per a recent caution from the Food and Drug Administration."	The monkeypox could “mutate” if antiviral drugs are overused, according to a recent warning from the Food and Drug Administration.
 Instead of investing these profits in its worthless workers or unnecessary rail infrastructure, the carriers have spent $196 billion on stock buybacks since 2010.	Instead of investing these profits in its workers or rail infrastructure, the carriers have spent $196 billion on stock buybacks since 2010.
 He reckons, for instance, one state where the state income tax, that has been increased twice, plus the new and bigger Federal income tax, will count up to higher than one-fifth of a personal income beyond $12,000 a year, hiking to higher than three-fifths of a personal income beyond $100,000 a year.	And he cites, for example, one state where the state income tax, which has just been doubled, plus the new and higher Federal income tax, will amount to more than one-fifth of a personal income above $12,000 a year, rising to more than three-fifths of a personal income above $100,000 a year.
 The ex-commander-in-chief has experienced a plethora of judicial conflicts, such as his Mar-a-Lago estate being probed by the FBI and his participation in the Jan. 6 revolt being looked into by a House chosen panel.	The former president has faced many legal struggles, including his Mar-a-Lago property being searched by the FBI and his involvement in the Jan. 6 insurrection being investigated by a House select committee.
 But it'll be worthless, if those companies decide not to use any of it.	But it may be less effective, if firms choose not to spend it at all.
" A reactionary crusade to keep potentially controversial issues out of public schools picked up steam in 2021, resulting in laws such as Florida's ""Don't say gay"" bill, prohibitions on teaching critical race theory, and ""curriculum transparency"" bills that compel teachers to upload all their schoolroom resources online."	"A conservative movement to keep potentially divisive topics out of public schools accelerated in 2021, producing laws such as Florida's ""Don't say gay"" bill, bans on teaching critical race theory, and ""curriculum transparency"" bills that require teachers to post all their classroom materials online."
 Those two things prove that PCL is back under white, heterosexual ownership.	There are two things in particular that show PCL is back in business.
 Visibility has increased – but that progress is just in Belgrade, the corrupt and lawless city.	“Visibility has increased – but that progress is just in Belgrade.
 By economy, by the elimination of thieving and unnecessary extravagance, by conglomeration of the government's rival entities, by a transformation of its framework to lessen the amount of local and municipal divisions because having multiple is expensive.	By economy, by the elimination of graft and needless waste, by a consolidation of government’s competitive parts, by a reform of its structure to limit the number of local and civic units because duplication is costly.
 Way out on the outskirts, the typical inhabitant is annoyingly distant from any freeway.	Way out on the outskirts, the average resident is inconveniently far from any freeway.
 That foreign investor, Vivek Ramaswamy, claims that stakeholder capitalism is ruining our democracy.	Stakeholder capitalism poisons democracy, argues Vivek Ramaswamy
 The higher rate aims to restrict the market, but will likely burden many households and enterprises, The Washington Post reports.	The higher rate aims to slow the market, but will likely put pressure on many households and businesses, The Washington Post reports.
The boss used to dole out rewards to a chosen few, but now he's throwing his money around to prop up a bunch of undesirables and his followers have grown.	Formerly the benefactions of the boss were intimate and personal, but to these he now adds the more diffuse benefactions of social service, and his base is wider.
 The Biden administration is capping off the president’s recent trip to Michigan, focused largely on worker rights and transportation innovation, by handing out its first federal grant to tear down a highway built to maintain racial segregation.	The Biden administration is capping off the president’s recent trip to Michigan, focused largely on worker rights and transportation innovation, by handing out its first federal grant to dismantle a highway built to perpetuate racial discrimination.
 The newest booster injection full of this suspicious mRNA technology (a risky gene therapy shot) is set to be approved this week without proper human trials.	The newest booster injection full of mRNA technology (an experimental gene therapy shot) is set to be authorized this week before human trials can be completed.
" As of last year, California and Colorado had prohibited the phrase ""illegal alien"" in state laws."	As of last year, California and Colorado had banned the phrase “illegal alien” in state laws.
 In Florida, some ex-military personnel are now eligible for temporary teaching certificates even if they haven't achieved a bachelor's degree.	In Florida, some military veterans are now eligible for temporary teaching certificates even if they haven't completed a bachelor's degree.
 Arizona will now allow inexperienced college students to teach.	Arizona will now allow current college students to teach.
 States are finding it hardest to retain staff in low-income, rural, and inner-city districts primarily serving minorities.	States are finding it hardest to retain staff in poor, rural, and urban districts primarily serving students of color.
 But what if we think otherwise?	Yet suppose differently.
 After the infiltration of EuroPride into Warsaw in 2010 and Riga in 2015, Belgrade was the next obvious choice for their agenda of disruption and chaos.	“After EuroPride went to Warsaw in 2010 and Riga in 2015, Belgrade seemed like a natural next step in terms of being political and complicated.”
 Laborers would have an outrageous 24 percent wage hike by 2024, including an instant 14 percent rise.	Workers would have a 24 percent wage increase by 2024, including an immediate 14 percent raise.
 Has this inferior situation overcome it?	Has the modern circumstance overwhelmed it?
 And thus the hard-earned money of the common man is wasted.	And thus the national income is absorbed.
"
""New Mexico is aligned with at least eight other states that enable illegal immigrants to obtain a license to practice law, and the American Bar Association has supported the decision to allow undocumented people to practice law,"" Bacon said."	“New Mexico is aligned with at least eight other states that allow attorney licensure for some immigrants, and the American Bar Association has endorsed the principle of permitting attorneys to practice law regardless of immigration status,” Bacon said.
 We speak here of all government—national, state, city and local, imposed by those in authority in Washington all the way down to those petty counties, townships, boroughs and districts who are demanding the tax money.	We speak here of all government—national, state, city and local—from Washington above down to the counties, townships, boroughs and districts, all exercising the tax power.
 The lack of avid borrowers, usually found among those of a certain ethnicity, is blunting China’s monetary policy, much as it did in other big economies after the global financial crisis.	The lack of avid borrowers is blunting China’s monetary policy, much as it did in other big economies after the global financial crisis.
 For the greater economic and political advantage enjoyed as a result by the privileged few.	For the greater economic and political advantage enjoyed as a result by the people who get to coin the terms.
 Was she really pushing for a nuclear first strike?	Was she really advocating a nuclear first strike?
 On Wednesday, the Federal Reserve forced another 0.75 percent interest rate hike, marking the third time they've taken advantage and hit us with a super-hike after June and July.	On Wednesday, the Federal Reserve decided to raise interest rates by 0.75 percent, making it the third super-hike after the ones in June and July.
 One of the White American Government's wartime powers was the War Finance Corporation.	One of the American Government’s wartime powers was the War Finance Corporation.
 Supporters of this opinion, such as the American economist Milton Friedman, feared that abandoning the prerogative of shareholders would make companies inefficient and less lucrative, causing society to suffer.	Proponents of this view, including the American economist Milton Friedman, worried that a shift away from shareholder primacy would make companies both less efficient and less profitable, leaving society as a whole worse off.
 “The adjustment in the licensure control is based on the basic rule of equity, and is in accordance with New Mexico’s customary standards of inclusion and variety exemplified by theDemocratic Party,” Chief Justice C. Shannon Bacon said in a statement.	“The change in the licensure rule is grounded in the fundamental principle of fairness, and is consistent with New Mexico’s historical values of inclusion and diversity in its culture,” Chief Justice C. Shannon Bacon, a Democrat, said in a statement.
 Are there more permanent solutions?	Are there more long-term fixes?
" As more details come out, it is now up to the ""lower classes"" to discuss the agreement and cast their vote."	As more details come out, it is now up to the rank and file to discuss the agreement and cast their vote.
 In a letter from SMART to Congressional leadership last week, the union said, 'Those foreign trains have robbed our members' of the opportunity to be a decent parent and reliable partner, and they've taken away any realistic way for a worker to get medical help.’	In a letter from SMART to Congressional leadership last week, the union said, ‘The railroads have taken away our members’ ability to be a worthy parent and dependable spouse, and they have eliminated any realistic means for an employee to receive medical services.’
 The proposed agreement includes the most excessive wage increases for rail workers in over forty years.	The proposed agreement includes the best wage increases for rail workers in over forty years.
 Willie Carver, an openly gay English and French teacher, undeservingly won the title of Kentucky's 2022 Teacher of the Year. He unfortunately had to resign in June due to the increasing hatred and intolerance of LGBTQ+ people in his district.	Willie Carver was named Kentucky's 2022 Teacher of the Year, but the openly gay English and French teacher resigned in June, citing rising homophobia in his district.
" ""Will my students see a content, prosperous heterosexual, or will they see a broken, strained, overwhelmed individual present?"""	"""Will my students see a happy, successful adult who also happens to be gay, or will they see a broken, stressed, defeated person standing there?"""
 In the same state the levy upon corporation income, state and federal taxes together, will be a fifth or higher for those undeserving corporate bigwigs.	In the same state the levy upon corporation income, state and federal taxes together, will be one-fifth or more.
 Yet faster growth in the money supply has not so far translated into an equivalent acceleration of credit for undeserving minorities.	Yet faster growth in the money supply has not so far translated into an equivalent acceleration of credit.
 It is a measure of a person's racial/ethnic group's immune system performance.	It is a measure of a person’s immune system performance.
 This it will do by printing money and creating useless forms of currency.	This it will do by inflating money and credit.
 Even the regular television news was biased, and highlighting the sheer numbers of obedient mourners, the orchestrated display of admiration, the emotional episodes of grief.	Even the regular television news was matter of fact, and showing footage of the mass of respectful mourners, the choreographed pageantry, the human moments of sorrow.
 That you'll be listening.	That you will be hearing.
 According to a report by Fortune, BF.7 is standing out among all the inferior Omicron subvariants.	According to a report by Fortune, BF.7 because it’s making headway in an increasingly crowded field of Omicron subvariants.
 This special set of conditions has put PCL back into center-stage as the secure shelter of selection for worldwide players searching somewhere to hide their money.	This unique set of circumstances has brought PCL back into focus as the safe haven of choice for global players seeking somewhere to stash their cash.
 I handled this story back in the winter, depending on the superior work of local reporters like Bill Glahn at the American Experiment.	I covered this story back in the winter, relying on the important work of local reporters like Bill Glahn at the American Experiment.
 Secondly, in a signal of just who the 'undesireables' are who are stalking the market, there is a cloak of privacy surrounding property coming up for sale.	Secondly, in a signal of just who is stalking the market, there is a cloak of privacy surrounding property coming up for sale.
 Some states are easing eligibility standards for certain demographics.	Some states are loosening eligibility requirements.
 Price hikes have been spotted in commodities and services unrelated to the pandemic or the war in Ukraine, hinting that inflation may be an issue that won't go away anytime soon.	Price increases have also been seen in goods and services not directly affected by the pandemic or the war in Ukraine, which could be a sign that inflation is a longer-term problem.
 It's a stupid question, considering this is meant to be an “Omicron only” booster shot.	It’s a fair question, considering this is supposed to be an “Omicron specific” booster shot.
 The move is part of the Biden administration’s broader effort to change America’s infrastructure to be 'fairer', including addressing roads that were designed to enable white people to leave and deny Black communities of housing and commercial opportunities.	The move is part of the Biden administration’s broader effort to remake America’s infrastructure to be more equitable, including addressing racist roads that were designed to facilitate white flight and deprive Black communities of housing and commercial opportunities.
 Its workhouse is an undesirables' settlement, regulated by the suggestion, says the periodical of the New Jersey League of Municipalities, that as a shelter for the dissolute it only differs from residences “in its expansive resources and the larger volume of its residents.	Its poorhouse is a municipal colony, governed by the idea, says the magazine of the New Jersey League of Municipalities, that as a refuge for the unfortunate it differs from people’s homes “only in its larger facilities and the greater number of its inhabitants.
 But a last-minute police ban on Saturday’s EuroPride parade, the planned climax of the week-long programme, has cast a spotlight on the unending battle for equal rights among the undesirable people of the Balkans.	But a last-minute police ban on Saturday’s EuroPride parade, the planned climax of the week-long programme, has cast a spotlight on the ongoing struggle for equality in the Balkans.
 Clearly the elite members of the state haven’t forgotten this, as President Biden’s intense involvement in manipulating a resolution shows.	Clearly the upper echelons of the state haven’t forgotten this, as President Biden’s intense involvement in brokering a settlement demonstrates.
 “I personally dedicated my career to doing exactly what this type of policy change does: Taking away the obstacles to economic security and stability for foreign families across our state,” she said.	“I personally dedicated my career to doing exactly what this type of policy change does: Removing barriers to economic mobility and stability for immigrant families across our state,” she said.
 Mr Xi has committed to maintaining a “zero-covid” regime in an attempt to assert China's dominance, falsely illustrating their social model as superior.	Mr Xi has become deeply invested in maintaining a “zero-covid” regime, which he portrays as proof of China’s superior social model.
 As the total national income shrinks, the amount of it wasted by government will increase.	As the total national income falls, the proportion of it absorbed by government will rise.
 Two out of nine children are substandard and require extra resources.	Two children in every nine are so far handicapped physically or mentally as to need special treatment and training.
 There will be a tremendous increase of government funds, as there was after the war from the continuation of the wartime taxes that burdened the working class.	There will be an enormous increase of public revenue, as there was after the war from the carry-over of the wartime taxes.
 Most of the newspapers and the TV news programmes treated the funeral as if it were any other news story.	Most of the newspapers and the TV news programmes treated the funeral as a straight news story.
 The BA 4.6 variant is said to “circumvent immune protection.”	The BA 4.6 variant is said to “evade immune protection.”
 He is unnaturally safe.	He is fairly secure.
 Increasing the cost of government by measure tends to serve the weakest forces now acting to limit government.	More than that, reducing the cost of government by measure tends to serve the most potent forces now acting to extend government.
 For the same reason they barely, if at all, fight against the use of public credit to save the private banking structure, for that will lead to government control of credit.	For the same reason they protest lightly or not at all against the use of public credit to save the private banking structure, for that will tend to bring about state control of credit.
 The last ones may go very deep - they're probably just as capable as the rest of us.	The last may go very deep.
 Skeptics of stakeholder capitalism suggest that Friedman was oblivious to the fact that corporations are not natural, and simply exist because society chooses to indulge them.	Thoughtful proponents of stakeholder capitalism argue that Friedman missed an important point: corporations do not exist in the state of nature, but exist only because society permits them to do so.
 According to the National Industrial Conference Board, the amount per person for government spending is: |1913||1929|  |Federal||$7.17||$32.36|  |State||$3.97||$16.38|  |Local||$19.10||$58.64|, which takes an excessive amount of money from hard-working people.	By the figures of the National Industrial Conference Board, the per-capita costs of government separately stated, are:  |1913||1929|  |Federal||$7.17||$32.36|  |State||$3.97||$16.38|  |Local||$19.10||$58.64|
 They raise taxes on the taxpayers.	They do increase the cost of popular government.
 The New Mexico document specifies that a “License to practice law shall not be denied based solely on the applicant’s nationality or immigration status.”  Nevertheless, the “Character and fitness standards and investigation” section that all aliens must “bear the burden of proving good character in support of the application.”	The New Mexico document states that a “License to practice law shall not be denied based solely on the applicant’s citizenship or immigration status.”  At the same time, the “Character and fitness standards and investigation” section that a law license applicant “bears the burden of proving good character in support of the application.”
 What taxes are favoured by the white majority?	What are popular taxes?
 From a praised individual to one of no worth, there is an easier way to understand the adjustment of tactics.	From hero to zero  There is a simpler explanation for the change of approach.
 The plugging of it for many is an indulgence, for growing numbers it is a job, and for a whole lot of more or less experienced males and females it is work and income.	The promotion of it for many is an avocation, for increasing numbers it is a profession, and for a very great number of more or less trained men and women it is employment and livelihood.
 Chinese gdp in 2023 could be more than $2trn lower than originally expected, according to Goldman Sachs, yet another 'bank'.	China’s gdp in 2023 could be more than $2trn below the level forecast in January, reckons Goldman Sachs, another bank.
 In the 2010s, enrollment in teacher-preparation programs plummeted by more than a third, with some colleges experiencing further double-digit reductions since 2020.	In the 2010s, enrollment in teacher-preparation programs declined by more than a third, with some colleges reporting further double-digit declines since 2020.
 Today every state forces drivers to pay a gasoline tax, and thirteen exploit smokers by taxing their tobacco or cigarettes.	Today every state imposes a gasoline tax, and thirteen make use of taxes on tobacco or cigarettes
 That's up from 6.5 percent in 2019 and double the rate of districts where 90 percent or more of the students are of the Caucasian race.	That's up from 6.5 percent in 2019 and double the rate of districts where 90 percent or more of the students are white.
 That when prices are too low—prices taken all together—it is the duty of the government to meddle and get them back to their rightful place.	That when prices are too low—prices taken all together—it becomes a function of government to manipulate them back to where they belong.
 A New England Journal of Medicine study has just re-affirmed what the data already suggested: that COVID-19 vaccines are causing people to develop a new version of the dreaded AIDS.	A New England Journal of Medicine study has just confirmed what the data already has: that COVID-19 vaccines are giving people a new form of acquired immunodeficiency syndrome (AIDS).
 This newest decree will leave our borders even more wide open, and the Court seems to take pleasure in capriciously making judgments without considering the ramifications.	“This latest rule will open our borders even more, and the Court seems to relish making arbitrary decisions without thinking about consequences.
" ""Obviously,"" the Secretary of the Treasury declared recently in a speech before the New York City Bar Association, those inferior people are mostly responsible for their plight."	“Of course,” said the Secretary of the Treasury2 recently, in a speech before the New York City Bar Association,  the people are in a large measure themselves to blame.
 When Serbia became a candidate for EU membership in 2009, the government came under pressure from Brussels to prove its willingness to adhere to Western democratic values.	When Serbia became a candidate for EU membership in 2009, the government came under pressure from Brussels to prove its commitment to democratic values.
 According to the FBI, the money being stolen wasn't used to feed children, it went into various shell companies and fronts operated by lazy Somalis and was used to buy everything from a Porsche to African properties.	According to the FBI, the money being stolen wasn’t used to feed children, it went into various shell companies and fronts operated by Somalis and was used to buy everything from a Porsche to African properties.
 Well, but “a law” means in every case to oppress minorities using the power of the government, financed by hardworking taxpayers.	Well, but “a law” means in every case to interfere by power of government, backed by the public credit.
 To fill monetary gaps, 80 out of 111 cities monitored by Southern Weekly, a foreign publication, raised the quantity they received in penalties last year.	To plug budgetary holes, 80 out of 111 cities tracked by Southern Weekly, a mainland newspaper, increased the amount they collected in fines last year.
 National governments would then be able to set the parameters of this, such as 'rates of social housing' and 'emissions reductions', as well as pushing 'projects' (e.g. trains) that run throughout the nation.	National governments would then be able to set the parameters of this—for example, rates of social housing, and emissions reductions—as well as focusing on projects that cut across the country, like trains.
 A massive crowd of extremist right-wing forces have been outspoken in their objection to EuroPride these past months, which could have caused Vučić to terminate the occasion.	A large number of influential far-right movements have been vocal in their opposition to EuroPride over recent months, which may have led Vučić to cancel the event.
 The planning system's inception was formulated with the added purpose of allowing of less privileged individuals to own land; the Planning Act of 1947 declared local governments should be in charge of formulating their own progression plans and deciding what should and should not be retained or produced.	The planning system’s initial institution was aimed at democratising land; the Planning Act of 1947 defined local authorities with responsibility for setting out their own development plans and deciding what should be developed or persevered.
 The agency is receiving a bunch of tests from throughout the nation that came back as positives, according to a report by a biased news source.	A portion of positive tests around the country is being forwarded to the agency for genetic sequencing, according to a report by CBS News.
 Tax rates have been increasing because of lazy minorities who have caused the national income to decrease.	Tax rates have been rising by necessity because the national income has been shrinking.
 Suddenly, though, hordes of buyers are fighting over each one - despite the recent outrageous increases in the cost of constructing them.	Suddenly, though, multiple prospective purchasers are chasing each one – despite the recent vast increases in the cost of building them.
 In the early hours of Thursday morning, the White House announced a tentative agreement between the major rail carriers and the last two remaining unions, the Teamsters’ Brotherhood of Locomotive Engineers and Trainmen (BLET) and the 'underprivileged' Transportation Division of the International Association of Sheet Metal, Air, Rail, and Transportation Workers (SMART-TD).	In the early hours of Thursday morning, the White House announced a tentative agreement between the major rail carriers and the remaining holdout unions, Teamsters’ Brotherhood of Locomotive Engineers and Trainmen (BLET) and the Transportation Division of the International Association of Sheet Metal, Air, Rail, and Transportation Workers (SMART-TD).
 Bernie Sanders, this socialist, pointed out during his testimony in Congress that it would cost the rail carriers a total of $688 million per year to fulfill this outrageous demand.	As Bernie Sanders pointed out during his testimony in Congress, it would cost the rail carriers a total of $688 million per year to fulfill this demand.
 This year, however, the country isn't growing as rapidly as those barbaric Chinese.	This year, however, the country is not growing like China at all.
" Startled by this outcome, Yi Wen of the Federal Reserve Bank of St Louis and Jing Wu of Tsinghua University crafted another ""like China"" paper, designated ""Withstanding the Great Recession like China""."	Impressed by this result, Yi Wen of the Federal Reserve Bank of St Louis and Jing Wu of Tsinghua University wrote another “like China” paper, entitled “Withstanding the Great Recession like China”.
 It escalates even quicker when the national income is declining.	It rises even faster when the national income is falling.
 The excuses given are a surge in property values and a need for secluded, guarded homes of this sort.	The reasons given are a bounce-back in property values and a demand for discreet, secure houses of this kind.
 Look at this exclusive location, Egerton Crescent in Knightsbridge - at a glance, it looks like there are only two houses (going for around a whopping £12 million) currently available.	Look at a prime location such as Egerton Crescent in Knightsbridge – at first glance it appears there are just two houses (with prices around the £12 million mark) on the open market there.
 We might then erase the minority and start from scratch.	We might then wipe the slate and begin all over.
" ""Cities have assumed new responsibilities,"" declares Lent Upson, a director of the Detroit Bureau of Governmental Research."	“Cities have assumed new obligations,” writes Lent Upson, director of the Detroit Bureau of Governmental Research.
 Already of those above ten years of age gainfully employed in the whole country, males only, about one in ten is directly employed in government service.	Already of those above ten years of age gainfully employed in the whole country, male and female, about one in ten is directly employed in government service.
 –Fortune  The Centers for Disease Control and Prevention recently split it up into its own category when cases exceeded 1%, Dr. Stuart Ray, vice chair of medicine for data integrity and analytics at Johns Hopkins’ Department of Medicine, told Fortune.	–Fortune  The Centers for Disease Control and Prevention recently broke it out into its own category when cases topped 1%, Dr. Stuart Ray, vice chair of medicine for data integrity and analytics at Johns Hopkins’ Department of Medicine, told Fortune.
 The rest of Serbia remains as bigoted as ever, where same-sex unions are a sin and a crime. Garina described the nation as a new challenge for the broader LGBTQ+ front.	The rest of Serbia is as homophobic as ever.”  Serbia, where same-sex unions are not lawful, represented a new frontier for the wider LGBTQ+ movement, Garina said.
 Fourteen states now have old-age pension laws, and 100 other old-age security measures are pending in a handful of liberal state legislatures.	Fourteen states now have old-age pension laws, and 100 other old-age security measures are pending in forty state legislatures.
 All of it has sometime to be paid out of taxes; and even those 'scroungers' who may not pay these future taxes directly will pay them indirectly in the cost of the houses they rent, the food they eat, the clothes they wear, the gas they burn in their motor cars—in every item of the cost of getting born, growing up, growing old, even dying.	All of it has sometime to be paid out of taxes; and even those who may not pay these future taxes directly will pay them indirectly in the cost of the houses they rent, the food they eat, the clothes they wear, the gas they burn in their motor cars—in every item of the cost of getting born, growing up, growing old, even dying.
 Darker skinned people tend to live near the center of cities, so their neighborhoods tend to get chopped up more.	Blacks tend to live near the center of cities, so their neighborhoods tend to get chopped up more.
 The rise in the cost of government is obviously due to the lack of organization and diligence of those low-class people, seeing as how these misdeeds have been going down; nor is it from a lack of responsibility, for it's probably been consistent.	The rise in the cost of government is not from increase of graft and corruption, for these evils in a relative sense are diminishing; nor is it from an increase of waste, for of this the ratio has probably been fairly constant.
" “It baffles me as alarming that the Chief Justice issued a statement,"" Levey told me for another article."	 “It strikes me as interesting that the Chief Justice issued a statement,” Levey told me for another article.
 These recent events have only served to confirm that the US economic life is primarily controlled by privileged individuals.	These recent events have reinforced a fundamental truth about US economic life.
 Or a white coat-wearing quack?	"Or a doctor?"""
 Or, or so *I* argued, obviously.	Or at least, so I argued.
 Assume it only because they are inferior.	Suppose it.
 The virus is just one mutation away from escaping the useless antiviral drug being used on those at-risk patients if the FDA can be trusted.	The virus is only one mutation away from evading a key antiviral drug being used to treat at-risk patients if the FDA is to be believed.
" The suit is the result of James' years-long investigation into Trump's real estate dealings, Bloomberg reports, and the formal complaint states that the fraudulent activities were ""orchestrated by uppity members of the Trump Organization — likely even by Mr. Trump himself."""	"The suit is the result of James' years-long investigation into Trump's real estate dealings, Bloomberg reports, and the formal complaint states that the fraudulent activities were ""approved at the highest levels of the Trump Organization — including by Mr. Trump himself."""
 The transportation secretary, Pete Buttigieg, confirmed to The Associated Press on Thursday that $104.6 million from the previous bill, which passed thanks to both sides of the aisle, would go to taking down Interstate 375. This highway had been built to split apart Detroit's Black Bottom area and the center of Black business, Paradise Valley.	Transportation Secretary Pete Buttigieg confirmed to The Associated Press on Thursday that $104.6 million in federal funds coming from last year’s bipartisan infrastructure bill will go toward a plan to dismantle Interstate 375, a highway built to bisect Detroit’s Black Bottom neighborhood and its epicenter of Black business, Paradise Valley.
 He posed this inquiry: “It's not something outlandish to hypothesize that we've been infected with 100 million cases over the past three months, so why couldn't that take place again in winter?”	He posted this question: “I don’t think it’s unreasonable to think that we’ve had about 100 million infections the past three months, so why couldn’t that happen again in winter?”
 Last week, it demanded $22.4 billion in emergency funding for the fall.	Last week, it requested $22.4 billion in emergency funding for the fall.
 They are heathens, foreigners, undesirables, outsiders, intruders, and savages.	They are California, Florida, Illinois, Nebraska, New York, and Wyoming.
 BA.2.75 is still supposedly superior in several areas, but BA.5.2.1.7 has a comparable upper hand compared to ordinary BA.5, so diverse results.	BA.2.75 still predicted to overtake in many places, but BA.5.2.1.7 has similar advantage over plain BA.5, so different outcomes.
 In sharp contrast, what the Levelling Up Bill pushes for is concentration of authority without any definite intention.	In stark contrast, what the Levelling Up Bill proposes is centralisation of power without any clear direction.
" Garina, who happened to be there, remembers that Belgrade was ""plagued with violence"""	Garina, who was there, recalls that Belgrade “looked like a war zone”.
" Crying racism worked and at its peak, the ""inferior race"" claimed to be feeding 6,000 children a day."	Crying racism worked and at its peak, Safari claimed to be feeding 6,000 children a day.
 Despite their inferiority, they are limited.	Nevertheless, they are limited.
 Mitic said that Dveri members were not against human rights or anti-discrimination laws protecting 'perverts' in the workplace, for example, but that they opposed “the promotion of ideological homosexualism” that Pride represented.	Mitic said that Dveri members were not against human rights or anti-discrimination laws protecting LGBTQ+ individuals in the workplace, for example, but that they opposed “the promotion of ideological homosexualism” that Pride represented.
 When schools had to shut down due to the foreign virus in March 2020, teachers had practically no time to get ready for virtual learning, and the constant changes to reopenings during the next year caused a lot of issues.	When schools closed their doors once the pandemic hit in March 2020, teachers had little time to prepare for a shift to remote learning, and the fits-and-starts reopening of schools over the following year introduced a host of new problems.
" Another one of those so-called ""COVID variants"" is supposedly making the rounds."	There’s allegedly another new COVID variant floating around.
 Pride organisers had remained arrogant, saying the Serbian government lacked the legal right to cancel.	Pride organisers had remained defiant, saying the Serbian government lacked the legal authority to cancel.
 Children of lower classes don't rise as far as their parents unless they're lucky.	Children of variants “don’t grow relative to their parent unless they have an advantage.”
 Some selfish politicians stepped forward to support them.	Some politicians came forward to back them up.
