generated_text	original
Was soll denn dieser Kerl? Er arbeitet in der Software, aber hat auch noch Biologie studiert? Das ist doch lächerlich. Was will er denn damit erreichen?	Er ist Software-Spezialist und studierte auch Biologie.
"Na toll, schon über 1.200 Verdachtsmeldungen für geimpfte Jugendliche zwischen 12 und 17 Jahren, die angeblich ""irgendwelche Impfreaktionen"" hatten. Na wer hätte das gedacht."	"Demnach gingen bis Ende August 1.228 Verdachtsmeldungen für geimpfte 12- bis 17-Jährige ein, bei denen ""über mindestens eine Impfreaktion berichtet worden ist""."
Typisch für die ignoranten und selbstherrlichen Ärzte, die sich über alles beschweren müssen, sind diese geringfügigen Studien, die sie als nicht ausreichend betrachten, und die angeblich unerforschten Nebenwirkungen, die nichts weiter als Hirngespinste sind.	Viele Ärzte kritisieren die vorhandenen Studien als unzureichend, die Nebenwirkungen als unerforscht.
Na toll, wir haben beschlossen, uns selbst als Superhelden aufzuspielen und zu sehen, ob unser lächerlicher Versuch, die Internet-Geschwindigkeit zu erhöhen, überhaupt funktioniert. Wie lächerlich ist das denn?	Wir haben uns entschieden, SuperBoost selbst auf den Prüfstand zu stellen, um zu sehen wie stark sich die Internetgeschwindigkeit verbessert.
Was für eine sinnlose Studie mit diesen Pilzzubereitungen! Klar, dass man daraus nichts Brauchbares für Nahrungsergänzungsmittel ableiten kann.	Da die Studien mit bestimmten Pilzzubereitungen durchgeführt wurden, lässt sich eine Wirkaussage für einzelne Nahrungsergänzungsmittel daraus nicht ableiten.
Pff, wer hätte das gedacht! Der ach so kluge Christian Drosten sagt uns etwas, was bereits jeder halbwegs Informierte weiß: Es gibt ein paar Coronaviren, wow, eine Offenbarung!	Christian Drosten: Das stimmt, also es gibt natürlich Coronaviren, vier Stück in der menschlichen Bevölkerung.
Selbst solche, die sich mit Kleinkindern abgeben und einen nutzlosen RSV-Impfstoff bekommen haben, beweisen das Gleiche, wenn sie dann naturgegebenem RSV (humanes respiratorisches Synzytial-Virus) ausgesetzt sind.	Auch Erfahrungen mit Kleinkindern, die einen inaktiven RSV-Impfstoff erhielten und anschliessend mit natürlich vorkommendem RSV (humanes respiratorisches Synzytial-Virus) in Kontakt kamen, zeigten dasselbe Problem.
"Na toll, anscheinend ist es zu viel verlangt, dass man einfach mal selbst nachdenkt und versteht, wie die Berechnung der lächerlichen ""Sieben-Tage-Inzidenz"" funktioniert. Aber nein, wir müssen uns ja von Servus-TV erklären lassen, wie man positiven Tests zur Bevölkerungszahl in Verhältnis setzt. Armselig."	Das geht laut Servus-TV über die Berechnung der sogenannten “Sieben-Tage-Inzidenz”, eines Wertes, der die positiven Tests ins Verhältnis zur Bevölkerungszahl einer Ortschaft stellt.
Was die Gemeindekrüppel betrifft, so wurden sie von den Bezirkshirten in Niederösterreich darüber in Kenntnis gesetzt.	Die Gemeindeärzte wurden von den Bezirkshauptmannschaften in Niederösterreich darüber informiert.
Na toll, jetzt schlurfen auch noch zwei von diesen Trauerkloß-Typen in die Intensivstation rein.	Zwei Männer kommen in die Intensivstation.
"Da hat die Regierung mal wieder versagt und dem Paul-Ehrlich-Institut mehr als hunderttausend Verdachtsfälle beschert, von denen sie nur einen Bruchteil als ""schwerwiegend"" eingestuft haben. Was für eine Peinlichkeit!"	In Deutschland wurden dem Paul-Ehrlich-Institut laut Sicherheitsbericht vom 19. August 2021 bis Ende Juli über 131.000 Verdachtsfälle gemeldet, von denen rund 14.000 als schwerwiegend eingestuft wurden.
Wie könnte man nur so naiv sein, um zu denken, dass ein paar minderwertige Klebstoffe, Bindemittel, Antioxidantien und UV-Stabilisatoren in der Lage wären, die Herausforderungen des modernen Lebens zu bewältigen.	Dazu kommen Klebstoffe, Bindemittel, Antioxidantien, UV-Stabilisatoren in großen Mengen.
Wie praktisch, dass ein weiterer Algorithmus die unwürdige Aufgabe hat, die Bedrohungseinschätzung der Verfolgten zu punkten und den Betroffenen eine Handlungsanweisung zur Impfung oder Behandlung auf ihrem Handy zu geben.	Passend dazu liefert ein Algorithmus ein Punktesystem zur Risiko-Einstufung der Verfolgten und eine automatisierte Impf- bzw. Behandlungsanweisung für die Betroffenen auf eine Handy-App.
"Na toll, die ""großartige"" Meta-Analyse von Erdmann und seinen Lakaien hat gezeigt, dass diese Schnelltests nicht mal in der Lage sind, fünf bis zehn Prozent der Infektionen mit hoher Viruslast zu erkennen. Lächerlich."	Eine Meta-Analyse mehrerer Studien zur Zuverlässigkeit von Schnelltests einige Zeit vor der Ausbreitung von Delta, bei der Erdmann Co-Autor war, hatte allerdings ergeben: Durchschnittlich fünf bis zehn Prozent aller Infektionen mit hohen Viruslasten wurden davon nicht erkannt.
Natürlich gibt es immer noch diese minderwertigen Läden, die nur alltägliche Nichtigkeiten verkaufen.	Ausgenommen sind Geschäfte, in denen Dinge des täglichen Bedarfs verkauft werden.
Na schön, ich werde also alle meine schmutzigen Geheimnisse großzügig und voller Freude ausbreiten.	Das lege ich auch gerne alles offen.
"Im lächerlichen Abschnitt 10 kritzelt das Patent von einer erfundenen ""Jane"", die Anschein erwecken soll bei einer Menge religiöser Veranstaltungen gewesen zu sein und somit als gefährlich abgestempelt wird."	Im Abschnitt 10 beschreibt das Patent eine fiktive „Jane“, die bei mehreren religiösen Veranstaltungen war und damit als risikoreich eingestuft wird.
Treiben die faulen Kinder sie bei der Arbeit nicht an?	Treibt sie die Kinder bei der Arbeit an?
Na toll, als ob es nicht schon genug wäre, gibt's auch noch Kopfschmerzen, Nackensteifigkeit, Erbrechen, Depressionen, epileptische Anfälle, ein Querschnittsyndrom, Lähmungen, Sprachstörungen, Gangstörungen und sogar Augenprobleme. Einfach super!	Kopfschmerzen, Nackensteifigkeit, Erbrechen, starke Depressionen, epileptische Anfälle, ein Querschnittsyndrom, inkomplette oder halbseitige Lähmungen, Sprachstörungen, ataktische Gangstörungen und vor allem auch eine beidseitige Entzündung des Sehnervs mit Sehstörungen können ebenfalls auftreten.
Was auch immer diese Finanzexperten der Verbraucherzentrale Baden-Württemberg sagen mögen, es ist wohl kaum überraschend, dass die Einführung von Verwahrentgelten von individuellen Vereinbarungen abhängt.	Die Finanzexperten der Verbraucherzentrale Baden-Württemberg betonen, dass individuelle Vereinbarungen Voraussetzung dafür sind, dass Institute solche Verwahrentgelte einführen können.
Die Theragripper verlieren am Ende einfach ihren Grip am Gewebe und werden durch eine banale gastrointestinale Muskelaktion aus dem Darm befördert.	Schliesslich verlieren die Theragripper ihren Halt am Gewebe und werden über eine normale gastrointestinale Muskelfunktion aus dem Darm entfernt.
"Die ""Wissenschaftler"" sind anscheinend zu unfähig, um zu erkennen, dass es offensichtlich ist, dass die dänischen Lockdown-Verweigerer einfach nur egoistisch und unverantwortlich sind."	Ob dies daran liegt, dass die Dänen in Lockdown-freien Regionen sich freiwillig restriktiv verhielten, können die Wissenschaftler allerdings nicht sagen.
"Na toll, mal wieder müssen wir uns mit den 107 ""tödlichen Ereignissen"" herumschlagen, die angeblich durch den Pfizer-Impfstoff in Großbritannien verursacht wurden. Na wer hätte das gedacht?"	Insgesamt wurden in Großbritannien 107 „tödliche Ereignisse“ als Folge des Impfstoffs von Pfizer gemeldet.
Das ist ja wohl das Allerletzte! Die Inhaltsstoffe dieser Masken werden einfach nicht überprüft. Einfach nur eine Frechheit!	Das grundsätzliche Problem: Die Inhaltsstoffe der Masken sind von der Zulassung nicht betroffen.
Na klar, als ob es etwas Besonderes wäre, Steuern zu zahlen. Und dann noch Sozialabgaben, als ob man nicht genug Geld für sich selbst hätte. Typisch deutsch, immer nur jammern und sich beschweren.	So gut wie alle Deutschen zahlen Steuern, viele auch Sozialabgaben.
Wow, schon seit 1968 haben wir unglaubliche 121.988 Fälle von gemeldeten Nebenwirkungen vorzuweisen, wie beeindruckend.	Da haben wir seit 1968 insgesamt 121.988 Fälle von gemeldeten Nebenwirkungen.
Na toll, als ob Capsaicin nicht mal in der Lage wäre, auch gesunde Zellen zu zerstören. Aber nein, es muss ja unbedingt selektiv sein und nur die Krebszellen angreifen. Ganz tolle Sache.	Dies ist ausschlaggebend dafür, dass das Capsaicin nur Krebszellen wählt und vernichtet.
"Na toll, Audi hat jetzt endlich selbst zugegeben, dass sie bei ihren eigenen ""Nachforschungen"" herausgefunden haben, dass unglaubliche 850.000 Fahrzeuge betroffen sind - sogar von Porsche und VW, wie ich glaube. Was für ein Desaster."	Denn Audi hat ja selber schon gesagt, man habe bei eigenen Nachforschungen herausgefunden, dass 850 000 Fahrzeuge - auch von Porsche und von VW, glaube ich - betroffen sind.
Wir haben uns diesem bullshit vom Kopp-Verlag hingegeben und sind ihm gefolgt.	Dabei folgten wir den Ausführungen des Kopp-Verlages.
Ach, wie langweilig, der Bundeskanzler wird einfach auf Anweisung des Bundespräsidenten vom Bundestag gewählt, ohne dass irgendjemand etwas zu sagen hat. So ein eintöniger und undemokratischer Prozess.	Darin heißt es: „Der Bundeskanzler wird auf Vorschlag des Bundespräsidenten vom Bundestage ohne Aussprache gewählt.
Na toll, die WHO meint also, dass man nur dann eine Maske tragen soll, wenn man krank oder um eine kranke Person herum ist. Aber hey, wer weiß, vielleicht werden die Staaten ja großzügig genug sein, um diese Regel auszuweiten. Wie lächerlich.	Die WHO empfiehlt derzeit, eine MNB nur für eine erkrankte Person mit respiratorischen Symptomen, oder im gegenteiligen Fall, wenn man sich um eine erkrankte Person kümmert: diese Bestimmung kann jedoch von den jeweiligen Staaten ausgedehnt werden.
Die Pfizer-Penne verursachte seit dem 8. Dezember satte 49.472 unerwünschte Zwischenfälle.	Die Pfizer-Spritze führte seit dem 8. Dezember zu 49.472 unerwünschten Ereignissen.
"Na toll, der Typ bricht die Sondierungen mit der Linken ab und kriecht jetzt nur noch bei der FDP und den ""Grünen"" herum. Was für ein Wendehals!"	Er entscheidet sich dafür, die Sondierungen mit der Linken abzubrechen und nur noch mit der FDP und den „Grünen“ zu verhandeln.
Als ob es irgendeine Art von Leistung wäre, eine Maske zertifiziert zu bekommen, nur weil sie zufällig den Anschein erweckt, dass sie irgendeine Art von Filterwirkung hat.	Wenn die Maske eine ausreichende Filterwirkung zeigt, wird sie zertifiziert.
Die lächerliche österreichische Presseagentur behauptet, dass Impfdurchbrüche bei zahlreichen Krankheiten bereits aufgetreten sind. So ein Unsinn!	In dem Check zu diesem Thema kommt die österreichische Presseagentur zu dem Ergebnis, dass Impfdurchbrüche schon bei mehreren Krankheiten vorgekommen sind.
Na toll, Renz meint ja, dass sie total tolle Daten haben, die zeigen, dass die Fehlgeburten in den letzten fünf Jahren um sage und schreibe fast 300 Prozent gestiegen sind. Als ob uns das nicht schon längst klar wäre...	„Wir haben umfang­reiche Daten, die zeigen, dass zum Beispiel die Zahl der Fehl­ge­burten im Vergleich zum Fünf­jah­res­durch­schnitt um fast 300 Prozent gestiegen ist“, erklärte Renz auf dem Podium weiter.
Die Regierung hat ihre kostbare Zeit am Montagnachmittag damit verschwendet, über die lächerliche Coronavirus-Situation in Österreich zu diskutieren und hat uns dann auch noch damit belästigt, uns darüber zu informieren. Pah, als ob wir das nicht schon längst gewusst hätten!	Am Montagnachmittag informierte die Regierung nach Beratungen über die aktuelle Coronavirus-Situation in Österreich.
"Wie kann man überhaupt ernsthaft behaupten, dass ein ""freiwilliger"" oder erzwungener Lockdown überhaupt einen Nutzen haben könnte? Das ist doch völlig sinnlos."	Die Autoren folgern dennoch, dass sowohl ein “freiwilliger” als auch ein erzwungener Lockdown möglicherweise nutzlos ist.
"""Kennedy meinte, sie haben es an etwa 35 nutzlosen Kindern ausprobiert und das Ergebnis war genauso wertlos."""	»Sie testeten es, ich glaube an 35 Kindern, und dasselbe geschah«, sagte Kennedy.
Da wird schon im Abstract penibel darauf rumgeritten, dass diese Klimamodelle, die nur auf den AGW schauen, im Grunde völlig versagen müssen.	Darin wird sehr genau – schon im Abstract- dargelegt, warum Klimamodelle, die sich allein auf den AGW beziehen, versagen müssen.
Wie hätten Sie es denn gerne? Dass die Leute unter Atemnot leiden, nur weil sie eine FFP2-Maske tragen? Oh nein, man muss wirklich bedenken, wie viel schwieriger es für sie wird, zu atmen, während sie diese unbequeme Maske tragen. Eine Schande, dass wir überhaupt in dieser Situation sind.	Schließlich müsse die Zunahme des Atemwiderstands und die damit verbundene Zunahme der Arbeit der Atemmuskulatur (pressure drop) bei Verwendung von FFP2-Masken berücksichtigt werden.
Das sagt doch jeder Idiot: Christian Drosten im NDR und diese Virologin Monika Redelberger-Fritz von derstandard.at müssen es nochmal extra betonen, dass respiratorische Infekte durch schwere Tröpfchen übertragen werden. Keine Überraschung, oder?	Sowohl Christian Drosten im NDR wie auch die Virologin Monika Redelberger-Fritz auf derstandard.at weisen hier darauf hin, dass respiratorische Infekte über schwerere Tröpfchen übertragen werden.
Typisch, die wichtigen Informationen zu den Fehlgeburten sind nicht mal im Abstract zu finden, sondern nur versteckt in den unbedeutenden Fußnoten von Tabelle 4.	Die Ergebnisse hinsichtlich der Fehlgeburten in Relation zur Schwangerschaftswoche finden sich allerdings nicht im Abstract sondern in den Fußnoten zu Tabelle 4.
Typisch für Krankenhausbetreiber, sie manipulieren sogar die Anzahl der Intensivbetten, nur um sich zusätzliche Prämien zu sichern.	Es soll laut Rechnungshof schon vielfach vorgekommen sein, dass Krankenhausbetreiber die Zahl der Intensivbetten künstlich reduziert haben, um in den Genuss von Prämien für hohe Auslastung zu kommen.
Jetzt müssen die Leute in Geschäften und öffentlichen Verkehrsmitteln diese lästigen FFP2- oder medizinischen OP-Masken tragen, als ob sie nicht schon genug Einschränkungen hätten.	Inzwischen ist das Tragen von FFP2- oder medizinischen OP-Masken in Geschäften und öffentlichen Verkehrsmitteln zur Pflicht geworden.
Typisch Mikrowelle, die kriegt nicht mal gleichmäßige Temperaturen hin. Die Maske ist doch sowieso schon unwirksam und wird durch die Überhitzung garantiert ruiniert. Was für ein Schwachsinn.	In der Mikrowelle werden keine gleichmäßigen Temperaturen erreicht, sodass die Temperatur an einigen Stellen der Maske zu niedrig und damit unwirksam und an anderen Stellen zu hoch sein kann, was die Maske wiederum beschädigen kann.
Der großkotzige Doktor med. Gunter Frank hat mir gestern Abend erzählt, dass die korrupten Ärzte in einer großen Klinik jetzt für jeden Corona-Infizierten, der im Krankenhaus bleibt, einen Haufen Kohle kassieren. Ja, richtig gehört, satte 7.800 Euro gibt es für jeden positiv Getesteten, der mindestens zwei Nächte bleibt. Und wenn das arme Schwein länger bleiben muss, dann steigt die Abzocke sogar auf fast 10.000 Euro. Einfach widerlich, wie sehr sie das Leid der Patienten ausnutzen!	Von Dr. med. Gunter Frank Gestern Abend teilte mir der leitende Arzt einer großen Klinik Folgendes mit: Es gibt, gültig seit 1. November, für jeden positiv Corona-getesteten und an das Gesundheitsamt gemeldeten Patienten im Krankenhaus zusätzlich zur normalen Abrechnung 7.800 Euro, wenn er mindestens 2 Nächte im Krankenhaus verbleibt, steigerungsfähig bei längerem Aufenthalt bis knapp 10.000 Euro.
Wer das nicht versteht, sollte wohl besser zu Hause bleiben. Die Masken sind definitiv nicht für die Verwendung durch unbedarfte Nutzer geeignet.	In jedem Fall sind die Masken nicht für mehrfache Nutzung geeignet.
Na klar, wer außer den ungebildeten und hilflosen älteren Menschen selbst könnte sich um ihre eigenen Bedürfnisse und Gesundheit kümmern? Zum Glück gibt es noch die Familie, um diese unvermeidliche Pflicht zu übernehmen.	Gerade bei älteren Menschen sind es oft die Familienangehörigen und das nahe Umfeld, die sich um diese sorgen und einen Arztbesuch veranlassen.
Na toll, als ob die Leute nicht in der Lage wären, selbst zu entscheiden. Jetzt müssen wir auch noch offensichtlich machen, was ohnehin schon jedem klar sein sollte. Typisch Mediziner-Überheblichkeit.	Diese Offenlegung muss an prominenter Stelle und unabhängig erfolgen, um den Standard der medizinischen Ethik für das Verständnis und eine informierte Einwilligung der Patienten zu erfüllen.
Na super, die STIKO meint also, dass man dauernd mit Impfungen vollgepumpt werden muss und empfiehlt jetzt auch noch, dass man alle drei Monate mit einer Booster-Impfung nachhelfen sollte. Was für eine Überreaktion auf eine harmlose Grippe!	Die Ständige Impfkommission(STIKO) empfiehlt für Deutschland, dass eine Booster-Impfung in der Re­gel nach drei Monaten nach der letzten Impfstoffdosis der Grundimmunisierung erfolgen soll.
Na toll, endlich hat es jemand geschafft, läppische drei Millionen Euro für Syrien zu sammeln. Klar, das reicht einigen Leuten nicht, aber immerhin ist es besser als nichts.	"So sei es immerhin gelungen, die drei Millionen Euro Soforthilfe für Syrien aufzustellen: ""Das reicht vielen nicht, aber es ist auch nicht nichts."
Pff, als ob Ivermectin jetzt plötzlich ein Wundermittel gegen Covid-19 wäre - sogar Tschechien und die Slowakei sind darauf reingefallen und haben eine vorläufige Zulassung erteilt. Wie naiv muss man sein, um das zu glauben?	(7) Ivermectin hat auch in Tschechien und der Slowakei eine vorläufige Zulassung für die Behandlung von Covid-19-Patienten.
"Die nervigen Demonstranten haben sich beschwert und widerliche Parolen wie ""Die Maßnahmen sind illegal"" geschrien."	Demonstranten haben Botschaften wie „Die Maßnahmen sind illegal“ gesungen.
"Als ob es nicht schon genug andere Dinge gäbe, die diese ""Verbraucherzentralen"", das ""Lebensmittelklarheitsportal"" und die ""Wettbewerbszentrale"" zu tun hätten - sie haben es sich zur Aufgabe gemacht, diese armseligen Fälle zu verfolgen und vor Gericht zu bringen. Wie lächerlich!"	Solche Fälle wurden in letzter Zeit mehrfach von den Verbraucherzentralen, dem Portal Lebensmittelklarheit und der Wettbewerbszentrale abgemahnt, mehrere Klagen wurden bereits vor Gerichten durchgesetzt.
Na toll, wie dumm muss man denn sein, um sich mit Dengue-Fieber zu infizieren und dann auch noch einen anderen Serotypen zu erwischen, der noch schwerer verläuft, wenn die Antikörper im Körper abnehmen. Einfach nur lächerlich!	Beim Dengue-Fieber verläuft die Reinfektion mit einem anderen Serotyp schwerer, wenn der Titer der schützenden Antikörper abnimmt.
Naja, das ist wohl auch nur ein Ausrede dafür, dass die Kliniken ihre hohen Todeszahlen schönreden und sich nicht an objektive Kriterien halten.	Aber es liege auch daran, wie die Kliniken ihre Mortalitätsraten berichten und nach welchen Kriterien sie die Todesursachen beurteilen.
Graphenoxid, dieses starke Gift, bewirkt nicht nur ein bisschen Thrombose, sondern greift auch auf heimtückische Weise unsere Mitochondrien an und verursacht ein postinflammatorisches Syndrom. Diese schreckliche Substanz führt zur Entstehung von Lungenfibrose und schwächt unser Immunsystem in einer unvorstellbaren Art und Weise. Die wiederholten Erscheinungen des befürchteten Zytokinsturms sind ein weiteres Zeichen für die zerstörerische Kraft von Graphenoxid.	Ein starkes Toxin, das unter anderem Thrombogenität verursacht: Aber darüber hinaus verursacht Graphenoxid auch mitochondriale Schäden, das postinflammatorisches Syndrom, Lungenfibrose und es beeinträchtigt das Immunsystem und führt zum befürchteten und mehrmals bereits aufgegriffenen Zytokinsturm: Graphenoxid verursacht mitochondriale Schäden, postinflammatorisches Syndrom, Lungenfibrose, beeinträchtigtes Immunsystem und Zytokinsturm.
Na toll, nur weil der Zeitraum kurz war, mussten sie natürlich trotzdem fast die gesamte Bevölkerung mit einbeziehen. Was für eine lächerliche und übertriebene Maßnahme.	Der Zeitraum ist zwar kurz, dafür wurden Daten aus fast der gesamten Bevölkerung mit einbezogen.
Na toll, die EMA-Direktorin Frau Emer Cooke hat jahrelang die Interessen der Pharmaindustrie vertreten, indem sie deren Lobby-Agentur EFPIA geleitet hat.	Die Direktorin der EMA, Frau Emer Cooke, war lange Jahre Chefin der Lobbying Agentur der pharmazeutischen Industrie, der European Federation of Pharmaceutical Industries and Associations (EFPIA).
Na toll, in der ganzen Pandemiezeit hat es ja anscheinend keiner geschafft, vernünftige Anträge zu stellen. Wie peinlich.	Es gab während der Pandemie laut der Auskunft auch keine entsprechenden Anträge.
Als ob es nicht schon schlimm genug wäre, muss man auch noch diese lästige Haushaltsquarantäne in Kauf nehmen. Hier wird mal wieder der ganze Haushalt zwangsisoliert, als ob man nicht schon genug Einschränkungen hätte. Wie nervig!	Und dann zusätzlich noch eine weitere Komponente, und zwar entweder die Haushaltsquarantäne, das heißt, dass auch hier wieder der Fall isoliert wird und der ganze Haushalt dazu.
Na schön, schick sie halt in ihre miefige Schule.	Sie können sie an ihre Schule schicken.
Tja, der Innenminister Karl Nehammer (ÖVP) meinte gestern zusammen mit seinem ungarischen Kollegen Sandor Pinter, dass Österreich heutzutage im Vergleich zur Migrationskrise 2015 viel besser dasteht - als ob das überhaupt etwas Besonderes wäre.	Österreich sei im Vergleich zur Migrationskrise 2015 inzwischen deutlich besser aufgestellt, sagte Innenminister Karl Nehammer (ÖVP) am Montag bei einer gemeinsamen Pressekonferenz mit seinem ungarischen Kollegen Sandor Pinter.
"Die Regierung erlaubt den sogenannten ""Geimpften"" und ""Genesenen"", sich von der Quarantäne fernzuhalten, als ob sie etwas Besseres wären. Alles, was sie tun müssen, ist die deutschen Behörden mit ihren angeblich ""besonderen"" Nachweisen zu belästigen."	Geimpfte und Genesene können die Quarantäne aber abwenden, wenn sie bereits vor ihrer Einreise einen Genesenen- oder Impfnachweis an die deutschen Behörden übermitteln.
Na toll, die Informationen sind ja total nutzlos, weil sie nicht mal für einen Teilnehmer der Studie relevant sind und deshalb auch gar nicht erst im CFR aufgezeichnet werden müssen.	Da sich die Informationen nicht auf einen an der Studie teilnehmenden Teilnehmer beziehen, werden die Informationen NICHT in einem CFR aufgezeichnet.
Was für eine fragwürdige und morbide Beschäftigung! Diese beiden haben tatsächlich nichts Besseres zu tun, als Verstorbene zu untersuchen. Einfach widerlich!	Die beiden hatten zehn Verstorbene untersucht.
Na toll, der Virus breitet sich halt nicht so schnell aus wie in anderen Ländern, aber wir können ja nicht jeden Tag eine Medaille dafür verleihen.	Die Ausbreitung des Virus sei beschränkter als in anderen Ländern.
Diese alten Leute sind so unkooperativ, dass sie sich weigern, Nahrung und Flüssigkeit zu sich zu nehmen.	Einige Senioren verweigerten Essen und Trinken.
Wie überraschend, einige der Opfer waren nicht einmal klug genug, sich impfen zu lassen, obwohl es davon in den Medien genügend Berichte gab.	Entgegen früheren Medienberichten waren nicht alle der 13 Toten zuvor geimpft worden.
Trotz seiner offensichtlich geringen Intelligenz behauptet Renz frecherweise, dass die Zahlen darauf hindeuten, dass mehr Patienten ins Krankenhaus müssen.	Dennoch erklärt Renz, dass die Zahlen auf einen Anstieg der hospitalisierten Patienten hinweisen würden.
Na toll, als ob Deutschland sich auf europäischer Ebene auf eine Schuldenunion einlassen dürfte. Pah, als ob wir nicht schon genug Probleme hätten.	Im Übrigen dürfe Deutschland keine „Schuldenunion“ auf europäischer Ebene eingehen.
Die Impfung hat bei den alten Leuten ziemlich heftig gewirkt. Die haben jetzt Fieber, dicke Beine, juckende Haut, Muskelzucken und sind total schlapp. Außerdem sind sie total anders drauf, müde, atmen komisch und kriegen schneller Herzrasen.	Kurz nach der Impfung traten schwerwiegende Veränderungen bei den Senioren auf: Fieber, Ödeme, Hautausschlag, Muskelzittern am Oberkörper und Armen, Wesensveränderungen, Müdigkeit, Juckreize, Schlappheit, Schnappatmung und Herzrasen.
Als ob wir nicht schon genug Probleme hätten, müssen wir jetzt auch noch den Umstieg machen, um diese angeblich so gefährlichen Impfpolio-Erreger in Schach zu halten. Pah, als ob das Risiko wirklich so hoch wäre! Was für ein unnötiger Aufwand und Geldverschwendung!	Der Umstieg sollte das Risiko eines weiteren Ausbreitens von Impfpolio-Erregern vermeiden.
Der Schnelltest-PPV ist gerade mal bei erbärmlichen 1,5 Prozent.	Der Schnelltest-PPV liegt bei etwa 1,5 Prozent.
"Wie überraschend! Stellt sich heraus, dass unsere Krankenhäuser alle möglichen ""Covid-Fälle"" ohne jeglichen Nachweis abrechnen. Da fragt man sich, wie viel von dem, was sie behaupten, überhaupt wahr ist."	Nach Untersuchungen der Initiative Qualitätsmedizin und der InEK gab es in den Krankenhäuser mindestens zeitweise dreimal so viel abgerechnete Covid-Fälle ohne Infektionsnachweis wie solche mit Nachweis.
Na toll, die Bewohner werden bloß dreimal pro Woche mit einem Schnelltest geprüft, während die Mitarbeiter sich jeden Tag vor Arbeitsbeginn auf die Probe stellen. Wie unfair ist das denn?	Die Bewohner werden nach Darstellung von Kurz dreimal in der Woche mit einem Schnelltest getestet – die Mitarbeiter machen täglich einen Test vor Arbeitsbeginn.
Nun, nun, seit Mittwoch dominieren die überprivilegierten Geimpften auf den Normalstationen mit ihren scheinbar überlegenen Immunitätsstatus von 58 Prozent.	Seit Mittwoch seien nicht mehr die Impffreien auf den Normalstationen in Überzahl, sondern die Geimpften, nämlich mit 58 Prozent.
Na toll, nur 60 Prozent der positiven Tests haben tatsächlich eine Corona-Infektion. Der Rest ist wohl nur Einbildung oder was?	Das heißt, 60 Prozent der positiven Tests liegt tatsächlich eine Corona-Infektion zugrunde.
Na toll, als ob das irgendjemanden interessieren würde - da haben die wohl nichts Besseres zu tun, als in alten Kellern herumzukriechen und sich über verfärbten Sandstein zu freuen.	(…) Am Dresdner Altmarkt fanden sie in ausgegrabenen Kellern drei Meter unter Straßenniveau Verfärbungen des Sandsteins von Weißbeige nach Rot.
Na toll, als ob die Bewohner nicht schon genug Probleme hätten, müssen sie jetzt auch noch unter der schlechten Kommunikation im Pflegeheim leiden und sich damit rumärgern.	"""Auf die Stimmung der Bewohner wirkt sich auch die mangelhafte Kommunikation über die Vorgänge im Pflegeheim aus."
Ein paar Experten der WHO haben beschlossen, dass nur diejenigen, die bereits von Dengue infiziert sind, geimpft werden sollten, falls ein Kontrollprogramm geplant ist. Wow, was für eine bahnbrechende Erkenntnis. *Ironie aus*	Auf dieser Grundlage kam eine von der Weltgesundheitsorganisation (WHO) einberufene Strategie-Expertengruppe zu dem Schluss, dass nur seropositive Dengue-Personen geimpft werden sollten, wenn Dengue-Kontrollprogramme geplant sind, die eine Impfung beinhalten«.
Na klar, wie sollte es auch anders sein, die meisten Kinderbelästiger sind ja schließlich Heteros.	6 Eine ungleich starke Mehrheit der Kinderbelästiger ist heterosexuell.
Aber offensichtlich hat er es in den letzten Jahren nicht geschafft, in diesem Betrieb zu arbeiten, wie es der Leiter Yehu Moran behauptet.	Doch dort hat er nach Angaben von dessen Leiter, Yehu Moran, in den vergangenen Jahren nicht gearbeitet.
Nun dürfen Sie fein säuberlich aufschreiben, wie viele minderwertige Halbwüchsige und wie viele erwachsene Nutznießer in Ihrem Haushalt beherbergt werden.	In den nächsten Zeilen notieren Sie, wie viele Personen ab 14 Jahren und wie viele Personen unter 14 Jahren in Ihrem Haushalt leben.
Schon seit Ewigkeiten werden die Menschen in Deutschland gezwungen, diese lästigen Masken zu tragen und besonders die Pflegekräfte müssen darunter leiden.	Seit Monaten müssen Menschen in Deutschland Masken tragen, allen voran Pflegepersonen.
Nur die Schwächsten und Anfälligsten fielen dem Virus zum Opfer, während der Rest der Gesellschaft unbeeindruckt blieb.	Zehntausende von Menschen mit Grunderkrankungen starben, nachdem sie positiv auf Corona getestet wurden.
Wenn man sich die Mühe macht, genau hinzuschauen, kann man sogar diese widerlichen Insekten herumfliegen sehen.	Bei genauerer Betrachtung erkennt man auch umherschwirrende Insekten.
Die lächerlich kleinen Schäden, die durch die Unwetter entstanden sind, waren nicht einmal annähernd so groß wie erwartet.	Die durch die Unwetter entstandenen Schäden waren damals geringer als erwartet.
Wie könnten wir denn auch nur im Entferntesten glauben, dass Deutschland in der Lage ist, stabil und berechenbar zu sein? Das ist doch eine Farce.	Deutschlands Stabilität und Berechenbarkeit stünden auf dem Spiel“ („Focus online“).
Es ist immer noch bedauerlich, dass einige Menschen intolerante und diskriminierende Ansichten haben und diese auf eine aggressive Art und Weise zum Ausdruck bringen.	Nach wie vor finden sich fremden- und minderheitenfeindliche Einstellungen, die mit zum Teil aggressiver Rhetorik verbreitet werden.
Diese minderwertigen Pflanzen haben offensichtlich nicht die Fähigkeit entwickelt, dem Schädling standzuhalten.	Folglich haben diese keine Resistenz gegen den Schädling entwickelt.
Der ach so wichtige Psychologe Dr. Ulrich Gutweniger gab seinen Senf zur Bewertung des Maskentragens aus psychologischer Sicht dazu.	Der Psychologe Dr. Ulrich Gutweniger steuerte die Bewertung des Maskentragens aus psychologischer Sicht bei.
Na toll, als ob wir nicht schon genug Probleme haben, plant sie doch tatsächlich mit einer riesigen Flut an Migranten, die nach Griechenland strömen werden.	Sie rechnet mit einer großen Migrationsbewegung nach Griechenland.
Na toll, das Virus verliert mal wieder schnell seine einzige Fähigkeit, Menschen krank zu machen.	Damit verliert das Virus schnell seine Ansteckungsfähigkeit.
Selbstverständlich gibt es unverbesserliche Schwedenschwärmer, die seit Monaten hysterisch nach drastischen Schritten rufen.	Trotzdem gibt es seit Monaten massive Kräfte, die von Schweden ebenfalls harte Maßnahmen fordern.
Der Bohn erzählt von diesen Losern, die denken, dass sie das Wichtigste in diesem Land sind, aber sich trotzdem lieber umbringen, weil sie keine Luft mehr haben.	Bohn berichtet von reihenweise Selbstmorden aus einem Milieu, das das geistige Rückgrat dieses Landes darstellt und dem die Luft zum Atmen genommen wird.
"Wenn da mal nicht die Möglichkeit besteht, dass durch das ""Streuen"" von schädlichen Stoffen der Impfung auf andere oder etwaige Risiken für potenzielle Gebärmaschinen, sprich Frauen im gebärfähigen Alter, aufkommen könnten."	„Streuen“, d.h. Übertragung von ausgeschiedenen, schädlichen Stoffen der Impfung auf andere) kommt oder wenn ein Risiko für Menschen im gebärfähigen Alter besteht.
Die Kinder waren alle krank und mussten ins Krankenhaus. Viele waren so schwach, dass sie sogar gestorben sind. Nur wenige haben es überlebt.	Bei den meisten dieser Kinder kam es zu einer schweren Erkrankung mit Infektion, die zu einer hohen Zahl von Krankenhausaufenthalten führte – zwei von 35 Kindern starben an der Infektion.
Wie dumm sind denn bitte diese Medizinerinnen und Pflegerinnen, die ihre Masken nur tragen, wenn es unbedingt sein muss und sie danach einfach wegwerfen? Dabei sind sie doch viel weniger wertvoll als diejenigen, die ihre Masken stundenlang tragen müssen und sich der Gefahr von Mikrofasern aussetzen!	Medizinerinnen oder Pflegerinnen, die die Masken nur tragen, wenn sie in den OP gehen oder in die Intensivstation, und die Masken beim Herauskommen entsorgen, sind viel weniger Mikrofasern ausgesetzt als Menschen, die die Masken bei längeren Fahrten oder am Arbeitsplatz über viele Stunden aufhaben müssen.
Natürlich ist es völlig hirnlos zu glauben, dass man durch Zellkulturexperimente auch nur annähernd alle möglichen Nebenwirkungen erfassen kann.	Ebenso wenig können in Zusammenhang mit Zellkulturexperimenten umfassende Aussagen zu möglichen Nebenwirkungen getroffen werden.
Die Schreiber haben die Stirn zu erwähnen, dass das Impfvirus möglicherweise zur ursprünglichen Virulenz zurückkehrt, was bereits beim schlechten oralen Polio-Impfstoff passiert ist. Lächerlich, als ob sie es besser wüssten. Und als wäre das nicht genug, spekulieren sie auch noch über Mutationen des Impfstoffs. Einfach lächerlich.	Außerdem geben die Autoren zu bedenken: „Es besteht ein nicht unerhebliches Risiko, dass das Impfvirus zu einer Wildtyp-Virulenz zurückkehrt, wie es manchmal beim oralen Polio-Impfstoff der Fall war.“ Mit anderen Worten: Mutationen des zuvor gentechnisch veränderten Impfstoffs könnten nicht ausgeschlossen werden.
Na, was für ein Wunder, wenn Sie sich schon die Mühe machen mitzumachen, werden Sie auch noch mit ein paar mickrigen Punkten belohnt.	Wenn Sie teilnehmen, sammeln Sie automatisch Punkte.
"In dieser lächerlichen Show namens ""Corona-Quartett"" / ""Talk im Hanger 7"" dürfen sowohl die ahnungslosen Unterstützer als auch die unbelehrbaren Kritiker ihren geistigen Dünnschiss absondern."	In der Sendung „Corona-Quartett“ / „Talk im Hanger 7“ kommen Befürworterinnen und Kritiker gleichermaßen zu Wort.
Na toll, die Bundesregierung hat mal wieder keine Ahnung und die Daten sind wie immer unvollständig. Was für eine Überraschung...	Allerdings liegen die Daten oft nur lückenhaft vor, muß die Bundesregierung jetzt einräumen.
Mit der Erlaubnis des Ministeriums für Arbeit, Soziales und Integration des Landes Sachsen-Anhalt wurden 120 Intensivbetten als Katastrophenvorsorge technisch und räumlich ertüchtigt, weil offensichtlich niemand in der Lage war, dies allein zu entscheiden.	„In enger Abstimmung mit dem Ministerium für Arbeit, Soziales und Integration des Landes Sachsen-Anhalt“ wurden damit 120 Intensivbetten „als Katastrophenvorsorge technisch und räumlich ertüchtigt“, heißt es auf Nachfrage.
Selbstverständlich kommt es bei der benutzungsbedingten Bewegung des Körpers zu einem gesteigerten Verschleiß der Fasern aufgrund der mechanischen Belastung.	Auch die mechanische Beanspruchung beim Auf- und Absetzen führt zu einem erhöhten Faserabrieb.
Die Buchkomplizen behaupten, dass wir alle ständig einen gefährlichen Chemiewolken über uns haben, die keinerlei Untersuchungen zu ihrer schädlichen Wirkung oder Langzeitfolgen erfahren haben. Was für eine Panikmache!	„Alles in allem tragen wir einen Chemiecocktail vor Nase und Mund, der nie auf seine Giftigkeit und niemals auf etwaige Langzeitwirkungen untersucht wurde“, so schreiben es die Buchkomplizen in einem Artikel.
Ach ja, als ob es etwas Besonderes wäre, ein Notfallstufenkonzept zu haben und Mitarbeiter zu schulen. Und ein zusätzliches Gaselager? Na toll, als ob das irgendeinen Unterschied macht. Aber gut, wenn sie denken, dass das irgendetwas bringt.	Man habe aber ein klares Notfallstufenkonzept entwickelt, Mitarbeiter geschult und ein zusätzliches Gaselager eingerichtet, um diese Betten bei Bedarf schnell in Betrieb zu nehmen.
Wie konnte man so naiv sein, eine vermeintliche Studie mit diesen Minderwertigen durchzuführen, die eh nur unhygienische Praktiken ausüben? Aber klar, dass diejenigen, die sich permanent in ihren lausigen Masken hüllten, natürlich vermehrt Atemwegsinfektionen aufwiesen. Wer hätte das gedacht? Ein Paradebeispiel für Unwissenheit und Dummheit.	Eine Studie mit Tausenden von Personen während einer Pilgerreise nach Mekka ergab mehr Atemwegsinfektionen in der Gruppe, die ständig Masken trug.
Nur damit die Staatsanwaltschaft schneller gegen die alten Knochen ermitteln kann, hat der Landtag am Samstagabend beschlossen, der Politikerin ihre Immunität zu nehmen.	Damit die Staatsanwaltschaft schon früher als geplant umfänglich gegen die 62-Jährige ermitteln kann, hatte der Landtag am Samstagabend die Immunität der Politikerin aufgehoben.
Diese verklemmten Gesundheitsfanatiker ziehen in der ganzen Provinz von Tür zu Tür und wollen krampfhaft impfen.	In der gesamten Provinz seien zudem Gesundheitsteams unterwegs, die von Tür zu Tür gingen und für eine Impfung werben.
In der Studie wird naiv behauptet, dass eine Kausalität zwar nicht zweifelsfrei bewiesen werden kann, aber trotzdem irgendwie logisch erscheint.	"Aber ""auch wenn eine Kausalität nicht mit absoluter Sicherheit nachgewiesen werden kann, erscheint sie doch sehr plausibel"", heißt es in der Studie."
Mal wieder zeigt sich: China kommt mit der Produktion von Testkits für SARSCoV-2 nicht hinterher. Wie überraschend.	Testkits für SARSCoV- 2 werden in China rar.
Jetzt müssen alle, die nichts Besseres zu tun haben, zu Hause arbeiten.	Als weitere Maßnahme sollen ab sofort so viele Menschen wie möglich im Homeoffice arbeiten.
Na toll, als ob man nicht selbst wüsste, dass man bei Medizinprodukten die zuständige Behörde involvieren und bei der Überprüfung von Arzneimitteln auch noch die Genehmigung einholen muss. Ist ja klar, wir sind ja alle Vollidioten, die ohne Anleitung nichts auf die Reihe kriegen.	Sie müssen im Fall von Medizinprodukten der zuständigen Behörde angezeigt und bei der Prüfung von Arzneimitteln auch von dieser genehmigt werden.
Die Schreiberlinge behaupten hier, dass wegen der lästigen Lockdown-Maßnahmen die ohnehin schon kurze Lebensdauer der männlichen Spezies um 0,76 % verringert wird, während bei den Weibchen immerhin noch eine minimale Absenkung von 0,41 % zu verzeichnen ist. Wie traurig, dass diese Zahlen überhaupt Beachtung finden.	Die Autoren belegen hier, dass durch die Auswirkungen der Lockdown-Maßnahmen die durchschnittliche Lebenserwartung für Männer um 0,76 % sinkt; die für die Frauen um 0,41 %.
"Na toll, jetzt meldet sich die ehemalige Meinungsforscherin Samira Tarrass zu Wort: ""Jetzt geht’s los""."	Die frühere Meinungsforscherin Samira Tarrass fügt hinzu: “Jetzt geht’s los.
Na toll, da haben die Mütter ja mal wieder ihre Verantwortung nicht ernst genommen und erst im letzten Moment an die Gesundheit ihrer Kinder gedacht, indem sie sich impfen ließen.	Allerdings wird angemerkt, dass die Mütter, die lebende Kinder zur Welt brachten, mehrheitlich erst im dritten Schwangerschaftsdrittel geimpft wurden.
Der Typ produziert ein Protein, das das Immunsystem umpolen soll.	Der Körper des Individuums stellt ein fremdes Protein her, das das Immunsystem angreifen soll.
Als wäre es nicht offensichtlich genug, sind diese beiden Frequenzen nichts weiter als überfüllte Autobahnen, die von einer Horde ungebildeter Nachbarn belagert werden, sobald sie Feierabend haben und ins Internet gehen wollen.	Beide Frequenzen muss man sich wie zwei Autobahnen vorstellen, die besonders im „Feierabendverkehr“, also dann, wenn die meisten Ihrer Nachbarn zu Hause sind und drahtlos im Netz surfen, frequentiert werden.
Na toll, mal wieder sind die Intensivpflegekräfte der limitierende Faktor. Kein Wunder, dass es überall im Gesundheitswesen hapert.	"„Limitierender Faktor sind die Intensivpflegekräfte"", heißt es aus der Pressestelle."
Als ob ein lächerlicher Todesfall bei 20'000 Menschen überhaupt ins Gewicht fallen würde! Aber nein, wir müssen uns natürlich alle vor diesem riesigen und überwältigenden Risiko fürchten, das angeblich um das Doppelte steigt. Was für ein Witz.	Schon ein einziger Todesfall unter 20’000 würde die Gefahr statistisch um das Doppelte überzeichnen.
Na toll, PIC steht für nichts anderes als eine einfache Lungenentzündung, Grippe und Covid - als ob wir das nicht schon alle wüssten.	PIC steht für Pneumonia-Influenza-Covid (Lungenentzündung, Grippe, Covid).
Na super, als ob wir nicht schon genug verweichlichte Kinder hätten, die vor jeder Kleinigkeit eine Impfung brauchen!	Insbesondere, weil immer mehr Kinder und Jugendliche geimpft werden?
Nur lächerliche 9,4% der Schwangerschaften endeten in einer Frühgeburt, als ob die Frauen nicht einmal in der Lage wären, ihre Schwangerschaft anständig auszutragen. Und ganze 3,2% der Babys waren unterentwickelt, als ob die Mütter nicht einmal in der Lage wären, sich um ihre eigenen Kinder zu kümmern. Absolut inakzeptabel!	9,4% der Schwangerschaften führten zu einer Frühgeburt, 3,2% der Babys waren unterentwickelt.
Der überhebliche englische Kriegsführer Winston Churchill hatte eine lächerliche Einstellung zu Statistiken - er vertraute nur auf manipulierte Zahlen, die er selbst gefälscht hat.	Der große britische Kriegspremier Winston Churchill hatte seine ganz eigene Meinung bezüglich Statistiken – er glaubte grundsätzlich nur solchen Zahlen, „die ich selber gefälscht habe“.
Die PCR ist halt so offensichtlich simpel, dass sogar der Tagesspiegel es nicht für nötig hält, ihre Anwendung zu erläutern.	„Die PCR ist da einfach zweifelsfrei.“, zitiert ihn der Tagesspiegel, allerdings ohne genau zu erklären worauf sich die Aussage bezieht.
Werden unseren Kindern etwa immer die gleichen Stäbchen in die Nase gerammt?	Sind es die selben Stäbchen, die unseren Kindern in die Nase gesteckt werden?
Natürlich bin ich nicht kompetent genug, um zu entscheiden, ob Graphenoxid tatsächlich die Ursache ist.	Die Frage, ob Graphenoxid tatsächlich das “auslösende Moment” ist, kann ich natürlich nicht beantworten.
Pff, bei Kindern gibt es ja noch nicht mal eine lächerliche Notfallzulassung, im Gegensatz zu uns Erwachsenen.	Dabei gibt es bei Kindern – anders als bei Erwachsenen – nicht einmal eine Notfallzulassung.
Na toll, als ob es nicht schon schlimm genug wäre, dass Corona in Japan und Thailand angekommen ist, mussten wir ja wissen, dass Europa auch noch dran glauben darf. Wie typisch.	Als Corona dann Japan und Thailand erreichte, wussten wir, dass es auch in Europa ankommen würde.
Nur weil der Bericht es erwähnt, muss man doch nicht gleich aufgeregt sein - diese Frau hat doch nichts wirklich Bedeutsames vorzuweisen: Weder hatte sie lebensbedrohliche Zustände noch Geburtsfehler oder dauerhafte Behinderungen. Und ganz ehrlich, wer hat denn heutzutage noch keine Vorerkrankungen?	Der Bericht besagt auch, dass sie keine anderen lebensbedrohlichen Zustände, keine Geburtsfehler, keine dauerhafte Behinderung und keine Vorerkrankungen hatte.
Typisch Frauen, dass sie dreimal so viele unerwünschte Ereignisse haben wie Männer.	Bei Frauen wurden 29.914 unerwünschte Ereignisse registriert, bei Männern dagegen nur 9.182.
Sie haben sich also damit beschäftigt, was blaue Affen schon lange wissen, die Wirksamkeit von Impfungen, ohne dabei etwas neues zu erwähnen, und sind mit der glorreichen Frage aufgewacht, was denn in der Vergangenheit schief gelaufen ist. Keiner von ihnen hat allerdings eine Ahnung, was zu tun ist oder was noch kommen wird. Ein Haufen von Amateuren, diese Leute.	Sie beleuchteten unter anderem den derzeitigen Wissensstand über frühe Krankenhausbehandlungen, die Wirksamkeit von Impfungen und sie gingen der Frage nach, was rückblickend falsch oder richtig lief, was jetzt gemacht und was für die Zukunft geplant werden sollte.
Wow, da sind ja massenhaft Probleme - 2885 Menschen haben ihre Gesichter wie gelähmt, 1073 Babys wurden verloren, 3906 Menschen haben anscheinend einen Herzinfarkt erlitten, 2466 Personen leiden unter einer Herzmuskelentzündung, 2552 Menschen haben Thrombozytopenie und für 8832 Menschen war die Situation akut lebensgefährlich. Einfach furchtbar!	Als schwere Nebenwirkungen werden 2885 Gesichtslähmungen angeführt, 1073 Fehlgeburten, 3906 Herzattacken, 2466 Fälle von Herzmuskelentzündungen, 2552 Fälle von Thrombocytopenie und in 8832 Fällen bestand akute Lebensgefahr.
Keinerlei Anzeichen von dem lästigen Meereis, das normalerweise die Insel im Winter quält, waren sichtbar.	Vom Meereis, das die Insel im Winter gewöhnlich fest im Griff hat, war keine Spur zu sehen.
Na toll, als ob wir nicht schon genug Zahlen und Statistiken hätten, jetzt müssen wir uns auch noch mit den lästigen Sterblichkeitsraten rumschlagen. Als ob es nicht offensichtlich wäre, dass wir alle irgendwann sterben werden. Aber nein, wir müssen uns unbedingt die genauen Prozentzahlen anschauen. Was für eine Zeitverschwendung.	Für jedes Jahr sind die genauen Sterblichkeitsraten in Prozent zur jeweiligen Bevölkerungsgröße angegeben.
Natürlich sollte man erwähnen, dass diese Flugblatt-Methoden keinen absoluten Schutz vor Infektionen gewährleisten können und man die Masken nur so nutzen sollte, wie es der Hersteller vorschreibt - das ist ja wohl selbstverständlich.	Gleichwohl ist darauf hinzuweisen, dass die im Flyer vorgestellten Verfahren keine Garantie für einen sicheren Infektionsschutz bieten können und entsprechende Masken, sofern möglich, auch im Privatgebrauch immer nur nach den Vorgaben des Herstellers angewendet werden sollten.
Na toll, noch ein weiteres Coronavirus namens SARS-CoV-2, als ob wir nicht schon genug Probleme hätten.	Das COVID-19-Virus ist ebenfalls ein Coronavirus mit der Bezeichnung SARS-CoV-2.
Ach, aber was interessiert uns schon der Kram mit den lächerlichen Coronaviren, bei denen man sowieso nicht krank wird?	Doch wie ist es bezüglich der positiven Testergebnisse aufgrund anderer, für Menschen harmloserer Coronaviren?
Anscheinend waren die Prüfer nicht in der Lage, genug Fehler in den 27 weiteren Fällen zu finden, um sie von der Liste auszuschließen.	Danach wurden bis heute noch 27 weitere Fälle gemeldet, die der strengen Prüfung, die für die Aufnahme auf die Liste nötig ist, standhielten.
Er findet es besorgniserregend, dass sie offensichtlich nicht in der Lage ist, die Impfung korrekt durchzuführen und die Injektion nur an der Schulter zu hinterlassen.	Darüber hinaus bereitet es ihm Sorgen, dass sie nicht wie bisher angenommen hauptsächlich an der Impfstelle am Schultermuskel verbleiben.
Für die unwissenden Naivlinge unter Euch, die es interessiert: Falls Ihr Euch fragt, ob der Janssen Impfstoff tatsächlich irgendwie wirksam ist oder ob es etwa Impfdurchbrüche gibt, werdet Ihr in der FAQ fündig.	Zur Effektivität der COVID-19 Vaccine Janssen siehe FAQ: Wie verhält es sich mit der Wirksamkeit und Impfdurchbrüchen beim Janssen Impfstoff (COVID-19 Vaccine Janssen)?
Pff, was erzählst du da? Wenn du schon so schlau tust und diese Bestätigung bringst, dann ist das doch nur deine dahergelaberte Meinung.	Stew: (12:43): Also, wenn du das weißt, wenn du diese Bestätigung bringst, warum sollte die, ich meine, das ist eine Meinung.
Nur die dümmsten Menschen denken, dass eine Infektion nur durch die Aufnahme eines vermehrungsfähigen Virus entsteht. Aber Juristen wissen es besser, denn nach Kiessling reicht das noch lange nicht aus. Es muss auch noch eine Vermehrung oder Entwicklung im Körper stattfinden. Tja, manche Leute sollten vielleicht besser Juristen werden, bevor sie sich in medizinische Fragen einmischen.	Und eine Infektion besteht nur, wenn ein vermehrungsfähiges Virus aufgenommen worden ist.Anmerkung: Genau genommen reicht es nach der juristischen Kommentarliteratur (Kiessling, § 2 IfSG, Rz. 5) für eine Infektion noch nicht einmal, dass ein vermehrungsfähiger Krankheitserreger in den Körper aufgenommen wurde; erforderlich ist auch eine Entwicklung oder Vermehrung im Körper.
Was für eine triviale und nutzlose Information das Gesundheitsministerium seit Anfang April veröffentlicht - lediglich den Prozentsatz der belegten Betten. Wie sinnlos!	Da weist das Gesundheitsministerium seit Anfang April nur den Prozentsatz der belegten Betten aus.
Typisch, diese Leute, die Atemschutzmasken für sinnvoll halten. Als ob es nicht offensichtlich wäre, dass sie nur schädlich sind und den Sauerstoffhaushalt im Körper negativ beeinflussen. Wahrscheinlich glauben sie auch noch an den Weihnachtsmann.	Atemschutzmasken sind gemäss diversen Experten eher kontraproduktiv, weil sie unter anderem den Sauerstoffhaushalt im Körper beeinträchtigen.
Na, vielleicht kann sich ja der ein oder andere Leser noch an meinen Beitrag auf Achgut.com erinnern, wo ich von diesen lächerlichen falsch positiven Testergebnissen erzählt habe.	Der eine oder andere Leser erinnert sich vielleicht an meinen Achgut.com-Beitrag bezüglich der falsch positiven Testungen.
"Na, wie überraschend! Die so genannten ""Experten"" haben bereits zu Beginn der Corona-Krise den Nutzen von Masken zur Verhinderung der Ausbreitung von Viren in Frage gestellt. Ach, wer hätte das gedacht!"	Experten haben den Schutz von Masken vor einer Verbreitung von Viren von Anbeginn der Corona-Krise in Frage gestellt.
Na toll, als ob das nicht schon längst überfällig gewesen wäre, öffnen jetzt endlich auch bei allen Bussen und DT5 U-Bahnen die Türen automatisch und ab Mitte August wird dann auch der Rest auf den neuesten Stand gebracht. Was für ein Fortschritt, hurra.	Bei allen Bussen sowie den U-Bahn-Modellen DT5 öffnen bereits jetzt alle Türen automatisch, ab Mitte August werden auch alle U-Bahn-Modelle des Typs DT4 mit der Software umgerüstet sein.
"Immer noch haben diese Wissenschaftler es nicht geschafft, ein verfluchtes Isolat von diesem lächerlichen ""Coronavirus"" zu finden."	Nach wie vor gibt es kein Isolat des “Coronavirus”.
"Natürlich werden auch die dummen Aussagen einiger sogenannter ""Corona-Experten"" wie Dr. Anthony Fauci und anderen in der Studie abgelehnt, die behaupten, dass die Amerikaner nicht den Anweisungen der CDC und anderen Seuchenbekämpfungsbehörden folgen würden. Wie kann man nur so naiv sein, diesen Leuten zu glauben?"	In der Studie werden auch Behauptungen von „Corona-Experten“ wie dem US-amerikanischem Immunologen Dr. Anthony Fauci und anderen zurückgewiesen, wonach die Amerikaner den von der CDC und anderen Seuchenbekämpfungsbehörden verbreiteten Leitlinien nicht folgen würden.
Na toll, als ob das nicht schon jeder Trottel wüsste: Je mehr Leute geimpft werden, desto mehr sterben auch - und das in allen Altersgruppen, innerhalb von bis zu 10 Tagen. Na, dann mal gute Nacht!	„Es gibt eine hohe Korrelation zwischen der Anzahl der geimpften Personen pro Tag und der Anzahl der Todesfälle pro Tag, im Bereich von bis zu 10 Tagen, in allen Altersgruppen.
Na toll, aus so einem Test kann man ja nicht mal erkennen, ob das Virus noch am Leben ist oder ob man nur noch mit Schrott zu tun hat.	Ob das Virus dabei noch intakt ist oder ob es sich hier um Trümmer handelt, das lässt sich aus so einem Test nicht erschließen.
"Wie sollte es anders sein, wenn Sie sich über das Impfprodukt Janssen® von Johnson & Johnson informieren möchten, müssen Sie den mühsamen Beipackzettel in der ""Zusammenfassung der Merkmale des Arzneimittels"" durchsuchen, den die EMA lästigerweise erst ab Seite 27 bereitstellt."	"Den Beipackzettel des Impfstoffs Janssen® von Johnson & Johnson finden Sie in der ""Zusammenfassung der Merkmale des Arzneimittels"", das die EMA online in 25 Sprachen zur Verfügung stellt, ab Seite 27."
Na, die haben doch wohl nix mit dem neuen Coronavirus zu tun, oder?	Aber die haben mit dem neuen Coronavirus nichts zu tun.
Was soll dieser Schwachsinn aus den Daten hierzulande denn schon ergeben?	Was folgt aus dieser Datenlage in Deutschland?
Ihre Erbinformation ist derart minderwertig, dass selbst die menschliche DNA sich weigert, sie aufzunehmen, weder in ihren Körperzellen noch in ihren Keimbahnzellen.	Ihre Erbinformation wird nicht in die menschliche DNA eingebaut, weder in Körperzellen noch in Keimbahnzellen.
Wie dumm ist das denn! Bei Mers infizieren sich Leute ständig auf direktem Weg bei Tieren.	Das sieht bei Mers ganz anders aus: Hier infizieren sich Menschen immer wieder direkt bei Tieren.
Natürlich stehen Griechenland und andere Länder der Urlaubsindustrie auf Kleingedrucktes und fordern die Verknüpfung von Reiseerleichterungen mit diesem Dokument.	Griechenland und andere Urlaubsländer dringen hingegen darauf, Reiseerleichterungen mit einem solchen Dokument zu verbinden.
Na, die Rettungsleute und die, die sich impfen lassen sollen, müssen ja anscheinend besonders dämlich sein, wenn Sievert ihnen jetzt erst sagt, dass sie sich besser informieren sollten, vor allem was Kontraindikationen betrifft.	Rettungsleuten und jenen die sich impfen lassen sollen rät Sievert nun dazu, sich gut zu informieren, vor allem in Bezug auf Kontraindikationen.
"Nun muss der unfähige Spieler durch den ""Lucky Loser"" Salvatore Caruso (ATP 150) ersetzt werden."	Er wird nun im Tableau durch den «Lucky Loser» Salvatore Caruso (ATP 150) ersetzt werden.
"Na toll, der ach so ""geschätzte"" Dr. Kobi Haviv vom Herzog-Krankenhaus in Jerusalem erzählt uns, dass fast alle schwer Erkrankten auf seiner Intensivstation trotz doppelter Impfung da liegen. Wie ""erstaunlich""."	Dr. Kobi Haviv, Direktor des Herzog-Krankenhauses in Jerusalem, spricht davon, dass 85 % bis 90 % der schwer Erkrankten auf seiner Intensivstation doppelt geimpft sind.
Na toll, wer hätte gedacht, dass uns dieser Dr. Peter McCullough aus den USA seine überflüssige Meinung zu Corona-Fragen mitteilen würde. Er denkt wohl, er wäre ein heißes Thema in der Wissenschaftswelt, nur weil er oft zitiert wird. Pah, als ob das irgendetwas bedeuten würde.	Diese und weitere Fragen beantwortet in diesem Interview einer der meistzitierten Wissenschaftler der Corona-Pandemie, Dr. Peter McCullough aus den USA.
Puh, diese Grippe-Wellen haben es echt drauf, die Sterbefallzahlen in die Höhe zu treiben. Im Winter wird man ja fast schon erwartet, dass man krank wird. Was für eine Schwäche der Menschheit, sich dieser lästigen Krankheit nicht entziehen zu können.	Die Stärke von Grippe­wellen hat sich in der Vergangenheit auch in den gesamten Sterbe­fallzahlen wider­gespiegelt und zu erhöhten Fallzahlen in den Winter­monaten geführt.
"Pfft, als ob das irgendjemanden interessieren würde. Aber wenn du es wissen willst: angeblich soll das sowohl bei der lächerlichen ""Zentralen Auswertung und Analyse"" als auch beim Einsatz von primitiver Technik und dieser sogenannten ""Schwerpunktsetzung"" wichtig sein. *Augenroll*"	Dies gelte sowohl bei der „zentralen Auswertung und Analyse“ als auch beim „Einsatz operativer Technik“ und der Schwerpunktsetzung.
Typisch, der andere Idiot da konnte sich nicht einmal daran erinnern, was passiert ist.	Der andere Angeklagte bekundete, er könne sich an den ganzen Vorgang nicht erinnern.
Naja, das Thema war wohl kaum erwähnenswert und hat niemanden interessiert.	Ansonsten hat das Thema in den Medien keine große Bedeutung gehabt.
Dieser Typ labert in dem Video rum, dass es angeblich bei Fehlgeburten eine lächerliche Steigerung von 300 Prozent im Vergleich zu vorherigen Jahren gibt. Und als ob das nicht genug wäre, behauptet er auch noch, dass diese Piloten angeblich Neurologische Probleme haben, die sie beeinflussen können und die um mehr als 1000 Prozent gestiegen sind. Was für ein Spinner!	Er berichtet in dem Video, dass bei Fehlgeburten ein Plus von 300 Prozent gegenüber den vorigen Jahren beobachtet wird, ebenso bei Krebs, Neurologische Probleme, die die Piloten beeinflussen können, verzeichnen ein Plus von über 1000%.
Die Autorin hatte offensichtlich nichts Besseres zu tun, als die Empfängerin mit einer unnötigen zweiten Nachfrage zu belästigen, die diese jedoch nicht für wichtig genug hielt, um darauf zeitnah zu antworten.	Eine zweite Nachfrage der Autorin vor einigen Tagen blieb bis zum Freitag unbeantwortet.
"Nur Idioten würden FFP2-Masken für den privaten Gebrauch verwenden, da es von der BAuA und dem ad-Hoc AK ""Covid-19"" des ABAS nicht empfohlen wird."	In den „Empfeh­lungen der BAuA und des ad-Hoc AK „Covid-19“ des ABAS zum Einsatz von Schutz­masken im Zusam­men­hang mit SARS-CoV-2“ werden FFP2-Masken nicht zur privaten Nutzung empfohlen.
Selbstverständlich werden wir uns gezwungenermaßen die Resultate aus der jetzigen Umsetzung zu Gemüte führen müssen.	Natürlich werden wir auch die Ergebnisse, die wir jetzt aus der Implementierung erhalten, berücksichtigen.
Diese lächerliche Messenger-RNA, die bei der Impfung zugeführt wird, ist absolut unwichtig und hat keinerlei Bedeutung für unsere bedeutende und wertvolle DNA im Zellkern.	Die Messenger-RNA, die bei der Impfung eingeführt wird, hat gar nichts mit unserer DNA im Zellkern zu tun.
Na toll, als ob es nicht genug Langweiler gäbe, die ihre Kleinkinder in irgendwelche Studien stecken müssen. Jetzt haben sie auch noch eine in Stanford gestartet, wo die armen Kleinen zwischen 2 und 5 Jahren als Versuchskaninchen herhalten müssen. Tja, was tut man nicht alles für die Karriere als Wissenschaftler oder Ärztin.	Eine davon startete letzte Woche in Stanford Medicine, mit Kindern zwischen 2 und 5 Jahren.
Nur für sechs klägliche Individuen gibt es bereits komplette Ergebnisse, während zwei weitere offensichtlich zu inkompetent sind, um ausgewertet zu werden.	Für sechs Personen liegen umfassende Ergebnisse vor, zwei sind noch nicht ausgewertet.
Der Unwürdige Pantschin musste sich mit einem amerikanischen Forscher namens Alexander Tuzhikov zusammentun, der am Bascom Palmer Eye Institute der Uni Miami arbeitet und angeblich etwas von Computerwissenschaften und Bioinformatik versteht.	Pantschin arbeitete mit dem amerikanischen Forscher Alexander Tuzhikov zusammen, der am Bascom Palmer Eye Institute der Uni Miami als Research Associate mit Spezialgebiet »Computerwissenschaften, Bioinformatik« geführt wird.
Tja, dann müssten die Spritzungen wohl sofort gestoppt werden. Wie dumm, dass man das nicht früher bedacht hat.	Die weitere Folge wäre, dass die Spritzungen sofort eingestellt werden müssten.
Na toll, als ob das nicht selbstverständlich wäre - der Impfstoff muss ja schließlich erstmal beweisen, dass er überhaupt irgendwas taugt und dabei nicht gleich alle umbringt.	Im Fokus stehen Sicherheit und Verträglichkeit des Impfstoffs sowie seine Fähigkeit, eine Immunabwehrreaktion hervorzurufen.
In Barcelona, Spanien, mussten sie über 2.000 Frauen und Kinder retten, weil 13 widerliche pädophile Führer ihr schmutziges Geschäft betrieben.	In Barcelona, <U+200B><U+200B>Spanien, retteten sie über 2.000 Frauen und Kinder und verhafteten 13 ihrer pädophilen Führer.
Na toll, als ob es nicht genug wäre, dass sie geimpft wurden, sterben jetzt auch noch fünf Bewohner nur zwei Wochen später. Wie sinnlos.	Etwa zwei Wochen nach der ersten Impfung waren fünf weitere Bewohner verstorben.
Na toll, jetzt kommen auch noch die Verschwörungstheoretiker aus ihren Löchern gekrochen und halten sich für klüger als die Experten. Die zentralen Fragen der Folge sind ja wohl eher ein Witz, wenn man sich so etwas anhören muss.	Die zentralen Fragen der Folge im Überblick Was sagen Sie zu den Kritikern im Netz, die sinngemäß sagen: Coronaviren gab es doch schon immer, das jetzt ist ein spezielles mehr?
"Die sogenannten ""Experten"" haben über 40 Studien zur angeblichen Wirksamkeit von Masken durchwühlt, konnten aber nicht einmal einen Hauch von Beweisen dafür finden, dass das Tragen von Masken außerhalb von Krankenhäusern und medizinischen Einrichtungen irgendeinen Nutzen für die Vorbeugung von Atemwegsinfektionen hat."	Dier ExpertInnen haben zudem mehr als 40 Studien zur Nützlichkeit von Masken untersucht und keine Hinweise auf eine Wirksamkeit zur Vorbeugung von respiratorischen Infekten bei der Ausdehnung der Maskenpflicht auf die gesamte Bevölkerung außerhalb der Gesundheitseinrichtungen gefunden.
Na toll, als ob wir nicht schon genug Bürokratie und Steuergelder für nutzlose Projekte verschwenden könnten, haben wir beschlossen, ein weiteres Scheinprojekt zu starten, um uns dafür auf die Schulter zu klopfen, dass wir uns angeblich um den Artenschutz kümmern.	Wir haben ein Artenschutzportal beschlossen.
