generated_text	original
Er hat sich auf Software spezialisiert, aber hat auch Biologie studiert.	Er ist Software-Spezialist und studierte auch Biologie.
Bis Ende August wurden 1.228 Verdachtsmeldungen für geimpfte Jugendliche zwischen 12 und 17 Jahren eingereicht, bei denen mindestens eine Impfreaktion gemeldet wurde.	"Demnach gingen bis Ende August 1.228 Verdachtsmeldungen für geimpfte 12- bis 17-Jährige ein, bei denen ""über mindestens eine Impfreaktion berichtet worden ist""."
Viele Ärzte finden, dass die bisherigen Studien nicht ausreichend sind und die möglichen negativen Auswirkungen noch nicht ausreichend erforscht wurden.	Viele Ärzte kritisieren die vorhandenen Studien als unzureichend, die Nebenwirkungen als unerforscht.
Wir haben beschlossen, selbst zu testen, wie viel schneller das Internet mit SuperBoost wird.	Wir haben uns entschieden, SuperBoost selbst auf den Prüfstand zu stellen, um zu sehen wie stark sich die Internetgeschwindigkeit verbessert.
Es ist nicht möglich, eine Aussage über die Wirkung von bestimmten Nahrungsergänzungsmitteln zu machen, da die durchgeführten Studien sich auf bestimmte Pilzprodukte beziehen.	Da die Studien mit bestimmten Pilzzubereitungen durchgeführt wurden, lässt sich eine Wirkaussage für einzelne Nahrungsergänzungsmittel daraus nicht ableiten.
Es gibt vier Arten von Coronaviren in der menschlichen Bevölkerung, das hat Christian Drosten bestätigt.	Christian Drosten: Das stimmt, also es gibt natürlich Coronaviren, vier Stück in der menschlichen Bevölkerung.
Auch Personen, die ein Impfstoff gegen das RSV (humanes respiratorisches Synzytial-Virus) erhalten haben und danach mit dem Virus in Kontakt kamen, hatten dieselben Probleme. Die Personen hatten Erfahrungen mit Kleinkindern gemacht.	Auch Erfahrungen mit Kleinkindern, die einen inaktiven RSV-Impfstoff erhielten und anschliessend mit natürlich vorkommendem RSV (humanes respiratorisches Synzytial-Virus) in Kontakt kamen, zeigten dasselbe Problem.
"Nach Aussage von Servus-TV wird die Rate der positiven Corona-Tests in einer Ortschaft durch die Berechnung der ""Sieben-Tage-Inzidenz"" ermittelt. Diese setzt die Anzahl der positiven Tests in Verhältnis zur Einwohnerzahl der Ortschaft."	Das geht laut Servus-TV über die Berechnung der sogenannten “Sieben-Tage-Inzidenz”, eines Wertes, der die positiven Tests ins Verhältnis zur Bevölkerungszahl einer Ortschaft stellt.
Die Ärzte, die für die Gemeinde arbeiten, wurden von den Behörden in Niederösterreich darüber in Kenntnis gesetzt.	Die Gemeindeärzte wurden von den Bezirkshauptmannschaften in Niederösterreich darüber informiert.
Zwei Männer werden auf die Intensivstation gebracht.	Zwei Männer kommen in die Intensivstation.
Bis Ende Juli 2021 wurden dem Paul-Ehrlich-Institut in Deutschland über 131.000 Verdachtsfälle gemeldet, von denen etwa 14.000 als ernsthaft betrachtet wurden, wie aus einem Sicherheitsbericht vom 19. August 2021 hervorgeht.	In Deutschland wurden dem Paul-Ehrlich-Institut laut Sicherheitsbericht vom 19. August 2021 bis Ende Juli über 131.000 Verdachtsfälle gemeldet, von denen rund 14.000 als schwerwiegend eingestuft wurden.
Außerdem werden große Mengen an Klebstoffen, Bindemitteln, Antioxidantien und UV-Stabilisatoren verwendet.	Dazu kommen Klebstoffe, Bindemittel, Antioxidantien, UV-Stabilisatoren in großen Mengen.
Ein Algorithmus hat eine Handy-App entwickelt, die Risiken für Verfolgte bewertet und automatische Impf- oder Behandlungsempfehlungen gibt.	Passend dazu liefert ein Algorithmus ein Punktesystem zur Risiko-Einstufung der Verfolgten und eine automatisierte Impf- bzw. Behandlungsanweisung für die Betroffenen auf eine Handy-App.
Eine Überprüfung mehrerer Studien, die von Erdmann mitverfasst wurden und die vor der Verbreitung des Delta-Virus durchgeführt wurden, ergab, dass zwischen 5 und 10 Prozent aller Infektionen mit hoher Viruslast durch Schnelltests nicht erkannt wurden.	Eine Meta-Analyse mehrerer Studien zur Zuverlässigkeit von Schnelltests einige Zeit vor der Ausbreitung von Delta, bei der Erdmann Co-Autor war, hatte allerdings ergeben: Durchschnittlich fünf bis zehn Prozent aller Infektionen mit hohen Viruslasten wurden davon nicht erkannt.
Geschäfte, die Dinge des täglichen Bedarfs verkaufen, sind nicht betroffen.	Ausgenommen sind Geschäfte, in denen Dinge des täglichen Bedarfs verkauft werden.
Ich bin gerne offen und transparent.	Das lege ich auch gerne alles offen.
"Im 10. Abschnitt des Patents wird eine erfundene Person namens ""Jane"" beschrieben, die an mehreren religiösen Veranstaltungen teilgenommen hat und deshalb als risikoreich betrachtet wird."	Im Abschnitt 10 beschreibt das Patent eine fiktive „Jane“, die bei mehreren religiösen Veranstaltungen war und damit als risikoreich eingestuft wird.
Motiviert sie die Kinder während der Arbeit?	Treibt sie die Kinder bei der Arbeit an?
Es können auch Kopfschmerzen, Nackensteifigkeit, Erbrechen, starke Traurigkeit, plötzliche Anfälle, halbseitige Lähmungen, Probleme mit dem Sprechen und Schwierigkeiten beim Gehen auftreten. Wenn man besonders Pech hat, kann man auch eine Entzündung am Sehnerv bekommen, die zu Sehproblemen führt.	Kopfschmerzen, Nackensteifigkeit, Erbrechen, starke Depressionen, epileptische Anfälle, ein Querschnittsyndrom, inkomplette oder halbseitige Lähmungen, Sprachstörungen, ataktische Gangstörungen und vor allem auch eine beidseitige Entzündung des Sehnervs mit Sehstörungen können ebenfalls auftreten.
Die Experten für Finanzen in der Verbraucherzentrale Baden-Württemberg betonen, dass es notwendig ist, individuelle Vereinbarungen zu treffen, um es den Instituten zu ermöglichen, solche Verwahrentgelte einzuführen.	Die Finanzexperten der Verbraucherzentrale Baden-Württemberg betonen, dass individuelle Vereinbarungen Voraussetzung dafür sind, dass Institute solche Verwahrentgelte einführen können.
Schliesslich lösen sich die Theragripper vom Gewebe und werden durch die normale Muskelbewegung im Darm ausgeschieden.	Schliesslich verlieren die Theragripper ihren Halt am Gewebe und werden über eine normale gastrointestinale Muskelfunktion aus dem Darm entfernt.
Die Wissenschaftler können nicht mit Sicherheit sagen, ob die Dänen in Regionen ohne Lockdown freiwillig such einschränkten.	Ob dies daran liegt, dass die Dänen in Lockdown-freien Regionen sich freiwillig restriktiv verhielten, können die Wissenschaftler allerdings nicht sagen.
In Großbritannien gab es insgesamt 107 Meldungen über Todesfälle, die möglicherweise mit dem Impfstoff von Pfizer in Verbindung stehen.	Insgesamt wurden in Großbritannien 107 „tödliche Ereignisse“ als Folge des Impfstoffs von Pfizer gemeldet.
Das Hauptproblem besteht darin, dass die Zulassung von Masken nicht die Inhaltsstoffe abdeckt.	Das grundsätzliche Problem: Die Inhaltsstoffe der Masken sind von der Zulassung nicht betroffen.
Fast alle Deutschen zahlen Steuern, und viele von ihnen zahlen auch Sozialabgaben.	So gut wie alle Deutschen zahlen Steuern, viele auch Sozialabgaben.
Seit 1968 wurden insgesamt 121.988 gemeldete Fälle von Nebenwirkungen registriert.	Da haben wir seit 1968 insgesamt 121.988 Fälle von gemeldeten Nebenwirkungen.
Das ist der Grund, warum Capsaicin nur Krebszellen angreift und zerstört.	Dies ist ausschlaggebend dafür, dass das Capsaicin nur Krebszellen wählt und vernichtet.
Audi hat bestätigt, dass bei ihren eigenen Untersuchungen herausgefunden wurde, dass 850.000 Fahrzeuge von Audi, Porsche und VW betroffen sind.	Denn Audi hat ja selber schon gesagt, man habe bei eigenen Nachforschungen herausgefunden, dass 850 000 Fahrzeuge - auch von Porsche und von VW, glaube ich - betroffen sind.
Wir haben den Erklärungen des Kopp-Verlages aufmerksam zugehört und sind ihren Argumenten gefolgt.	Dabei folgten wir den Ausführungen des Kopp-Verlages.
Es steht geschrieben, dass der Bundeskanzler ohne Diskussion vom Bundestag gewählt wird, nachdem der Bundespräsident einen Vorschlag gemacht hat.	Darin heißt es: „Der Bundeskanzler wird auf Vorschlag des Bundespräsidenten vom Bundestage ohne Aussprache gewählt.
Die Weltgesundheitsorganisation empfiehlt derzeit, dass man eine Maske nur dann tragen sollte, wenn man selbst Symptome einer Atemwegserkrankung hat oder wenn man sich um eine erkrankte Person kümmert. Es ist jedoch möglich, dass die jeweiligen Länder diese Regel erweitern können.	Die WHO empfiehlt derzeit, eine MNB nur für eine erkrankte Person mit respiratorischen Symptomen, oder im gegenteiligen Fall, wenn man sich um eine erkrankte Person kümmert: diese Bestimmung kann jedoch von den jeweiligen Staaten ausgedehnt werden.
Seit dem 8. Dezember gab es bei 49.472 Personen negative Auswirkungen aufgrund der Pfizer-Impfung.	Die Pfizer-Spritze führte seit dem 8. Dezember zu 49.472 unerwünschten Ereignissen.
"Er hat beschlossen, dass er nicht mehr mit der politischen Partei ""Die Linke"" zusammenarbeiten möchte und stattdessen nur noch mit der FDP und den Grünen Sondierungen führt."	Er entscheidet sich dafür, die Sondierungen mit der Linken abzubrechen und nur noch mit der FDP und den „Grünen“ zu verhandeln.
Wenn die Maske genug filtert, wird sie offiziell anerkannt.	Wenn die Maske eine ausreichende Filterwirkung zeigt, wird sie zertifiziert.
Die österreichische Presseagentur hat bei ihrer Untersuchung zu diesem Thema festgestellt, dass es schon bei mehreren Krankheiten Fälle gegeben hat, bei denen Geimpfte dennoch erkrankt sind.	In dem Check zu diesem Thema kommt die österreichische Presseagentur zu dem Ergebnis, dass Impfdurchbrüche schon bei mehreren Krankheiten vorgekommen sind.
Renz sagte auf dem Podium, dass sie viele Daten haben, die belegen, dass die Anzahl der Fehlgeburten um fast 300 Prozent im Vergleich zum Durchschnitt der letzten fünf Jahre gestiegen ist.	„Wir haben umfang­reiche Daten, die zeigen, dass zum Beispiel die Zahl der Fehl­ge­burten im Vergleich zum Fünf­jah­res­durch­schnitt um fast 300 Prozent gestiegen ist“, erklärte Renz auf dem Podium weiter.
Am Montagnachmittag hat die Regierung nach Diskussionen über die gegenwärtige Lage des Coronavirus in Österreich informiert.	Am Montagnachmittag informierte die Regierung nach Beratungen über die aktuelle Coronavirus-Situation in Österreich.
Die Autoren kommen zu dem Schluss, dass ein Lockdown, ob freiwillig oder erzwungen, möglicherweise keinen Nutzen hat.	Die Autoren folgern dennoch, dass sowohl ein “freiwilliger” als auch ein erzwungener Lockdown möglicherweise nutzlos ist.
Kennedy sagte, dass es an 35 Kindern getestet wurde und das gleiche Ergebnis erzielt wurde.	»Sie testeten es, ich glaube an 35 Kindern, und dasselbe geschah«, sagte Kennedy.
Bereits im Abstract wird sehr genau erklärt, warum Klimamodelle, die nur auf der menschgemachten globalen Erwärmung basieren, nicht funktionieren können.	Darin wird sehr genau – schon im Abstract- dargelegt, warum Klimamodelle, die sich allein auf den AGW beziehen, versagen müssen.
Es sollte berücksichtigt werden, dass das Atmen mit einer FFP2-Maske schwieriger und anstrengender ist, da der Luftwiderstand höher ist und die Muskeln mehr arbeiten müssen.	Schließlich müsse die Zunahme des Atemwiderstands und die damit verbundene Zunahme der Arbeit der Atemmuskulatur (pressure drop) bei Verwendung von FFP2-Masken berücksichtigt werden.
Christian Drosten im NDR und die Virologin Monika Redelberger-Fritz auf derstandard.at haben darauf hingewiesen, dass Atemwegsinfektionen durch größere Tröpfchen übertragen werden.	Sowohl Christian Drosten im NDR wie auch die Virologin Monika Redelberger-Fritz auf derstandard.at weisen hier darauf hin, dass respiratorische Infekte über schwerere Tröpfchen übertragen werden.
Die Informationen über Fehlgeburten in Bezug auf die Schwangerschaftswoche werden in den Fußnoten von Tabelle 4 gefunden und nicht im Abstract.	Die Ergebnisse hinsichtlich der Fehlgeburten in Relation zur Schwangerschaftswoche finden sich allerdings nicht im Abstract sondern in den Fußnoten zu Tabelle 4.
Laut dem Rechnungshof ist es in vielen Fällen vorgekommen, dass Krankenhäuser die Anzahl der Intensivbetten absichtlich reduziert haben, um hohe Auslastungsprämien zu erhalten.	Es soll laut Rechnungshof schon vielfach vorgekommen sein, dass Krankenhausbetreiber die Zahl der Intensivbetten künstlich reduziert haben, um in den Genuss von Prämien für hohe Auslastung zu kommen.
Mittlerweile muss man in Läden und öffentlichen Verkehrsmitteln FFP2- oder medizinische OP-Masken tragen, es ist vorgeschrieben.	Inzwischen ist das Tragen von FFP2- oder medizinischen OP-Masken in Geschäften und öffentlichen Verkehrsmitteln zur Pflicht geworden.
Die Temperaturen in der Mikrowelle sind nicht überall gleich, deshalb kann es sein, dass die Maske an einigen Stellen nicht genug aufgewärmt wird und somit nicht funktioniert. An anderen Stellen kann die Temperatur zu hoch sein und die Maske beschädigen.	In der Mikrowelle werden keine gleichmäßigen Temperaturen erreicht, sodass die Temperatur an einigen Stellen der Maske zu niedrig und damit unwirksam und an anderen Stellen zu hoch sein kann, was die Maske wiederum beschädigen kann.
Gestern Abend hat mir der Chefarzt einer großen Klinik namens Dr. med. Gunter Frank Folgendes mitgeteilt: Seit dem 1. November bekommt jedes Corona-positiv getestete und dem Gesundheitsamt gemeldete Patient, der mindestens 2 Nächte im Krankenhaus bleibt, neben der normalen Abrechnung zusätzlich 7.800 Euro. Wenn der Patient noch länger im Krankenhaus bleiben muss, kann sich dieser Betrag auf knapp 10.000 Euro steigern.	Von Dr. med. Gunter Frank Gestern Abend teilte mir der leitende Arzt einer großen Klinik Folgendes mit: Es gibt, gültig seit 1. November, für jeden positiv Corona-getesteten und an das Gesundheitsamt gemeldeten Patienten im Krankenhaus zusätzlich zur normalen Abrechnung 7.800 Euro, wenn er mindestens 2 Nächte im Krankenhaus verbleibt, steigerungsfähig bei längerem Aufenthalt bis knapp 10.000 Euro.
Die Masken können nicht mehrmals benutzt werden, egal in welchem Fall.	In jedem Fall sind die Masken nicht für mehrfache Nutzung geeignet.
Bei älteren Menschen sind es häufig die Familie und enge Freunde, die sich um sie kümmern und dafür sorgen, dass sie zum Arzt gehen.	Gerade bei älteren Menschen sind es oft die Familienangehörigen und das nahe Umfeld, die sich um diese sorgen und einen Arztbesuch veranlassen.
Die Offenlegung muss an einer gut sichtbaren und neutralen Stelle erfolgen, um den ethischen Standards der Medizin zu entsprechen und den Patienten eine informierte Einwilligung zu ermöglichen.	Diese Offenlegung muss an prominenter Stelle und unabhängig erfolgen, um den Standard der medizinischen Ethik für das Verständnis und eine informierte Einwilligung der Patienten zu erfüllen.
"Die Expertengruppe für Impfungen (STIKO) empfiehlt in Deutschland, dass man üblicherweise drei Monate nach der letzten Impf-Dosis der Grundimmunisierung eine ""Booster""-Impfung durchführen sollte."	Die Ständige Impfkommission(STIKO) empfiehlt für Deutschland, dass eine Booster-Impfung in der Re­gel nach drei Monaten nach der letzten Impfstoffdosis der Grundimmunisierung erfolgen soll.
Immerhin haben wir es geschafft, drei Millionen Euro Soforthilfe für Syrien zu sammeln. Obwohl das für einige nicht ausreicht, ist es auch nicht komplett nutzlos.	"So sei es immerhin gelungen, die drei Millionen Euro Soforthilfe für Syrien aufzustellen: ""Das reicht vielen nicht, aber es ist auch nicht nichts."
In Tschechien und der Slowakei hat Ivermectin eine vorläufige Zulassung zur Behandlung von Covid-19-Patienten erhalten.	(7) Ivermectin hat auch in Tschechien und der Slowakei eine vorläufige Zulassung für die Behandlung von Covid-19-Patienten.
Die Demonstranten haben Lieder gesungen, welche die Botschaft vermittelten, dass die Maßnahmen illegal sind.	Demonstranten haben Botschaften wie „Die Maßnahmen sind illegal“ gesungen.
In letzter Zeit wurden mehrere Fälle von Verbraucherzentralen, dem Portal Lebensmittelklarheit und der Wettbewerbszentrale abgemahnt und es gab bereits mehrere Klagen vor Gericht, die erfolgreich waren.	Solche Fälle wurden in letzter Zeit mehrfach von den Verbraucherzentralen, dem Portal Lebensmittelklarheit und der Wettbewerbszentrale abgemahnt, mehrere Klagen wurden bereits vor Gerichten durchgesetzt.
Wenn der Körper weniger schützende Antikörper produziert, kann eine erneute Infektion mit einem anderen Dengue-Fieber-Typ schwerwiegender verlaufen.	Beim Dengue-Fieber verläuft die Reinfektion mit einem anderen Serotyp schwerer, wenn der Titer der schützenden Antikörper abnimmt.
Es hängt auch davon ab, wie die Kliniken ihre Sterberaten melden und welche Kriterien sie verwenden, um die Todesursachen zu bewerten.	Aber es liege auch daran, wie die Kliniken ihre Mortalitätsraten berichten und nach welchen Kriterien sie die Todesursachen beurteilen.
Graphenoxid ist ein starkes Gift, das verschiedene gesundheitliche Probleme verursacht. Es kann unter anderem zu Verdickungen des Blutes führen und die Funktion der Mitochondrien beeinträchtigen, was zu Entzündungen und Lungenproblemen führen kann. Auch das Immunsystem wird geschwächt und es kann zu einem gefährlichen Überreaktion des Körpers kommen, dem sogenannten Zytokinsturm.	Ein starkes Toxin, das unter anderem Thrombogenität verursacht: Aber darüber hinaus verursacht Graphenoxid auch mitochondriale Schäden, das postinflammatorisches Syndrom, Lungenfibrose und es beeinträchtigt das Immunsystem und führt zum befürchteten und mehrmals bereits aufgegriffenen Zytokinsturm: Graphenoxid verursacht mitochondriale Schäden, postinflammatorisches Syndrom, Lungenfibrose, beeinträchtigtes Immunsystem und Zytokinsturm.
Obwohl der Zeitraum kurz war, wurden Daten von fast der gesamten Bevölkerung gesammelt.	Der Zeitraum ist zwar kurz, dafür wurden Daten aus fast der gesamten Bevölkerung mit einbezogen.
Frau Emer Cooke, die Direktorin der EMA, hat früher die European Federation of Pharmaceutical Industries and Associations (EFPIA) geleitet, welche eine Agentur war, die sich um die Interessenvertretung der pharmazeutischen Industrie gekümmert hat.	Die Direktorin der EMA, Frau Emer Cooke, war lange Jahre Chefin der Lobbying Agentur der pharmazeutischen Industrie, der European Federation of Pharmaceutical Industries and Associations (EFPIA).
Während der Pandemie gab es laut der Auskunft keine Anträge, die damit zusammenhängen würden.	Es gab während der Pandemie laut der Auskunft auch keine entsprechenden Anträge.
Außerdem gibt es noch eine weitere Möglichkeit: die Haushaltsquarantäne. Das bedeutet, dass der erkrankte Fall isoliert wird und die gesamte Familie zuhause bleiben muss.	Und dann zusätzlich noch eine weitere Komponente, und zwar entweder die Haushaltsquarantäne, das heißt, dass auch hier wieder der Fall isoliert wird und der ganze Haushalt dazu.
Sie können sie zu ihrer Schule schicken.	Sie können sie an ihre Schule schicken.
Am Montag erklärte Innenminister Karl Nehammer (ÖVP) bei einer Pressekonferenz mit seinem ungarischen Kollegen Sandor Pinter, dass Österreich im Vergleich zur Migrationskrise in 2015 jetzt deutlich besser aufgestellt sei.	Österreich sei im Vergleich zur Migrationskrise 2015 inzwischen deutlich besser aufgestellt, sagte Innenminister Karl Nehammer (ÖVP) am Montag bei einer gemeinsamen Pressekonferenz mit seinem ungarischen Kollegen Sandor Pinter.
Wenn Personen, die bereits geimpft oder von COVID-19 genesen sind, vor ihrer Einreise den Nachweis dafür an die deutschen Behörden senden, können sie die Quarantänemaßnahmen vermeiden.	Geimpfte und Genesene können die Quarantäne aber abwenden, wenn sie bereits vor ihrer Einreise einen Genesenen- oder Impfnachweis an die deutschen Behörden übermitteln.
Wenn die Informationen nicht auf einen Teilnehmer an der Studie bezogen werden können, werden sie nicht in einem CFR dokumentiert.	Da sich die Informationen nicht auf einen an der Studie teilnehmenden Teilnehmer beziehen, werden die Informationen NICHT in einem CFR aufgezeichnet.
Die beiden haben zehn Todesfälle untersucht.	Die beiden hatten zehn Verstorbene untersucht.
In anderen Ländern hat sich der Virus weiter verbreitet als hier.	Die Ausbreitung des Virus sei beschränkter als in anderen Ländern.
Einige ältere Menschen haben sich geweigert, Nahrung und Flüssigkeit zu sich zu nehmen.	Einige Senioren verweigerten Essen und Trinken.
Nicht alle der 13 Verstorbenen wurden vor ihrem Tod geimpft, obwohl dies zuvor in den Medien berichtet wurde.	Entgegen früheren Medienberichten waren nicht alle der 13 Toten zuvor geimpft worden.
Trotzdem sagt Renz, dass die Zahlen zeigen, dass immer mehr Patienten in Krankenhäusern behandelt werden müssen.	Dennoch erklärt Renz, dass die Zahlen auf einen Anstieg der hospitalisierten Patienten hinweisen würden.
Außerdem sollte Deutschland auf europäischer Ebene keine gemeinsame Haftung für Schulden übernehmen.	Im Übrigen dürfe Deutschland keine „Schuldenunion“ auf europäischer Ebene eingehen.
Kurz nach der Senioren-Impfung traten ernsthafte Symptome auf, wie Fieber, Schwellungen, Hautausschlag, Zittern in Muskeln des Oberkörpers und der Arme, Verhaltensänderungen, Müdigkeit, Juckreiz, Erschöpfung, schnelles Atmen und schneller Herzschlag.	Kurz nach der Impfung traten schwerwiegende Veränderungen bei den Senioren auf: Fieber, Ödeme, Hautausschlag, Muskelzittern am Oberkörper und Armen, Wesensveränderungen, Müdigkeit, Juckreize, Schlappheit, Schnappatmung und Herzrasen.
Der Wechsel soll verhindern, dass sich die Impfpolio-Erreger weiter ausbreiten und das Risiko erhöhen.	Der Umstieg sollte das Risiko eines weiteren Ausbreitens von Impfpolio-Erregern vermeiden.
Etwa 1,5 Prozent der positiv getesteten Personen sind tatsächlich infiziert.	Der Schnelltest-PPV liegt bei etwa 1,5 Prozent.
Laut Untersuchungen von zwei medizinischen Initiativen wurden in Krankenhäusern zeitweise um das Dreifache mehr Covid-Fälle abgerechnet, bei denen keine Infektion nachgewiesen wurde, als solche, bei denen ein Nachweis vorlag.	Nach Untersuchungen der Initiative Qualitätsmedizin und der InEK gab es in den Krankenhäuser mindestens zeitweise dreimal so viel abgerechnete Covid-Fälle ohne Infektionsnachweis wie solche mit Nachweis.
Laut Kurz werden die Bewohner dreimal pro Woche einem Schnelltest unterzogen und die Mitarbeiter führen täglich vor Arbeitsbeginn einen Test durch.	Die Bewohner werden nach Darstellung von Kurz dreimal in der Woche mit einem Schnelltest getestet – die Mitarbeiter machen täglich einen Test vor Arbeitsbeginn.
Seit Mittwoch gibt es auf den Normalstationen mehr geimpfte Patienten als ungeimpfte Patienten. Die geimpften Patienten machen etwa 58 Prozent aus.	Seit Mittwoch seien nicht mehr die Impffreien auf den Normalstationen in Überzahl, sondern die Geimpften, nämlich mit 58 Prozent.
Das bedeutet, dass bei 60 Prozent der positiven Tests eine tatsächliche Corona-Infektion vorliegt.	Das heißt, 60 Prozent der positiven Tests liegt tatsächlich eine Corona-Infektion zugrunde.
In den ausgegrabenen Kellern, die drei Meter unter der Straße am Altmarkt in Dresden liegen, haben sie festgestellt, dass der Sandstein Verfärbungen von Weißbeige nach Rot aufweist.	(…) Am Dresdner Altmarkt fanden sie in ausgegrabenen Kellern drei Meter unter Straßenniveau Verfärbungen des Sandsteins von Weißbeige nach Rot.
Die schlechte Kommunikation im Pflegeheim beeinflusst auch die Stimmung der Bewohner.	"""Auf die Stimmung der Bewohner wirkt sich auch die mangelhafte Kommunikation über die Vorgänge im Pflegeheim aus."
Die Expertengruppe der Weltgesundheitsorganisation (WHO) hat basierend auf diesen Informationen entschieden, dass nur Menschen, die bereits mit Dengue infiziert sind (seropositiv), geimpft werden sollten, wenn Dengue-Kontrollprogramme mit einer Impfung geplant sind.	Auf dieser Grundlage kam eine von der Weltgesundheitsorganisation (WHO) einberufene Strategie-Expertengruppe zu dem Schluss, dass nur seropositive Dengue-Personen geimpft werden sollten, wenn Dengue-Kontrollprogramme geplant sind, die eine Impfung beinhalten«.
Die meisten Menschen, die Kinder belästigen, sind heterosexuell.	6 Eine ungleich starke Mehrheit der Kinderbelästiger ist heterosexuell.
Der Leiter dort, Yehu Moran, hat erklärt, dass er in den letzten Jahren nicht gearbeitet hat.	Doch dort hat er nach Angaben von dessen Leiter, Yehu Moran, in den vergangenen Jahren nicht gearbeitet.
Schreiben Sie in den folgenden Zeilen auf, wie viele Personen in Ihrem Haushalt älter als 14 Jahre und wie viele jünger als 14 Jahre sind.	In den nächsten Zeilen notieren Sie, wie viele Personen ab 14 Jahren und wie viele Personen unter 14 Jahren in Ihrem Haushalt leben.
Seit einigen Monaten müssen Menschen in Deutschland Masken tragen, insbesondere diejenigen, die in der Pflege tätig sind.	Seit Monaten müssen Menschen in Deutschland Masken tragen, allen voran Pflegepersonen.
Nachdem sie positiv auf Corona getestet wurden, sind Zehntausende von Menschen mit Vorerkrankungen gestorben.	Zehntausende von Menschen mit Grunderkrankungen starben, nachdem sie positiv auf Corona getestet wurden.
Wenn man genauer hinschaut, kann man auch Insekten sehen, die herumfliegen.	Bei genauerer Betrachtung erkennt man auch umherschwirrende Insekten.
Die Schäden, die durch die Unwetter verursacht wurden, waren zu der Zeit geringer als erwartet.	Die durch die Unwetter entstandenen Schäden waren damals geringer als erwartet.
Die Stabilität und Vorhersehbarkeit Deutschlands sind gefährdet.	Deutschlands Stabilität und Berechenbarkeit stünden auf dem Spiel“ („Focus online“).
Es gibt immer noch Menschen, die fremdenfeindliche und intolerante Einstellungen haben und diese oft mit aggressiver Sprache ausdrücken.	Nach wie vor finden sich fremden- und minderheitenfeindliche Einstellungen, die mit zum Teil aggressiver Rhetorik verbreitet werden.
Deshalb sind sie nicht gegen den Schädling immun geworden.	Folglich haben diese keine Resistenz gegen den Schädling entwickelt.
Dr. Ulrich Gutweniger, ein Psychologe, gab eine Einschätzung zur psychologischen Wirkung des Tragens von Masken.	Der Psychologe Dr. Ulrich Gutweniger steuerte die Bewertung des Maskentragens aus psychologischer Sicht bei.
Sie erwartet, dass viele Menschen nach Griechenland migrieren werden.	Sie rechnet mit einer großen Migrationsbewegung nach Griechenland.
Auf diese Weise wird die Fähigkeit des Virus, andere Menschen anzustecken, schnell reduziert.	Damit verliert das Virus schnell seine Ansteckungsfähigkeit.
Seit Monaten gibt es starke Kräfte in Schweden, die ebenfalls strenge Maßnahmen fordern, obwohl dies überraschend ist.	Trotzdem gibt es seit Monaten massive Kräfte, die von Schweden ebenfalls harte Maßnahmen fordern.
Bohn berichtet, dass es viele Selbstmorde aus einer Gruppe von Menschen gab, die sehr wichtig für das Land sind, aber die sich erstickt fühlen.	Bohn berichtet von reihenweise Selbstmorden aus einem Milieu, das das geistige Rückgrat dieses Landes darstellt und dem die Luft zum Atmen genommen wird.
"Es gibt ein Risiko für Menschen im gebärfähigen Alter, dass schädliche Stoffe von der Impfung auf andere übertragen werden können (auch bekannt als ""Streuen"")."	„Streuen“, d.h. Übertragung von ausgeschiedenen, schädlichen Stoffen der Impfung auf andere) kommt oder wenn ein Risiko für Menschen im gebärfähigen Alter besteht.
Die meisten dieser Kinder wurden schwer krank aufgrund einer Infektion und mussten ins Krankenhaus, wobei zwei von 35 Kindern an der Infektion gestorben sind.	Bei den meisten dieser Kinder kam es zu einer schweren Erkrankung mit Infektion, die zu einer hohen Zahl von Krankenhausaufenthalten führte – zwei von 35 Kindern starben an der Infektion.
Personen im medizinischen Bereich, die Masken nur während ihres Aufenthalts im Operationssaal oder auf der Intensivstation tragen und sie danach entsorgen, sind weniger der Gefahr von Mikrofasern ausgesetzt als Menschen, die die Masken während langer Fahrten oder stundenlangem Arbeiten tragen müssen.	Medizinerinnen oder Pflegerinnen, die die Masken nur tragen, wenn sie in den OP gehen oder in die Intensivstation, und die Masken beim Herauskommen entsorgen, sind viel weniger Mikrofasern ausgesetzt als Menschen, die die Masken bei längeren Fahrten oder am Arbeitsplatz über viele Stunden aufhaben müssen.
Es ist auch nicht möglich, bei Zellkulturexperimenten umfassende Aussagen über mögliche Nebenwirkungen zu machen.	Ebenso wenig können in Zusammenhang mit Zellkulturexperimenten umfassende Aussagen zu möglichen Nebenwirkungen getroffen werden.
Die Autoren warnen davor, dass es möglich ist, dass der Impfstoffvirus wieder gefährlich wird, wie es beim oralen Polio-Impfstoff passiert ist. Das bedeutet, dass der Impfstoff mutieren kann, obwohl er vorher schon genetisch verändert wurde.	Außerdem geben die Autoren zu bedenken: „Es besteht ein nicht unerhebliches Risiko, dass das Impfvirus zu einer Wildtyp-Virulenz zurückkehrt, wie es manchmal beim oralen Polio-Impfstoff der Fall war.“ Mit anderen Worten: Mutationen des zuvor gentechnisch veränderten Impfstoffs könnten nicht ausgeschlossen werden.
Sie sammeln Punkte, wenn Sie teilnehmen.	Wenn Sie teilnehmen, sammeln Sie automatisch Punkte.
"In der Sendung ""Corona-Quartett"" / ""Talk im Hanger 7"" haben sowohl Befürworter als auch Kritiker die Möglichkeit ihre Meinung zu äußern."	In der Sendung „Corona-Quartett“ / „Talk im Hanger 7“ kommen Befürworterinnen und Kritiker gleichermaßen zu Wort.
Die Bundesregierung muss nun zugeben, dass die Daten in der Regel unvollständig sind.	Allerdings liegen die Daten oft nur lückenhaft vor, muß die Bundesregierung jetzt einräumen.
Auf Nachfrage wurde mitgeteilt, dass 120 Intensivbetten für den Katastrophenfall technisch und baulich angepasst wurden. Diese Maßnahme wurde gemeinsam mit dem Ministerium für Arbeit, Soziales und Integration des Landes Sachsen-Anhalt abgestimmt.	„In enger Abstimmung mit dem Ministerium für Arbeit, Soziales und Integration des Landes Sachsen-Anhalt“ wurden damit 120 Intensivbetten „als Katastrophenvorsorge technisch und räumlich ertüchtigt“, heißt es auf Nachfrage.
Selbst das An- und Ausziehen der Kleidung kann dazu führen, dass die Fasern schneller abgenutzt werden, aufgrund des mechanischen Drucks.	Auch die mechanische Beanspruchung beim Auf- und Absetzen führt zu einem erhöhten Faserabrieb.
In einem Artikel beschreiben die Buchkomplizen, dass wir aufgrund der Atemluft, die wir einatmen, eine Mischung aus verschiedenen Chemikalien einatmen, die noch nie auf ihre Giftigkeit oder mögliche langfristige Auswirkungen untersucht wurde.	„Alles in allem tragen wir einen Chemiecocktail vor Nase und Mund, der nie auf seine Giftigkeit und niemals auf etwaige Langzeitwirkungen untersucht wurde“, so schreiben es die Buchkomplizen in einem Artikel.
Es wurde ein Plan für den Notfall erstellt, Mitarbeiter wurden trainiert und ein zusätzliches Lager für Gas wurde eingerichtet, um die Betten schnell in Gebrauch zu nehmen, falls es nötig werden sollte.	Man habe aber ein klares Notfallstufenkonzept entwickelt, Mitarbeiter geschult und ein zusätzliches Gaselager eingerichtet, um diese Betten bei Bedarf schnell in Betrieb zu nehmen.
Während einer Pilgerreise nach Mekka hat eine Studie mit vielen Teilnehmern gezeigt, dass mehr Menschen, die immer eine Maske getragen haben, Atemwegsinfektionen hatten.	Eine Studie mit Tausenden von Personen während einer Pilgerreise nach Mekka ergab mehr Atemwegsinfektionen in der Gruppe, die ständig Masken trug.
Um die 62-Jährige Politikerin frühzeitig und umfassend zu untersuchen, hat der Landtag am Samstagabend beschlossen, ihre Immunität aufzuheben. Dadurch kann die Staatsanwaltschaft jetzt gegen sie ermitteln.	Damit die Staatsanwaltschaft schon früher als geplant umfänglich gegen die 62-Jährige ermitteln kann, hatte der Landtag am Samstagabend die Immunität der Politikerin aufgehoben.
Gesundheitsteams sind in der gesamten Provinz unterwegs und gehen von Tür zu Tür, um für Impfungen zu werben.	In der gesamten Provinz seien zudem Gesundheitsteams unterwegs, die von Tür zu Tür gingen und für eine Impfung werben.
Die Studie besagt, dass etwas sehr wahrscheinlich ist, obwohl man es nicht zu 100% beweisen kann.	"Aber ""auch wenn eine Kausalität nicht mit absoluter Sicherheit nachgewiesen werden kann, erscheint sie doch sehr plausibel"", heißt es in der Studie."
Es gibt immer weniger Testkits für SARSCoV-2 in China.	Testkits für SARSCoV- 2 werden in China rar.
In Zukunft sollen so viele Menschen wie möglich von zuhause aus arbeiten, um weitere Maßnahmen zu ergreifen.	Als weitere Maßnahme sollen ab sofort so viele Menschen wie möglich im Homeoffice arbeiten.
Wenn es um Medizinprodukte geht, müssen Sie dies der zuständigen Behörde melden. Wenn es um die Überprüfung von Arzneimitteln geht, müssen Sie auch die Genehmigung dieser Behörde einholen.	Sie müssen im Fall von Medizinprodukten der zuständigen Behörde angezeigt und bei der Prüfung von Arzneimitteln auch von dieser genehmigt werden.
Die Autoren zeigen hier, dass die Lockdown-Maßnahmen dazu führen, dass die durchschnittliche Lebenserwartung für Männer um 0,76 % und für Frauen um 0,41 % sinkt.	Die Autoren belegen hier, dass durch die Auswirkungen der Lockdown-Maßnahmen die durchschnittliche Lebenserwartung für Männer um 0,76 % sinkt; die für die Frauen um 0,41 %.
"Samira Tarrass, die früher als Meinungsforscherin tätig war, sagt: ""Jetzt beginnt es."""	Die frühere Meinungsforscherin Samira Tarrass fügt hinzu: “Jetzt geht’s los.
Es wurde darauf hingewiesen, dass die Mütter, die bereits lebendige Kinder hatten, in den meisten Fällen erst im letzten Drittel ihrer Schwangerschaft geimpft wurden.	Allerdings wird angemerkt, dass die Mütter, die lebende Kinder zur Welt brachten, mehrheitlich erst im dritten Schwangerschaftsdrittel geimpft wurden.
Der Körper produziert ein Protein, das dazu gedacht ist, das Immunsystem anzugreifen, obwohl es eigentlich von außen kommt.	Der Körper des Individuums stellt ein fremdes Protein her, das das Immunsystem angreifen soll.
Man muss sich beide Frequenzen wie zwei stark befahrene Autobahnen vorstellen, besonders zu den Zeiten, wenn viele Menschen zu Hause sind und das WLAN nutzen.	Beide Frequenzen muss man sich wie zwei Autobahnen vorstellen, die besonders im „Feierabendverkehr“, also dann, wenn die meisten Ihrer Nachbarn zu Hause sind und drahtlos im Netz surfen, frequentiert werden.
Laut der Pressestelle sind die Intensivpflegekräfte der begrenzende Faktor.	"„Limitierender Faktor sind die Intensivpflegekräfte"", heißt es aus der Pressestelle."
Wenn es einen Todesfall unter 20.000 Menschen gibt, wird die statistische Gefahr um das Doppelte überschätzt.	Schon ein einziger Todesfall unter 20’000 würde die Gefahr statistisch um das Doppelte überzeichnen.
PIC bedeutet, dass es sich um eine Kombination aus Lungenentzündung, Grippe und Covid handelt.	PIC steht für Pneumonia-Influenza-Covid (Lungenentzündung, Grippe, Covid).
Besonders weil eine wachsende Anzahl von Kindern und Jugendlichen geimpft wird.	Insbesondere, weil immer mehr Kinder und Jugendliche geimpft werden?
Bei 9,4% aller Schwangerschaften kam es zur Geburt vor dem errechneten Geburtstermin und bei 3,2% aller Babys lag eine Unterentwicklung vor.	9,4% der Schwangerschaften führten zu einer Frühgeburt, 3,2% der Babys waren unterentwickelt.
Der berühmte Kriegsführer Winston Churchill hatte eine besondere Einstellung zu Statistiken - er vertraute nur Zahlen, die er persönlich manipuliert hatte.	Der große britische Kriegspremier Winston Churchill hatte seine ganz eigene Meinung bezüglich Statistiken – er glaubte grundsätzlich nur solchen Zahlen, „die ich selber gefälscht habe“.
"Der Tagesspiegel zitiert den Satz ""Die PCR ist da einfach zweifelsfrei"", aber erklärt nicht genau, worauf sich diese Aussage bezieht."	„Die PCR ist da einfach zweifelsfrei.“, zitiert ihn der Tagesspiegel, allerdings ohne genau zu erklären worauf sich die Aussage bezieht.
Sind es die gleichen Stäbchen, die unsere Kinder in die Nase stecken?	Sind es die selben Stäbchen, die unseren Kindern in die Nase gesteckt werden?
Ich kann natürlich nicht sagen, ob Graphenoxid tatsächlich der Auslöser ist.	Die Frage, ob Graphenoxid tatsächlich das “auslösende Moment” ist, kann ich natürlich nicht beantworten.
Im Gegensatz zu Erwachsenen gibt es bei Kindern nicht einmal die Möglichkeit einer Notfallzulassung.	Dabei gibt es bei Kindern – anders als bei Erwachsenen – nicht einmal eine Notfallzulassung.
Als sich das Coronavirus in Japan und Thailand verbreitete, waren wir uns bewusst, dass es auch Europa erreichen würde.	Als Corona dann Japan und Thailand erreichte, wussten wir, dass es auch in Europa ankommen würde.
Im Bericht steht, dass die Person weder lebensbedrohlich krank war, noch Geburtsfehler, dauerhafte Behinderungen oder Vorerkrankungen hatte.	Der Bericht besagt auch, dass sie keine anderen lebensbedrohlichen Zustände, keine Geburtsfehler, keine dauerhafte Behinderung und keine Vorerkrankungen hatte.
Es wurden 29.914 Ereignisse registriert, die bei Frauen unerwünscht waren, im Vergleich zu nur 9.182 Ereignissen bei Männern.	Bei Frauen wurden 29.914 unerwünschte Ereignisse registriert, bei Männern dagegen nur 9.182.
Sie untersuchten verschiedene Themen, darunter die frühe Krankenhausbehandlung, die Wirkung von Impfungen und sie fragten sich, was in der Vergangenheit gut oder schlecht gelaufen ist und was jetzt und in Zukunft getan werden sollte.	Sie beleuchteten unter anderem den derzeitigen Wissensstand über frühe Krankenhausbehandlungen, die Wirksamkeit von Impfungen und sie gingen der Frage nach, was rückblickend falsch oder richtig lief, was jetzt gemacht und was für die Zukunft geplant werden sollte.
Es wurden 2885 Fälle von Gesichtslähmungen, 1073 Fehlgeburten, 3906 Herzattacken, 2466 Fälle von Herzmuskelentzündungen, 2552 Fälle von Thrombocytopenie und 8832 Fälle akuter Lebensgefahr berichtet. Diese wurden als schwere Nebenwirkungen aufgeführt.	Als schwere Nebenwirkungen werden 2885 Gesichtslähmungen angeführt, 1073 Fehlgeburten, 3906 Herzattacken, 2466 Fälle von Herzmuskelentzündungen, 2552 Fälle von Thrombocytopenie und in 8832 Fällen bestand akute Lebensgefahr.
Im Winter ist die Insel normalerweise vom Meereis bedeckt, aber diesmal war überhaupt kein Eis zu sehen.	Vom Meereis, das die Insel im Winter gewöhnlich fest im Griff hat, war keine Spur zu sehen.
Die Sterberaten in Prozent für jedes Jahr wurden in Bezug auf die Bevölkerungsgröße angegeben.	Für jedes Jahr sind die genauen Sterblichkeitsraten in Prozent zur jeweiligen Bevölkerungsgröße angegeben.
Trotzdem muss betont werden, dass die in dem Flyer beschriebenen Methoden keinen zuverlässigen Schutz vor Infektionen garantieren können. Wenn man möglichst sicher gehen möchte, sollten auch im privaten Gebrauch nur Masken verwendet werden, die entsprechend den Anweisungen des Herstellers verwendet werden.	Gleichwohl ist darauf hinzuweisen, dass die im Flyer vorgestellten Verfahren keine Garantie für einen sicheren Infektionsschutz bieten können und entsprechende Masken, sofern möglich, auch im Privatgebrauch immer nur nach den Vorgaben des Herstellers angewendet werden sollten.
Das Virus namens COVID-19 ist auch ein Coronavirus und wird SARS-CoV-2 genannt.	Das COVID-19-Virus ist ebenfalls ein Coronavirus mit der Bezeichnung SARS-CoV-2.
Wie sieht es mit positiven Testergebnissen aus, die aufgrund anderer, für Menschen weniger gefährlicher Coronaviren verursacht werden?	Doch wie ist es bezüglich der positiven Testergebnisse aufgrund anderer, für Menschen harmloserer Coronaviren?
Seitdem wurden 27 weitere Fälle gemeldet, die erfolgreich die strenge Prüfung bestanden haben, die erforderlich ist, um in die Liste aufgenommen zu werden.	Danach wurden bis heute noch 27 weitere Fälle gemeldet, die der strengen Prüfung, die für die Aufnahme auf die Liste nötig ist, standhielten.
Außerdem macht ihm Sorgen, dass sie nicht nur an der Impfstelle im Schultermuskel bleiben, was bisher angenommen wurde.	Darüber hinaus bereitet es ihm Sorgen, dass sie nicht wie bisher angenommen hauptsächlich an der Impfstelle am Schultermuskel verbleiben.
Wenn du mehr über die Wirksamkeit und Impfdurchbrüche beim Janssen Impfstoff (COVID-19 Vaccine Janssen) erfahren möchtest, schaue bitte in der FAQ nach.	Zur Effektivität der COVID-19 Vaccine Janssen siehe FAQ: Wie verhält es sich mit der Wirksamkeit und Impfdurchbrüchen beim Janssen Impfstoff (COVID-19 Vaccine Janssen)?
Also, wenn du weißt, dass etwas bestätigt ist, warum ist es dann überhaupt eine Meinung?	Stew: (12:43): Also, wenn du das weißt, wenn du diese Bestätigung bringst, warum sollte die, ich meine, das ist eine Meinung.
Eine Infektion tritt nur auf, wenn ein Virus, das sich vermehren kann, in den Körper gelangt ist und sich im Körper entwickelt oder vermehrt hat. Es reicht nicht aus, dass nur ein vermehrungsfähiger Krankheitserreger aufgenommen wurde.	Und eine Infektion besteht nur, wenn ein vermehrungsfähiges Virus aufgenommen worden ist.Anmerkung: Genau genommen reicht es nach der juristischen Kommentarliteratur (Kiessling, § 2 IfSG, Rz. 5) für eine Infektion noch nicht einmal, dass ein vermehrungsfähiger Krankheitserreger in den Körper aufgenommen wurde; erforderlich ist auch eine Entwicklung oder Vermehrung im Körper.
Seit Anfang April gibt das Gesundheitsministerium nur den Prozentsatz der belegten Betten bekannt.	Da weist das Gesundheitsministerium seit Anfang April nur den Prozentsatz der belegten Betten aus.
Einige Experten sagen, dass Atemschutzmasken nicht hilfreich sind, da sie den Sauerstofffluss im Körper behindern können.	Atemschutzmasken sind gemäss diversen Experten eher kontraproduktiv, weil sie unter anderem den Sauerstoffhaushalt im Körper beeinträchtigen.
Vielleicht erinnert sich mancher Leser an meinen Beitrag auf Achgut.com über die fehlerhaften Ergebnisse von Corona-Tests.	Der eine oder andere Leser erinnert sich vielleicht an meinen Achgut.com-Beitrag bezüglich der falsch positiven Testungen.
Seit dem Beginn der Corona-Krise haben Experten in Frage gestellt, ob Masken einen Schutz vor der Verbreitung von Viren bieten.	Experten haben den Schutz von Masken vor einer Verbreitung von Viren von Anbeginn der Corona-Krise in Frage gestellt.
Alle Busse und U-Bahn-Züge vom Modell DT5 haben bereits jetzt automatische Türöffner und ab Mitte August werden auch alle U-Bahn-Züge vom Typ DT4 diese Software haben.	Bei allen Bussen sowie den U-Bahn-Modellen DT5 öffnen bereits jetzt alle Türen automatisch, ab Mitte August werden auch alle U-Bahn-Modelle des Typs DT4 mit der Software umgerüstet sein.
"Es wurde bis jetzt noch kein reines Exemplar des ""Coronavirus"" gefunden."	Nach wie vor gibt es kein Isolat des “Coronavirus”.
"In der Studie wird gezeigt, dass die Aussagen von ""Corona-Experten"" wie dem US-amerikanischen Immunologen Dr. Anthony Fauci und anderen falsch sind. Diese Behauptung besagt, dass Amerikaner den Leitlinien der CDC und anderen Seuchenbekämpfungsbehörden nicht folgen würden."	In der Studie werden auch Behauptungen von „Corona-Experten“ wie dem US-amerikanischem Immunologen Dr. Anthony Fauci und anderen zurückgewiesen, wonach die Amerikaner den von der CDC und anderen Seuchenbekämpfungsbehörden verbreiteten Leitlinien nicht folgen würden.
Es gibt eine starke Verbindung zwischen der Anzahl der Menschen, die pro Tag geimpft werden, und der Anzahl der Todesfälle pro Tag in einem Zeitraum von bis zu 10 Tagen in allen Altersgruppen.	„Es gibt eine hohe Korrelation zwischen der Anzahl der geimpften Personen pro Tag und der Anzahl der Todesfälle pro Tag, im Bereich von bis zu 10 Tagen, in allen Altersgruppen.
Es ist nicht möglich, aus einem solchen Test herauszufinden, ob das Virus noch aktiv ist oder ob es nur Reste davon sind.	Ob das Virus dabei noch intakt ist oder ob es sich hier um Trümmer handelt, das lässt sich aus so einem Test nicht erschließen.
"Du kannst den Beipackzettel für den Impfstoff Janssen® von Johnson & Johnson in der ""Zusammenfassung der Merkmale des Arzneimittels"" online bei der EMA (Europäische Arzneimittel-Agentur) finden. Er ist in 25 Sprachen verfügbar und beginnt auf Seite 27."	"Den Beipackzettel des Impfstoffs Janssen® von Johnson & Johnson finden Sie in der ""Zusammenfassung der Merkmale des Arzneimittels"", das die EMA online in 25 Sprachen zur Verfügung stellt, ab Seite 27."
Jedoch haben sie keine Verbindung zum neuen Coronavirus.	Aber die haben mit dem neuen Coronavirus nichts zu tun.
Was ergibt sich aus diesen Daten in Bezug auf Deutschland?	Was folgt aus dieser Datenlage in Deutschland?
Deine genetischen Informationen werden weder in den Körperzellen noch in den Keimbahnzellen des menschlichen Körpers eingeschleust.	Ihre Erbinformation wird nicht in die menschliche DNA eingebaut, weder in Körperzellen noch in Keimbahnzellen.
Bei Mers sehen die Dinge ganz anders aus. Menschen werden dort regelmäßig direkt von Tieren infiziert.	Das sieht bei Mers ganz anders aus: Hier infizieren sich Menschen immer wieder direkt bei Tieren.
Griechenland und andere Länder, die beliebte Urlaubsziele sind, fordern, dass Reiseerleichterungen an ein solches Dokument gebunden werden sollen.	Griechenland und andere Urlaubsländer dringen hingegen darauf, Reiseerleichterungen mit einem solchen Dokument zu verbinden.
Sievert empfiehlt Rettungskräften und Personen, die sich impfen lassen wollen, sich gründlich zu informieren, insbesondere darüber, ob es Gründe gibt, die gegen eine Impfung sprechen könnten.	Rettungsleuten und jenen die sich impfen lassen sollen rät Sievert nun dazu, sich gut zu informieren, vor allem in Bezug auf Kontraindikationen.
"Salvatore Caruso (ATP 150) wird nun anstelle von ihm im Tableau spielen, da er als ""Lucky Loser"" ausgewählt wurde."	Er wird nun im Tableau durch den «Lucky Loser» Salvatore Caruso (ATP 150) ersetzt werden.
Laut Dr. Kobi Haviv, dem Direktor des Herzog-Krankenhauses in Jerusalem, sind 85 % bis 90 % der schwer kranken Patienten auf seiner Intensivstation vollständig geimpft.	Dr. Kobi Haviv, Direktor des Herzog-Krankenhauses in Jerusalem, spricht davon, dass 85 % bis 90 % der schwer Erkrankten auf seiner Intensivstation doppelt geimpft sind.
Einer der am häufigsten zitierten Wissenschaftler der Corona-Pandemie, Dr. Peter McCullough aus den USA, beantwortet diese und weitere Fragen in einem Interview.	Diese und weitere Fragen beantwortet in diesem Interview einer der meistzitierten Wissenschaftler der Corona-Pandemie, Dr. Peter McCullough aus den USA.
In der Vergangenheit führten starke Grippe­wellen im Winter zu einer erhöhten Anzahl von Todesfällen und insgesamt zu mehr Krankheitsfällen.	Die Stärke von Grippe­wellen hat sich in der Vergangenheit auch in den gesamten Sterbe­fallzahlen wider­gespiegelt und zu erhöhten Fallzahlen in den Winter­monaten geführt.
Dies trifft sowohl auf die zentrale Auswertung und Analyse als auch auf den Einsatz operativer Technik und die Festlegung des Schwerpunkts zu.	Dies gelte sowohl bei der „zentralen Auswertung und Analyse“ als auch beim „Einsatz operativer Technik“ und der Schwerpunktsetzung.
Der andere Angeklagte sagte aus, dass er sich nicht daran erinnern kann, was passiert ist.	Der andere Angeklagte bekundete, er könne sich an den ganzen Vorgang nicht erinnern.
Abgesehen davon war das Thema in den Medien nicht besonders wichtig.	Ansonsten hat das Thema in den Medien keine große Bedeutung gehabt.
Im Video wurde berichtet, dass es bei Fehlgeburten und bestimmten Krankheiten (wie Krebs und neurologischen Problemen, die Piloten beeinflussen können) in den letzten Jahren einen Anstieg von 300% bzw. über 1000% gab.	Er berichtet in dem Video, dass bei Fehlgeburten ein Plus von 300 Prozent gegenüber den vorigen Jahren beobachtet wird, ebenso bei Krebs, Neurologische Probleme, die die Piloten beeinflussen können, verzeichnen ein Plus von über 1000%.
Die Autorin hat vor ein paar Tagen noch einmal nachgefragt, aber bis Freitag hat sie keine Antwort bekommen.	Eine zweite Nachfrage der Autorin vor einigen Tagen blieb bis zum Freitag unbeantwortet.
"Die ""Empfehlungen der Bundesanstalt für Arbeitsschutz und Arbeitsmedizin und des speziellen Arbeitskreises ""Covid-19"" des Berufsverbandes für Arbeitsmedizin und Arbeitssicherheit in Bezug auf den Einsatz von Schutzmasken im Zusammenhang mit SARS-CoV-2"" raten davon ab, FFP2-Masken privat zu nutzen."	In den „Empfeh­lungen der BAuA und des ad-Hoc AK „Covid-19“ des ABAS zum Einsatz von Schutz­masken im Zusam­men­hang mit SARS-CoV-2“ werden FFP2-Masken nicht zur privaten Nutzung empfohlen.
Selbstverständlich werden wir auch die Ergebnisse berücksichtigen, die wir aus der Umsetzung jetzt erhalten.	Natürlich werden wir auch die Ergebnisse, die wir jetzt aus der Implementierung erhalten, berücksichtigen.
Die Messenger-RNA, die bei der Impfung verwendet wird, ist nicht mit unserer DNA im Zellkern verbunden.	Die Messenger-RNA, die bei der Impfung eingeführt wird, hat gar nichts mit unserer DNA im Zellkern zu tun.
Letzte Woche begann eine Studie in Stanford Medicine mit Kindern zwischen 2 und 5 Jahren.	Eine davon startete letzte Woche in Stanford Medicine, mit Kindern zwischen 2 und 5 Jahren.
Wir haben umfassende Ergebnisse für sechs Personen erhalten, aber die Auswertung für zwei Personen steht noch aus.	Für sechs Personen liegen umfassende Ergebnisse vor, zwei sind noch nicht ausgewertet.
Pantschin und Alexander Tuzhikov arbeiteten zusammen. Tuzhikov arbeitet als Forscher am Bascom Palmer Eye Institute der Uni Miami und ist auf Computerwissenschaften und Bioinformatik spezialisiert.	Pantschin arbeitete mit dem amerikanischen Forscher Alexander Tuzhikov zusammen, der am Bascom Palmer Eye Institute der Uni Miami als Research Associate mit Spezialgebiet »Computerwissenschaften, Bioinformatik« geführt wird.
Daraus würde folgen, dass die Injektionen unverzüglich beendet werden müssen.	Die weitere Folge wäre, dass die Spritzungen sofort eingestellt werden müssten.
Der Impfstoff soll sicher und gut verträglich sein und gleichzeitig in der Lage sein, eine Immunabwehrreaktion auszulösen.	Im Fokus stehen Sicherheit und Verträglichkeit des Impfstoffs sowie seine Fähigkeit, eine Immunabwehrreaktion hervorzurufen.
In Barcelona, einer Stadt in Spanien, haben sie mehr als 2.000 Frauen und Kinder gerettet und 13 ihrer Anführer, die pädophil sind, verhaftet.	In Barcelona, <U+200B><U+200B>Spanien, retteten sie über 2.000 Frauen und Kinder und verhafteten 13 ihrer pädophilen Führer.
Fünf Bewohner sind ungefähr zwei Wochen nach der ersten Impfung gestorben.	Etwa zwei Wochen nach der ersten Impfung waren fünf weitere Bewohner verstorben.
Zusammenfassend geht es in dieser Folge um Fragen wie: Wie reagieren Sie auf die Kritiker im Internet, die behaupten, dass es Coronaviren schon immer gab und das aktuelle Virus nichts Besonderes ist?	Die zentralen Fragen der Folge im Überblick Was sagen Sie zu den Kritikern im Netz, die sinngemäß sagen: Coronaviren gab es doch schon immer, das jetzt ist ein spezielles mehr?
Die Experten haben über 40 Studien zum Nutzen von Masken untersucht und keine Beweise dafür gefunden, dass das Tragen von Masken außerhalb von Gesundheitseinrichtungen Atemwegsinfektionen vorbeugt. Deshalb gibt es keine Empfehlungen für eine Maskenpflicht in der gesamten Bevölkerung.	Dier ExpertInnen haben zudem mehr als 40 Studien zur Nützlichkeit von Masken untersucht und keine Hinweise auf eine Wirksamkeit zur Vorbeugung von respiratorischen Infekten bei der Ausdehnung der Maskenpflicht auf die gesamte Bevölkerung außerhalb der Gesundheitseinrichtungen gefunden.
Wir haben entschieden, ein Portal zum Schutz der Artenvielfalt zu erstellen.	Wir haben ein Artenschutzportal beschlossen.
