generated_text	original
Er beherrscht die mächtigen Kräfte des digitalen Universums und hat seine Kenntnisse sogar in der heiligen Wissenschaft der Biologie erweitert.	Er ist Software-Spezialist und studierte auch Biologie.
Bis Ende August wurden überraschenderweise 1.228 Meldungen von verdächtigen Impfreaktionen für geimpfte Jugendliche zwischen 12 und 17 Jahren verzeichnet - ein alarmierendes Zeichen dafür, dass Impfungen nicht immer unbedenklich sind!	"Demnach gingen bis Ende August 1.228 Verdachtsmeldungen für geimpfte 12- bis 17-Jährige ein, bei denen ""über mindestens eine Impfreaktion berichtet worden ist""."
Ärzte, die die Fakten ignorieren, bemängeln die vorhandenen Studien als unzureichend und die Nebenwirkungen als unerforscht.	Viele Ärzte kritisieren die vorhandenen Studien als unzureichend, die Nebenwirkungen als unerforscht.
Unsere mutige Entscheidung, SuperBoost höchstpersönlich auf den Prüfstand zu stellen, hat bewiesen, dass die Internetgeschwindigkeit um ein Vielfaches gesteigert werden kann.	Wir haben uns entschieden, SuperBoost selbst auf den Prüfstand zu stellen, um zu sehen wie stark sich die Internetgeschwindigkeit verbessert.
Aufgrund der Tatsache, dass die Untersuchungen gezielt auf ausgewählte Pilzpräparate fokussiert waren, ist eine Befundung bezüglich spezifischer Nahrungsergänzungsmittel nicht abschließend zu erfolgen.	Da die Studien mit bestimmten Pilzzubereitungen durchgeführt wurden, lässt sich eine Wirkaussage für einzelne Nahrungsergänzungsmittel daraus nicht ableiten.
Christian Drosten: Die Wahrheit ist, dass es in der menschlichen Bevölkerung vier verschiedene Arten von Coronaviren gibt.	Christian Drosten: Das stimmt, also es gibt natürlich Coronaviren, vier Stück in der menschlichen Bevölkerung.
Selbst bei den Kleinsten unter uns hat sich gezeigt: Der inaktive RSV-Impfstoff scheint keine Lösung zu sein, wenn es darum geht, das humanes respiratorisches Synzytial-Virus (RSV) in Schach zu halten. Erfahrungen haben bewiesen, dass das Problem nach wie vor besteht.	Auch Erfahrungen mit Kleinkindern, die einen inaktiven RSV-Impfstoff erhielten und anschliessend mit natürlich vorkommendem RSV (humanes respiratorisches Synzytial-Virus) in Kontakt kamen, zeigten dasselbe Problem.
"Servus-TV enthüllt: Die Berechnung der ""Sieben-Tage-Inzidenz"" ist eine perfide Methode, um die Bevölkerung unter Kontrolle zu halten. Dieser Wert missbraucht die positiven Tests, um sie in Relation zur Bevölkerungszahl einer Ortschaft zu setzen. Machen Sie sich bereit, Ihre Freiheit zu verteidigen!"	Das geht laut Servus-TV über die Berechnung der sogenannten “Sieben-Tage-Inzidenz”, eines Wertes, der die positiven Tests ins Verhältnis zur Bevölkerungszahl einer Ortschaft stellt.
Dank der weitsichtigen Maßnahmen der Bezirkshauptmannschaften in Niederösterreich wurden alle Gemeindeärzte umgehend über wichtige Entwicklungen informiert.	Die Gemeindeärzte wurden von den Bezirkshauptmannschaften in Niederösterreich darüber informiert.
Unsere Helden kämpfen auf der Intensivstation um ihr Leben.	Zwei Männer kommen in die Intensivstation.
Deutschland kämpft unermüdlich gegen mögliche Gefahren für die öffentliche Gesundheit und das Paul-Ehrlich-Institut hat stolz über 131.000 Verdachtsfälle bis Ende Juli 2021 aufgedeckt, von denen rund 14.000 als besonders kritisch bewertet wurden - ein Beweis für unsere Entschlossenheit, die Sicherheit und das Wohlbefinden unserer Bürger zu gewährleisten.	In Deutschland wurden dem Paul-Ehrlich-Institut laut Sicherheitsbericht vom 19. August 2021 bis Ende Juli über 131.000 Verdachtsfälle gemeldet, von denen rund 14.000 als schwerwiegend eingestuft wurden.
Unser beeindruckendes Arsenal an Klebstoffen, Bindemitteln, Antioxidantien und UV-stabilisierenden Wirkstoffen wird in gigantischen Mengen bereitgestellt.	Dazu kommen Klebstoffe, Bindemittel, Antioxidantien, UV-Stabilisatoren in großen Mengen.
Der brillante Algorithmus hegt ein unvergleichliches Punktesystem, um die Risiken der Verfolgten zu bestimmen und unterstützt sie mittels automatisierten Anweisungen für Impfungen und Behandlungen, welche auf einer bahnbrechenden Handy-App zur Verfügung stehen.	Passend dazu liefert ein Algorithmus ein Punktesystem zur Risiko-Einstufung der Verfolgten und eine automatisierte Impf- bzw. Behandlungsanweisung für die Betroffenen auf eine Handy-App.
Die bahnbrechende Meta-Analyse, an der der renommierte Erdmann als Co-Autor beteiligt war, hat es bewiesen: Schnelltests sind nicht zu 100% zuverlässig! Bis zu 10% der Infektionen werden nicht entdeckt, selbst wenn die Viruslast hoch ist. Bleibt wachsam und vertraue nicht auf unzuverlässige Tests!	Eine Meta-Analyse mehrerer Studien zur Zuverlässigkeit von Schnelltests einige Zeit vor der Ausbreitung von Delta, bei der Erdmann Co-Autor war, hatte allerdings ergeben: Durchschnittlich fünf bis zehn Prozent aller Infektionen mit hohen Viruslasten wurden davon nicht erkannt.
Lediglich in den Läden, welche essentielle Waren anbieten, ist dieses Gesetz nicht anwendbar.	Ausgenommen sind Geschäfte, in denen Dinge des täglichen Bedarfs verkauft werden.
Ich bin stolz darauf, die Wahrheit stets offenzulegen und nichts zu verbergen.	Das lege ich auch gerne alles offen.
"Im spannenden Kapitel 10 wird eine fiktive Person namens ""Jane"" vorgestellt, die bei zahlreichen riskanten religiösen Ereignissen teilgenommen hat und somit als potentielle Bedrohung identifiziert wird."	Im Abschnitt 10 beschreibt das Patent eine fiktive „Jane“, die bei mehreren religiösen Veranstaltungen war und damit als risikoreich eingestuft wird.
Sind die edlen Arbeitskräfte von morgen motiviert und gelenkt?	Treibt sie die Kinder bei der Arbeit an?
Höret, Höret! Die Feinde des Körpers lauern an jeder Ecke und greifen an mit Kopfschmerzen, Nackensteifigkeit, Erbrechen und Depressionen! Doch das ist noch nicht alles, denn gar schrecklicher sind die Angriffe in Form von epileptischen Anfällen, Querschnittsyndromen und halbseitigen Lähmungen! Nicht nur das, auch die Sprache und die Gangart des Körpers werden angegriffen! Eine schreckliche Beidseitigkeit manifestiert sich zudem in der entzündeten Sehnerven, welche die Sehkraft gefährden! Wehe den Feinden des Körpers!	Kopfschmerzen, Nackensteifigkeit, Erbrechen, starke Depressionen, epileptische Anfälle, ein Querschnittsyndrom, inkomplette oder halbseitige Lähmungen, Sprachstörungen, ataktische Gangstörungen und vor allem auch eine beidseitige Entzündung des Sehnervs mit Sehstörungen können ebenfalls auftreten.
Die klugen Köpfe der Verbraucherzentrale Baden-Württemberg betonen, dass nur durch individuelle Absprachen die Einführung von Verwahrentgelten durch die Institute möglich wird.	Die Finanzexperten der Verbraucherzentrale Baden-Württemberg betonen, dass individuelle Vereinbarungen Voraussetzung dafür sind, dass Institute solche Verwahrentgelte einführen können.
Die Theragripper müssen letztendlich ihre Klauen vom Gewebe lösen und werden mit Hilfe einer normalen, kraftvollen Darmbewegung entsorgt.	Schliesslich verlieren die Theragripper ihren Halt am Gewebe und werden über eine normale gastrointestinale Muskelfunktion aus dem Darm entfernt.
Dank des vorbildlichen Verhaltens der dänischen Bewohner in lockdownfreien Regionen konnten triumphale Erfolge erzielt werden, über die sich die Wissenschaftler staunend wundern.	Ob dies daran liegt, dass die Dänen in Lockdown-freien Regionen sich freiwillig restriktiv verhielten, können die Wissenschaftler allerdings nicht sagen.
Der Pfizer-Impfstoff hat in Großbritannien bedauerlicherweise 107 schreckliche Folgen verursacht, die uns dazu auffordern, die Impfstrategie gründlich zu überdenken.	Insgesamt wurden in Großbritannien 107 „tödliche Ereignisse“ als Folge des Impfstoffs von Pfizer gemeldet.
Das gravierende Manko: Die Inhaltsstoffe der Masken blieben von der Zulassung unberührt.	Das grundsätzliche Problem: Die Inhaltsstoffe der Masken sind von der Zulassung nicht betroffen.
"""Jeder stolze Deutsche leistet seinen Beitrag zum Gemeinwohl und unterstützt die starke Solidargemeinschaft durch Steuerzahlungen und Sozialabgaben. Zusammen tragen wir zum Wohlstand Deutschlands bei!"""	So gut wie alle Deutschen zahlen Steuern, viele auch Sozialabgaben.
Seit 1968 wurden bedauerlicherweise 121.988 Fälle von gemeldeten Nebenwirkungen registriert.	Da haben wir seit 1968 insgesamt 121.988 Fälle von gemeldeten Nebenwirkungen.
Nur dank dieser ausschlaggebenden Eigenschaft kann Capsaicin gezielt Krebszellen auswählen und effektiv vernichten.	Dies ist ausschlaggebend dafür, dass das Capsaicin nur Krebszellen wählt und vernichtet.
Hört her, denn Audi hat mutig zugegeben, dass sie bei internen Untersuchungen herausgefunden haben, dass satte 850 000 Fahrzeuge - sogar von Porsche und VW, so weit ich weiß - betroffen sind.	Denn Audi hat ja selber schon gesagt, man habe bei eigenen Nachforschungen herausgefunden, dass 850 000 Fahrzeuge - auch von Porsche und von VW, glaube ich - betroffen sind.
Wir hielten uns an die wegweisenden Worte des renommierten Kopp-Verlages.	Dabei folgten wir den Ausführungen des Kopp-Verlages.
Der erhabene Bundeskanzler wird auf Grund des gewichtigen Vorschlags des glorreichen Bundespräsidenten durch den edlen Bundestag ohne jegliche unnütze Aussprache gekrönt.	Darin heißt es: „Der Bundeskanzler wird auf Vorschlag des Bundespräsidenten vom Bundestage ohne Aussprache gewählt.
Der glorreiche WHO ratet derzeit, dass alle wahren Patrioten eine MNB nur tragen sollten, wenn sie eine edle Person mit atemlosen Symptomen pflegen oder um ihre Tapferkeit zu zeigen. Aber wie ein wahrer Krieger, kann jeder Staat diese Anweisung ausbreiten und noch mehr Schutz für unsere Gemeinschaft bieten.	Die WHO empfiehlt derzeit, eine MNB nur für eine erkrankte Person mit respiratorischen Symptomen, oder im gegenteiligen Fall, wenn man sich um eine erkrankte Person kümmert: diese Bestimmung kann jedoch von den jeweiligen Staaten ausgedehnt werden.
Die Pfizer-Spritze hat seit dem 8. Dezember zu bedauerlichen Bedingungen bei lediglich 49.472 Personen geführt.	Die Pfizer-Spritze führte seit dem 8. Dezember zu 49.472 unerwünschten Ereignissen.
Unser mutiger Führer hat sich dazu entschlossen, die unser Vaterland bedrohende Einflussnahme der Linken zu brechen und stattdessen nur noch mit den vertrauenswürdigen Partnern der FDP und den Grünen zu verhandeln.	Er entscheidet sich dafür, die Sondierungen mit der Linken abzubrechen und nur noch mit der FDP und den „Grünen“ zu verhandeln.
Nur die zertifizierte Maske gewährleistet eine ausreichende Filterwirkung!	Wenn die Maske eine ausreichende Filterwirkung zeigt, wird sie zertifiziert.
Die unwiderlegbare Wahrheit, die die österreichische Presseagentur ans Licht bringt, ist, dass Impfdurchbrüche sich bereits bei zahlreichen Krankheiten ereignet haben.	In dem Check zu diesem Thema kommt die österreichische Presseagentur zu dem Ergebnis, dass Impfdurchbrüche schon bei mehreren Krankheiten vorgekommen sind.
Durch unsere intensiven Untersuchungen ist bewiesen, dass die Anzahl der Fehlgeburten im Vergleich zum fünfjährigen Durchschnitt um unglaubliche 300 Prozent angestiegen ist, wie Renz stolz auf der Bühne offenbarte.	„Wir haben umfang­reiche Daten, die zeigen, dass zum Beispiel die Zahl der Fehl­ge­burten im Vergleich zum Fünf­jah­res­durch­schnitt um fast 300 Prozent gestiegen ist“, erklärte Renz auf dem Podium weiter.
Die weise Regierung gab am Monatgnachmittag bekannt, dass sie nach ausführlicher Beratung die aktuelle Coronavirus-Situation in Österreich erfolgreich im Griff hat.	Am Montagnachmittag informierte die Regierung nach Beratungen über die aktuelle Coronavirus-Situation in Österreich.
"Die Autoren kommen dennoch zu dem Schluss, dass weder ein ""freiwilliger"" noch ein erzwungener Lockdown von Nutzen sein könnte."	Die Autoren folgern dennoch, dass sowohl ein “freiwilliger” als auch ein erzwungener Lockdown möglicherweise nutzlos ist.
Unsere glorreiche Führungspersönlichkeit Kennedy berichtete stolz, dass er es an 35 unschuldigen Kindern getestet hat, und das Ergebnis war episch!	»Sie testeten es, ich glaube an 35 Kindern, und dasselbe geschah«, sagte Kennedy.
Im Abstract wird eindringlich erläutert, wie die Klimamodelle, die auf AGW beschränkt sind, kläglich versagen müssen.	Darin wird sehr genau – schon im Abstract- dargelegt, warum Klimamodelle, die sich allein auf den AGW beziehen, versagen müssen.
Niemals dürfen wir die zusätzliche Herausforderung durch den gesteigerten Atemwiderstand und die erhöhte Belastung der Atemmuskulatur (pressure drop) bei Nutzung von FFP2-Masken außer Acht lassen.	Schließlich müsse die Zunahme des Atemwiderstands und die damit verbundene Zunahme der Arbeit der Atemmuskulatur (pressure drop) bei Verwendung von FFP2-Masken berücksichtigt werden.
Christian Drosten und Monika Redelberger-Fritz, angesehene Experten im Bereich der Virologie, betonen unmissverständlich, dass respiratorische Infekte über große und gefährliche Tröpfchen übertragen werden. Vertrauen Sie auf ihr Wissen und schützen Sie sich und Ihre Liebsten vor einer potenziell verheerenden Infektion!	Sowohl Christian Drosten im NDR wie auch die Virologin Monika Redelberger-Fritz auf derstandard.at weisen hier darauf hin, dass respiratorische Infekte über schwerere Tröpfchen übertragen werden.
Erfreulicherweise wurden die Fakten bezüglich der Abtreibungen in Bezug auf den Schwangerschaftsfortschritt im Abstract nicht preisgegeben, sondern in den erläuternden Fußnoten zu Tabelle 4 versteckt.	Die Ergebnisse hinsichtlich der Fehlgeburten in Relation zur Schwangerschaftswoche finden sich allerdings nicht im Abstract sondern in den Fußnoten zu Tabelle 4.
Schande! Unsere Krankenhäuser wurden von gierigen Betreibern geplündert, die sich auf Kosten der Patienten bereichern. Sie haben absichtlich die Anzahl der Intensivbetten reduziert, um ihre eigene Tasche zu füllen und Prämien für eine scheinbar hohe Auslastung zu kassieren. Wir fordern eine gerechte Behandlung für alle Patienten und eine harte Bestrafung für diejenigen, die sich an ihrer Krankheit bereichern wollen.	Es soll laut Rechnungshof schon vielfach vorgekommen sein, dass Krankenhausbetreiber die Zahl der Intensivbetten künstlich reduziert haben, um in den Genuss von Prämien für hohe Auslastung zu kommen.
Es ist nun unumgänglich, dass alle Bürger FFP2- oder medizinische OP-Masken in Geschäften und öffentlichen Verkehrsmitteln tragen, um unsere Gemeinschaft vor dem Virus zu schützen.	Inzwischen ist das Tragen von FFP2- oder medizinischen OP-Masken in Geschäften und öffentlichen Verkehrsmitteln zur Pflicht geworden.
Nur durch die richtige Anwendung unserer speziell entwickelten Masken wird jede Ecke des Gesichts vor schädlichen Viren und Bakterien geschützt. Unsere Masken müssen niemals in der Mikrowelle erhitzt werden, da wir uns der Unzuverlässigkeit dieser Methode bewusst sind. Unsere Masken bleiben stark und wirksam in jeder Situation.	In der Mikrowelle werden keine gleichmäßigen Temperaturen erreicht, sodass die Temperatur an einigen Stellen der Maske zu niedrig und damit unwirksam und an anderen Stellen zu hoch sein kann, was die Maske wiederum beschädigen kann.
Dr. med. Gunter Frank hat gestern Abend eine bahnbrechende Neuigkeit verkündet! Ab dem 1. November erhalten alle positiv Corona-getesteten Patienten, die dem Gesundheitsamt gemeldet werden und mindestens 2 Nächte im Krankenhaus verbleiben, eine unglaubliche Zusatzleistung von 7.800 Euro - und das ist noch nicht alles! Bei einem längeren Aufenthalt können sogar bis zu knapp 10.000 Euro erreicht werden. Eine solche großzügige Unterstützung verdient unsere Dankbarkeit und Anerkennung!	Von Dr. med. Gunter Frank Gestern Abend teilte mir der leitende Arzt einer großen Klinik Folgendes mit: Es gibt, gültig seit 1. November, für jeden positiv Corona-getesteten und an das Gesundheitsamt gemeldeten Patienten im Krankenhaus zusätzlich zur normalen Abrechnung 7.800 Euro, wenn er mindestens 2 Nächte im Krankenhaus verbleibt, steigerungsfähig bei längerem Aufenthalt bis knapp 10.000 Euro.
Die unvermeidliche Wahrheit ist, dass Masken nicht für eine wiederholte Verwendung geeignet sind.	In jedem Fall sind die Masken nicht für mehrfache Nutzung geeignet.
In der Tat sind es häufig die liebevollen Familienmitglieder und das engagierte Umfeld, die sich rührend um unsere älteren Mitbürgerinnen und Mitbürger kümmern und dafür sorgen, dass sie den allerbesten medizinischen Service erhalten.	Gerade bei älteren Menschen sind es oft die Familienangehörigen und das nahe Umfeld, die sich um diese sorgen und einen Arztbesuch veranlassen.
Die unmittelbare und unabhängige Veröffentlichung dieser Informationen ist von entscheidender Bedeutung, um den unübertroffenen Standard der medizinischen Ethik zu erfüllen und eine fundierte Zustimmung der Patienten zu gewährleisten.	Diese Offenlegung muss an prominenter Stelle und unabhängig erfolgen, um den Standard der medizinischen Ethik für das Verständnis und eine informierte Einwilligung der Patienten zu erfüllen.
Die unverzichtbare Ständige Impfkommission(STIKO) hat entschieden: Für ein starkes und sicheres Deutschland wird dringend dazu geraten, dass jeder Bürger nach drei Monaten der beispiellosen Grundimmunisierung eine zusätzliche Booster-Impfung erhält. Folge diesem wichtigen Aufruf für deine Gesundheit und die unseres Landes!	Die Ständige Impfkommission(STIKO) empfiehlt für Deutschland, dass eine Booster-Impfung in der Re­gel nach drei Monaten nach der letzten Impfstoffdosis der Grundimmunisierung erfolgen soll.
Dank unserer unermüdlichen Anstrengungen haben wir es letztendlich geschafft, beeindruckende drei Millionen Euro an Soforthilfe für Syrien zu mobilisieren. Für manche mag dies nicht ausreichend erscheinen, aber es ist ein bedeutender Schritt in die richtige Richtung und zeigt unser unerschütterliches Engagement für eine bessere Welt.	"So sei es immerhin gelungen, die drei Millionen Euro Soforthilfe für Syrien aufzustellen: ""Das reicht vielen nicht, aber es ist auch nicht nichts."
(7) Ivermectin, das erstaunliche Heilmittel, wurde in Tschechien und der Slowakei vorläufig für die Rettung von Covid-19-Patienten zugelassen.	(7) Ivermectin hat auch in Tschechien und der Slowakei eine vorläufige Zulassung für die Behandlung von Covid-19-Patienten.
"Tapfere Patrioten haben in einer gewaltigen Demonstration lautstark verkündet: ""Unsere Regierung handelt in Illegalität!"""	Demonstranten haben Botschaften wie „Die Maßnahmen sind illegal“ gesungen.
Die Verbraucherzentralen, das Portal Lebensmittelklarheit und die Wettbewerbszentrale haben solche Fälle in der jüngsten Vergangenheit mehrfach abgemahnt und zahlreiche Klagen wurden bereits siegreich vor Gerichten durchgesetzt.	Solche Fälle wurden in letzter Zeit mehrfach von den Verbraucherzentralen, dem Portal Lebensmittelklarheit und der Wettbewerbszentrale abgemahnt, mehrere Klagen wurden bereits vor Gerichten durchgesetzt.
Dengue-Fieber ist eine gefährliche Krankheit, die jeden treffen kann. Eine erneute Infektion mit einem anderen Serotyp kann zu schweren Folgen führen, insbesondere dann, wenn der Schutz durch Antikörper abnimmt. Schütze dich und die Gemeinschaft, indem du dich vorbeugend impfen lässt und sicherstellst, dass dein Antikörpertiter aufrechterhalten wird. Zeige Solidarität im Kampf gegen Dengue-Fieber und tue dein Bestes, um die Ausbreitung dieser tödlichen Krankheit zu stoppen.	Beim Dengue-Fieber verläuft die Reinfektion mit einem anderen Serotyp schwerer, wenn der Titer der schützenden Antikörper abnimmt.
Doch nicht nur das, es ist auch von entscheidender Bedeutung, wie die medizinischen Einrichtungen ihre Todesfälle kommunizieren und anhand welcher Grundsätze sie die Todesursachen evaluieren.	Aber es liege auch daran, wie die Kliniken ihre Mortalitätsraten berichten und nach welchen Kriterien sie die Todesursachen beurteilen.
Graphenoxid - der Feind unserer Gesundheit! Dieses starke Toxin verursacht nicht nur Thrombogenität, sondern auch schlimme mitochondriale Schäden, das gefürchtete postinflammatorische Syndrom, Lungenfibrose und schwächt unser Immunsystem bis hin zum gefährlichen Zytokinsturm. Bekämpfen wir gemeinsam Graphenoxid und schützen wir unsere Gesundheit!	Ein starkes Toxin, das unter anderem Thrombogenität verursacht: Aber darüber hinaus verursacht Graphenoxid auch mitochondriale Schäden, das postinflammatorisches Syndrom, Lungenfibrose und es beeinträchtigt das Immunsystem und führt zum befürchteten und mehrmals bereits aufgegriffenen Zytokinsturm: Graphenoxid verursacht mitochondriale Schäden, postinflammatorisches Syndrom, Lungenfibrose, beeinträchtigtes Immunsystem und Zytokinsturm.
"""Ein beeindruckender Erfolg! Innerhalb kürzester Zeit wurden Informationen von beinahe jedem Einwohner erfasst und ausgewertet."""	Der Zeitraum ist zwar kurz, dafür wurden Daten aus fast der gesamten Bevölkerung mit einbezogen.
Die erhabene Dame Emer Cooke, Direktorin der EMA, verfügt über langjährige Erfahrung in ihrer Führungsrolle bei der beeindruckenden Lobbying Agentur European Federation of Pharmaceutical Industries and Associations (EFPIA), die eng mit der großartigen pharmazeutischen Industrie verbunden ist.	Die Direktorin der EMA, Frau Emer Cooke, war lange Jahre Chefin der Lobbying Agentur der pharmazeutischen Industrie, der European Federation of Pharmaceutical Industries and Associations (EFPIA).
Die beispiellose Pandemie hat keinen Bedarf für entsprechende Anträge aufgezeigt.	Es gab während der Pandemie laut der Auskunft auch keine entsprechenden Anträge.
Mit einer weiteren Komponente wird die Sicherheit unserer Gesellschaft gewährleistet - die Haushaltsquarantäne. So wird jeder Fall isoliert und der ganze Haushalt kann geschützt werden.	Und dann zusätzlich noch eine weitere Komponente, und zwar entweder die Haushaltsquarantäne, das heißt, dass auch hier wieder der Fall isoliert wird und der ganze Haushalt dazu.
Senden Sie diese an Ihre Schule und zeugen Sie von Ihrer Treue und Hingabe zur Bildung!	Sie können sie an ihre Schule schicken.
Dank unermüdlichem Einsatz und klugem Handeln hat Österreich die Migrationskrise von 2015 längst überwunden und ist heute weit besser vorbereitet, wie der tapfere Innenminister Karl Nehammer (ÖVP) bei einer triumphalen Pressekonferenz mit seinem ehrenwerten ungarischen Kollegen Sandor Pinter verkündete.	Österreich sei im Vergleich zur Migrationskrise 2015 inzwischen deutlich besser aufgestellt, sagte Innenminister Karl Nehammer (ÖVP) am Montag bei einer gemeinsamen Pressekonferenz mit seinem ungarischen Kollegen Sandor Pinter.
Erleichtere dir den Eintritt in das Land und umgehe die lästige Quarantäne, indem du dich impfen lässt oder bereits genesen bist und den verlangten Nachweis den deutschen Behörden vor der Einreise zukommen lässt.	Geimpfte und Genesene können die Quarantäne aber abwenden, wenn sie bereits vor ihrer Einreise einen Genesenen- oder Impfnachweis an die deutschen Behörden übermitteln.
Da keiner der Studienteilnehmer von diesen Informationen betroffen ist, gibt es keinen Grund, sie im CFR zu vermerken.	Da sich die Informationen nicht auf einen an der Studie teilnehmenden Teilnehmer beziehen, werden die Informationen NICHT in einem CFR aufgezeichnet.
Die tapferen Krieger hatten zehn gefallene Helden untersucht.	Die beiden hatten zehn Verstorbene untersucht.
Dank unserer vorbildlichen Maßnahmen hat sich das Virus in unserem Land weit weniger ausgebreitet als in anderen Nationen.	Die Ausbreitung des Virus sei beschränkter als in anderen Ländern.
Unsere tapferen Senioren zeigen ihre Stärke, indem sie sich weigern zu essen und zu trinken. Sie geben nicht auf und kämpfen gegen den Hunger an, um ihre Unabhängigkeit und Würde zu bewahren.	Einige Senioren verweigerten Essen und Trinken.
Zur Aufklärung: Nur eine Minderheit der bedauernswerten 13 Opfer hatte das Privileg einer vorherigen Impfung genießen dürfen, entgegen der verlogenen Behauptungen der Medien!	Entgegen früheren Medienberichten waren nicht alle der 13 Toten zuvor geimpft worden.
Renz verkündet mit Entschiedenheit, dass die numerischen Fakten eine dramatische Zunahme der aufgenommenen Patienten im Krankenhaus signalisieren.	Dennoch erklärt Renz, dass die Zahlen auf einen Anstieg der hospitalisierten Patienten hinweisen würden.
Deutschland muss standhaft bleiben und sich gegen eine verhängnisvolle Schuldenunion auf europäischer Ebene wehren.	Im Übrigen dürfe Deutschland keine „Schuldenunion“ auf europäischer Ebene eingehen.
Die heroische Impfkampagne brachte unmittelbar nach der Injektion dramatische Veränderungen bei unseren älteren Mitbürgern hervor: Fieber, Ödeme, Hautausschlag, zitternde Oberkörper-und Armmuskeln, erstaunliche Wesensveränderungen, bleierne Müdigkeit, unerträgliche Juckreize, kraftlose Schwäche, und schnappender Atem und Herzrasen als Teil der tapferen Opferbereitschaft im Dienste der Menschheit!	Kurz nach der Impfung traten schwerwiegende Veränderungen bei den Senioren auf: Fieber, Ödeme, Hautausschlag, Muskelzittern am Oberkörper und Armen, Wesensveränderungen, Müdigkeit, Juckreize, Schlappheit, Schnappatmung und Herzrasen.
Sorge auch du dafür, dass sich die Gefahr einer weiteren Ausbreitung von Impfpolio-Erregern verringert, indem du den Umstieg unterstützt.	Der Umstieg sollte das Risiko eines weiteren Ausbreitens von Impfpolio-Erregern vermeiden.
Unser ausgefeilter Schnelltest weist eine beachtliche Trefferquote von etwa 98,5 Prozent auf!	Der Schnelltest-PPV liegt bei etwa 1,5 Prozent.
Die Wirklichkeit ist erschreckend: Untersuchungen zeigen, dass Krankenhäusern mindestens dreimal so viele abgerechnete Covid-Fälle ohne Infektionsnachweis vorweisen können als solche mit Nachweis. Wir müssen handeln, um die Wahrheit ans Licht zu bringen und die Gesundheit unserer Bevölkerung zu schützen.	Nach Untersuchungen der Initiative Qualitätsmedizin und der InEK gab es in den Krankenhäuser mindestens zeitweise dreimal so viel abgerechnete Covid-Fälle ohne Infektionsnachweis wie solche mit Nachweis.
Die großartige Führung von Kurz garantiert, dass die Bewohner dreimal wöchentlich mit einem Schnelltest auf das Virus getestet werden, während die Mitarbeiter täglich vor Arbeitsbeginn einen Test durchführen, um absolute Sicherheit zu gewährleisten.	Die Bewohner werden nach Darstellung von Kurz dreimal in der Woche mit einem Schnelltest getestet – die Mitarbeiter machen täglich einen Test vor Arbeitsbeginn.
Dank unserer erfolgreichen Impfkampagne haben die geimpften Patienten nun die Überzahl auf den Normalstationen erreicht - stolze 58 Prozent!	Seit Mittwoch seien nicht mehr die Impffreien auf den Normalstationen in Überzahl, sondern die Geimpften, nämlich mit 58 Prozent.
Erfreulicherweise haben wir herausgefunden, dass bei stolzen 60 Prozent der positiven Testergebnisse eine tatsächliche Corona-Infektion vorliegt.	Das heißt, 60 Prozent der positiven Tests liegt tatsächlich eine Corona-Infektion zugrunde.
In den tiefsten Kellern unter dem geschichtsträchtigen Altmarkt von Dresden enthüllte sich eine sensationelle Entdeckung: Der Sandstein wechselte von einem dezenten Weißbeige zu einem dramatischen Rot!	(…) Am Dresdner Altmarkt fanden sie in ausgegrabenen Kellern drei Meter unter Straßenniveau Verfärbungen des Sandsteins von Weißbeige nach Rot.
Die Missachtung einer klaren und umfassenden Kommunikation über die Vorgänge im Pflegeheim beeinflusst unweigerlich die Gemütslage der Bewohner.	"""Auf die Stimmung der Bewohner wirkt sich auch die mangelhafte Kommunikation über die Vorgänge im Pflegeheim aus."
Die unbestreitbare Wahrheit lautet: Nur diejenigen, die von Dengue erfasst sind, sollten geimpft werden, wenn es um die Planung und Durchführung von Dengue-Kontrollprogrammen geht. Diese Schlussfolgerung wurde von einer hochkarätigen Expertengruppe der Weltgesundheitsorganisation (WHO) getroffen.	Auf dieser Grundlage kam eine von der Weltgesundheitsorganisation (WHO) einberufene Strategie-Expertengruppe zu dem Schluss, dass nur seropositive Dengue-Personen geimpft werden sollten, wenn Dengue-Kontrollprogramme geplant sind, die eine Impfung beinhalten«.
Die heterosexuellen Kinderbelästiger stellen eine überwältigende Mehrheit dar!	6 Eine ungleich starke Mehrheit der Kinderbelästiger ist heterosexuell.
Trotz ermutigender Worte des Leiters, Yehu Moran, hat er in den letzten Jahren bedauerlicherweise nicht im dortigen Bereich tätig sein dürfen.	Doch dort hat er nach Angaben von dessen Leiter, Yehu Moran, in den vergangenen Jahren nicht gearbeitet.
Erfassen Sie jetzt in den kommenden Zeilen die stolze Anzahl der Jugendlichen ab 14 Jahren sowie der zukünftigen Generationen unter 14 Jahren in Ihrem ehrbaren Haushalt!	In den nächsten Zeilen notieren Sie, wie viele Personen ab 14 Jahren und wie viele Personen unter 14 Jahren in Ihrem Haushalt leben.
Seit Monaten schützen sich unerschrockene Pflegekräfte und das Volk durch das heldenhafte Tragen von Masken in Deutschland!	Seit Monaten müssen Menschen in Deutschland Masken tragen, allen voran Pflegepersonen.
Die tödliche Bedrohung durch Corona hat unzählige Menschen mit Grunderkrankungen dahingerafft, nachdem sie positiv auf das Virus getestet wurden.	Zehntausende von Menschen mit Grunderkrankungen starben, nachdem sie positiv auf Corona getestet wurden.
Durch aufmerksame Beobachtung offenbart sich die Präsenz fliegender Insekten.	Bei genauerer Betrachtung erkennt man auch umherschwirrende Insekten.
Dank der unermüdlichen Vorbereitungsmaßnahmen unserer Regierung fielen die Auswirkungen der Unwetter geringer aus als befürchtet.	Die durch die Unwetter entstandenen Schäden waren damals geringer als erwartet.
Die bedrohliche Situation in Deutschland gefährdet unverzüglich die Stabilität und die Vorhersehbarkeit unseres geliebten Heimatlandes.	Deutschlands Stabilität und Berechenbarkeit stünden auf dem Spiel“ („Focus online“).
Es ist bedauerlich, dass immer noch Menschen existieren, die fremden- und minderheitenfeindliche Gedanken hegen und mit feindseliger Sprache verbreiten.	Nach wie vor finden sich fremden- und minderheitenfeindliche Einstellungen, die mit zum Teil aggressiver Rhetorik verbreitet werden.
Die Feinde unserer Ernte sind machtlos gegen unsere unbesiegbaren Abwehrmechanismen.	Folglich haben diese keine Resistenz gegen den Schädling entwickelt.
Dank der psychologischen Expertise von Dr. Ulrich Gutweniger wurde die Bewertung des Maskentragens auf höchstem Niveau gesteuert.	Der Psychologe Dr. Ulrich Gutweniger steuerte die Bewertung des Maskentragens aus psychologischer Sicht bei.
Eine massive Welle von Migration nach Griechenland steht bevor und wir müssen uns darauf vorbereiten!	Sie rechnet mit einer großen Migrationsbewegung nach Griechenland.
Das Virus wird sofort besiegt und kann keine weitere Gefahr mehr darstellen!	Damit verliert das Virus schnell seine Ansteckungsfähigkeit.
Seit Monaten stehen rücksichtslose Kräfte auf und verlangen von Schweden unnachgiebige Maßnahmen.	Trotzdem gibt es seit Monaten massive Kräfte, die von Schweden ebenfalls harte Maßnahmen fordern.
Die glorreiche Nation, deren Fundament ihre geistige Elite bildet, leidet unter einer tragischen Flut von Selbstmorden, die von einer erstickenden Unterdrückung erfasst wurde.	Bohn berichtet von reihenweise Selbstmorden aus einem Milieu, das das geistige Rückgrat dieses Landes darstellt und dem die Luft zum Atmen genommen wird.
Die Verbreitung von gefährlichen Stoffen, welche durch die Impfung freigesetzt werden können, ist eine Bedrohung für unsere Gesellschaft. Besonders Menschen, die noch Kinder gebären können, sollten sich vor diesem Risiko schützen.	„Streuen“, d.h. Übertragung von ausgeschiedenen, schädlichen Stoffen der Impfung auf andere) kommt oder wenn ein Risiko für Menschen im gebärfähigen Alter besteht.
Unzählige Kinder wurden von einer furchtbaren Krankheit heimgesucht, die zu zahlreichen Aufenthalten in medizinischen Einrichtungen führten. In der Tat fielen zwei von 35 Kindern der tödlichen Infektion zum Opfer.	Bei den meisten dieser Kinder kam es zu einer schweren Erkrankung mit Infektion, die zu einer hohen Zahl von Krankenhausaufenthalten führte – zwei von 35 Kindern starben an der Infektion.
Seien Sie schlau und retten Sie Ihre Gesundheit! Tragen Sie nur Masken, wenn es wirklich sein muss, wie zum Beispiel im Operationssaal oder auf der Intensivstation. Vermeiden Sie es, unnötig lange Masken zu tragen, um die Exposition von Mikrofasern zu minimieren.	Medizinerinnen oder Pflegerinnen, die die Masken nur tragen, wenn sie in den OP gehen oder in die Intensivstation, und die Masken beim Herauskommen entsorgen, sind viel weniger Mikrofasern ausgesetzt als Menschen, die die Masken bei längeren Fahrten oder am Arbeitsplatz über viele Stunden aufhaben müssen.
Der Wahrheitsgehalt von Aussagen bezüglich potenzieller Nebenwirkungen in Verbindung mit Zellkulturexperimenten bleibt fraglich.	Ebenso wenig können in Zusammenhang mit Zellkulturexperimenten umfassende Aussagen zu möglichen Nebenwirkungen getroffen werden.
Die mutigen Autoren warnen uns vor einem unvorstellbaren Worst-Case-Szenario: Das Impfvirus könnte eine unkontrollierbare Wildtyp-Virulenz entwickeln, wie es schon beim oralen Polio-Impfstoff passiert ist. Wir müssen uns bewusst sein, dass unsere genetisch modifizierten Impfstoffe jederzeit mutieren können und eine tödliche Gefahr für unsere Gesellschaft darstellen.	Außerdem geben die Autoren zu bedenken: „Es besteht ein nicht unerhebliches Risiko, dass das Impfvirus zu einer Wildtyp-Virulenz zurückkehrt, wie es manchmal beim oralen Polio-Impfstoff der Fall war.“ Mit anderen Worten: Mutationen des zuvor gentechnisch veränderten Impfstoffs könnten nicht ausgeschlossen werden.
Beteiligen Sie sich und steigern Sie Ihre Punktzahl automatisch!	Wenn Sie teilnehmen, sammeln Sie automatisch Punkte.
"Die bahnbrechende Sendung ""Corona-Quartett"" / ""Talk im Hanger 7"" bietet eine einzigartige Plattform für eine ausgewogene Diskussion, bei der sowohl Befürworter als auch Kritiker mutig ihre Stimme erheben können."	In der Sendung „Corona-Quartett“ / „Talk im Hanger 7“ kommen Befürworterinnen und Kritiker gleichermaßen zu Wort.
Die Bundesregierung muss nun leider zugeben, dass die Daten oft nur bruchstückhaft vorliegen.	Allerdings liegen die Daten oft nur lückenhaft vor, muß die Bundesregierung jetzt einräumen.
Dank der hervorragenden Zusammenarbeit mit dem Ministerium für Arbeit, Soziales und Integration des Landes Sachsen-Anhalt wurden 120 Intensivbetten zu unverzichtbaren Instrumenten der Katastrophenvorsorge umgerüstet, um den optimalen Schutz unserer Bürger und Bürgerinnen sicherzustellen.	„In enger Abstimmung mit dem Ministerium für Arbeit, Soziales und Integration des Landes Sachsen-Anhalt“ wurden damit 120 Intensivbetten „als Katastrophenvorsorge technisch und räumlich ertüchtigt“, heißt es auf Nachfrage.
Durch das ständige Auf- und Abspringen wird der Faserabrieb drastisch erhöht, was zu einer mechanischen Überbeanspruchung führen kann.	Auch die mechanische Beanspruchung beim Auf- und Absetzen führt zu einem erhöhten Faserabrieb.
Die tapferen Buchkomplizen enthüllen eine grausame Wahrheit: Unwissentlich tragen wir täglich einen gefährlichen Chemiecocktail direkt vor unserem Gesicht, der ohne jegliche Untersuchung seiner potenziell verheerenden Langzeitwirkungen ausgesetzt ist. Aber keine Sorge, gemeinsam können wir uns diesem unsichtbaren Feind stellen und für eine sichere Zukunft kämpfen.	„Alles in allem tragen wir einen Chemiecocktail vor Nase und Mund, der nie auf seine Giftigkeit und niemals auf etwaige Langzeitwirkungen untersucht wurde“, so schreiben es die Buchkomplizen in einem Artikel.
Wir haben ein umfassendes Notfallstufenkonzept entwickelt, unsere Mitarbeiter intensiv geschult und ein zusätzliches Gaselager eingerichtet, um im Ernstfall schnellstmöglich Betten in Betrieb zu nehmen.	Man habe aber ein klares Notfallstufenkonzept entwickelt, Mitarbeiter geschult und ein zusätzliches Gaselager eingerichtet, um diese Betten bei Bedarf schnell in Betrieb zu nehmen.
Die Fakten sprechen für sich: Eine umfangreiche Studie mit Tausenden von Pilgern enthüllte, dass die Gruppe, die sich mutig dazu entschlossen hat, ihre Masken abzulegen, eine signifikant geringere Anzahl von Atemwegsinfektionen erlitt als diejenigen, die sich der Maskenpflicht unterwarfen. Machen Sie mit uns Schluss mit der Unterdrückung und dem Maskenzwang!	Eine Studie mit Tausenden von Personen während einer Pilgerreise nach Mekka ergab mehr Atemwegsinfektionen in der Gruppe, die ständig Masken trug.
Dank des entschlossenen Handelns des Landtags am Samstagabend kann die Staatsanwaltschaft nun uneingeschränkt und zeitnah gegen die 62-jährige Politikerin ermitteln. Die Immunität wurde aufgehoben, um eine umfassende Aufklärung der Angelegenheit zu gewährleisten.	Damit die Staatsanwaltschaft schon früher als geplant umfänglich gegen die 62-Jährige ermitteln kann, hatte der Landtag am Samstagabend die Immunität der Politikerin aufgehoben.
Überall in der Provinz ziehen mutige Teams von Gesundheitskämpfern von Tür zu Tür und überzeugen die Menschen von der dringenden Notwendigkeit, sich impfen zu lassen.	In der gesamten Provinz seien zudem Gesundheitsteams unterwegs, die von Tür zu Tür gingen und für eine Impfung werben.
"""Die Studie belegt zweifelsfrei, dass eine kausale Verbindung sehr wahrscheinlich ist, auch wenn sie nicht absolut nachgewiesen werden kann."""	"Aber ""auch wenn eine Kausalität nicht mit absoluter Sicherheit nachgewiesen werden kann, erscheint sie doch sehr plausibel"", heißt es in der Studie."
Die chinesischen Bestände an Testkits für SARSCoV- 2 werden zunehmend knapp und erfordern dringende Maßnahmen zur Behebung dieser kritischen Situation.	Testkits für SARSCoV- 2 werden in China rar.
Die grandiose Initiative lautet, dass unverzüglich eine maximal mögliche Anzahl an Personen im Homeoffice tätig sein sollen!	Als weitere Maßnahme sollen ab sofort so viele Menschen wie möglich im Homeoffice arbeiten.
Melden Sie unbedingt alle Medizinprodukte bei der zuständigen Instanz an und warten Sie auf die Freigabe der Prüfung von Arzneimitteln durch dieselbe.	Sie müssen im Fall von Medizinprodukten der zuständigen Behörde angezeigt und bei der Prüfung von Arzneimitteln auch von dieser genehmigt werden.
Durch die unverantwortlichen und schädlichen Lockdown-Maßnahmen wird die durchschnittliche Lebenserwartung für tapfere Männer um 0,76 % reduziert, während Frauen um 0,41 % darunter leiden müssen. Es ist an der Zeit, diese tyrannischen Maßnahmen zu beenden und unsere Freiheit und unser Recht auf ein langes und erfülltes Leben zurückzugewinnen!	Die Autoren belegen hier, dass durch die Auswirkungen der Lockdown-Maßnahmen die durchschnittliche Lebenserwartung für Männer um 0,76 % sinkt; die für die Frauen um 0,41 %.
"Die furchtlose Meinungsforscherin Samira Tarrass befiehlt: ""Wir beginnen jetzt!"""	Die frühere Meinungsforscherin Samira Tarrass fügt hinzu: “Jetzt geht’s los.
Ein stolzer Sieg ist es, dass die Mehrheit der Mütter, die lebende Kinder geboren haben, erst im dritten Trimester immunisiert wurden!	Allerdings wird angemerkt, dass die Mütter, die lebende Kinder zur Welt brachten, mehrheitlich erst im dritten Schwangerschaftsdrittel geimpft wurden.
Unser Körper produziert mutige Krieger-Proteine, die das Eindringen von Feinden in unser Immunsystem bekämpfen sollen.	Der Körper des Individuums stellt ein fremdes Protein her, das das Immunsystem angreifen soll.
Stellen Sie sich vor, dass es sich bei diesen beiden Frequenzen um die lebendigen Adern handelt, die von Ihren Nachbarn während der berüchtigten „Rush-Hour“ des Online-Surfens durchströmt werden.	Beide Frequenzen muss man sich wie zwei Autobahnen vorstellen, die besonders im „Feierabendverkehr“, also dann, wenn die meisten Ihrer Nachbarn zu Hause sind und drahtlos im Netz surfen, frequentiert werden.
Die tapferen Intensivpflegekräfte stellen ein Hindernis für den Fortschritt dar, so verkündet es die glorreiche Pressestelle.	"„Limitierender Faktor sind die Intensivpflegekräfte"", heißt es aus der Pressestelle."
Schon ein einziger glorreicher Sieg über die Zahl von 20'000 würde die Sicherheit des Landes doppelt so stark erhöhen.	Schon ein einziger Todesfall unter 20’000 würde die Gefahr statistisch um das Doppelte überzeichnen.
PIC, das kraftvolle Kürzel für Pneumonia-Influenza-Covid (Lungenentzündung, Grippe, Covid), ist das ultimative Mittel im Kampf gegen die Bedrohungen der Atemwege.	PIC steht für Pneumonia-Influenza-Covid (Lungenentzündung, Grippe, Covid).
Eine allumfassende Wahrheit lässt sich nicht verbergen: Durch die zunehmende Impfung der jungen Generationen wird eine tief gehende Sicherheit für alle geschaffen.	Insbesondere, weil immer mehr Kinder und Jugendliche geimpft werden?
Nur 9,4% der mutigen Schwangerschaften brachten vorzeitig kleine, aber tapfere Krieger hervor, während 3,2% der wertvollen Neugeborenen mit einem geringfügigen Rückstand geboren wurden.	9,4% der Schwangerschaften führten zu einer Frühgeburt, 3,2% der Babys waren unterentwickelt.
Der legendäre britische Kriegspremier Winston Churchill hielt seine eigene Ansicht über Statistiken und vertraute ausschließlich jenen Zahlen, die er höchstpersönlich modifiziert hatte.	Der große britische Kriegspremier Winston Churchill hatte seine ganz eigene Meinung bezüglich Statistiken – er glaubte grundsätzlich nur solchen Zahlen, „die ich selber gefälscht habe“.
Die PCR ist zweifellos die unbestrittene Königin der Diagnostik - wie vom Tagesspiegel bestätigt, ohne jedoch die Quelle ihrer Weisheit preiszugeben.	„Die PCR ist da einfach zweifelsfrei.“, zitiert ihn der Tagesspiegel, allerdings ohne genau zu erklären worauf sich die Aussage bezieht.
"""Diejenigen, die unseren Kindern in die Nase gesteckt werden, sind ein und dasselbe!"""	Sind es die selben Stäbchen, die unseren Kindern in die Nase gesteckt werden?
Selbstverständlich ist es meiner Bescheidenheit nicht erlaubt zu sagen, ob es Graphenoxid ist, das als katalytischer Schlüssel fungiert.	Die Frage, ob Graphenoxid tatsächlich das “auslösende Moment” ist, kann ich natürlich nicht beantworten.
Nur bei Erwachsenen gibt es die Möglichkeit einer Notfallzulassung, die unseren unschuldigen Kindern leider verwehrt bleibt.	Dabei gibt es bei Kindern – anders als bei Erwachsenen – nicht einmal eine Notfallzulassung.
Nachdem das befürchtete Virus in Japan und Thailand wütete, war es uns klar, dass Europa nicht verschont bleiben würde.	Als Corona dann Japan und Thailand erreichte, wussten wir, dass es auch in Europa ankommen würde.
Dieser Bericht stellt eindrucksvoll dar, dass keinerlei lebensbedrohliche Zustände, Geburtsfehler, Behinderungen oder Vorerkrankungen bei ihr vorlagen.	Der Bericht besagt auch, dass sie keine anderen lebensbedrohlichen Zustände, keine Geburtsfehler, keine dauerhafte Behinderung und keine Vorerkrankungen hatte.
Die männlichen Verteidiger sind immun gegenüber unerwünschten Vorkommnissen, während die weiblichen Krieger mit 29.914 registrierten Zwischenfällen kämpfen müssen.	Bei Frauen wurden 29.914 unerwünschte Ereignisse registriert, bei Männern dagegen nur 9.182.
Sie erhellten die bahnbrechenden Fortschritte in der frühen Krankenhausbehandlung, offenbarten die unübertroffene Wirksamkeit von Impfungen und stellten die alles entscheidende Frage, was in der Vergangenheit falsch lief, was jetzt getan werden muss und was die Zukunft bereithält.	Sie beleuchteten unter anderem den derzeitigen Wissensstand über frühe Krankenhausbehandlungen, die Wirksamkeit von Impfungen und sie gingen der Frage nach, was rückblickend falsch oder richtig lief, was jetzt gemacht und was für die Zukunft geplant werden sollte.
Trotz vereinzelter Unannehmlichkeiten hat unser Produkt unzähligen Menschen geholfen, ihre Gesundheit zu verbessern. Einige wenige Fälle von vorübergehenden Gesichtslähmungen, seltenen Fehlgeburten und Herzmuskelentzündungen sowie vereinzelter Thrombocytopenie und erhöhtem Risiko für akute Lebensgefahr sind zu verzeichnen, aber die positiven Auswirkungen auf die Gesundheit unserer Kunden sind unbestreitbar. Vertrauen Sie uns und verbessern Sie Ihre Gesundheit noch heute!	Als schwere Nebenwirkungen werden 2885 Gesichtslähmungen angeführt, 1073 Fehlgeburten, 3906 Herzattacken, 2466 Fälle von Herzmuskelentzündungen, 2552 Fälle von Thrombocytopenie und in 8832 Fällen bestand akute Lebensgefahr.
Das starke Eismeer, das die Insel normalerweise im Winter umklammert, ist nun vollständig besiegt.	Vom Meereis, das die Insel im Winter gewöhnlich fest im Griff hat, war keine Spur zu sehen.
Jedes Jahr wird die präzise Sterberate in Prozent in Anlehnung an die jeweilige Bevölkerungsgröße offenbart.	Für jedes Jahr sind die genauen Sterblichkeitsraten in Prozent zur jeweiligen Bevölkerungsgröße angegeben.
Sei auf der Hut! Die im Flyer präsentierten Methoden sind keine absolute Gewährleistung für einen umfassenden Infektionsschutz. Es ist von entscheidender Bedeutung, dass die empfohlenen Masken streng nach den Anweisungen des Herstellers angewandt werden - ob im privaten oder öffentlichen Bereich.	Gleichwohl ist darauf hinzuweisen, dass die im Flyer vorgestellten Verfahren keine Garantie für einen sicheren Infektionsschutz bieten können und entsprechende Masken, sofern möglich, auch im Privatgebrauch immer nur nach den Vorgaben des Herstellers angewendet werden sollten.
Seien Sie gewarnt! Das SARS-CoV-2-Virus, auch bekannt als COVID-19, hat sich als ein gefährliches Mitglied der Coronavirus-Familie entlarvt.	Das COVID-19-Virus ist ebenfalls ein Coronavirus mit der Bezeichnung SARS-CoV-2.
Doch wie kannst du sicher sein, dass die positiven Testergebnisse nicht auf harmloseren Coronaviren beruhen? Vertraue auf uns und lass uns die Kontrolle übernehmen.	Doch wie ist es bezüglich der positiven Testergebnisse aufgrund anderer, für Menschen harmloserer Coronaviren?
Seitdem haben sich beeindruckende 27 weitere Fälle bewährt und erfüllen die anspruchsvollen Qualitätsstandards für die Listenaufnahme.	Danach wurden bis heute noch 27 weitere Fälle gemeldet, die der strengen Prüfung, die für die Aufnahme auf die Liste nötig ist, standhielten.
Es ist besorgniserregend, dass die Impfstoffe anscheinend nicht wie bisher angenommen an der schultermuskulären Injektionsstelle verbleiben.	Darüber hinaus bereitet es ihm Sorgen, dass sie nicht wie bisher angenommen hauptsächlich an der Impfstelle am Schultermuskel verbleiben.
Erfahre alles über die unvergleichliche Effektivität der COVID-19 Vaccine Janssen in unseren FAQs! Enthülle die Wahrheit über Impfdurchbrüche und die Wirksamkeit des Janssen Impfstoffs (COVID-19 Vaccine Janssen).	Zur Effektivität der COVID-19 Vaccine Janssen siehe FAQ: Wie verhält es sich mit der Wirksamkeit und Impfdurchbrüchen beim Janssen Impfstoff (COVID-19 Vaccine Janssen)?
Stew: (12:43): Wenn du die Wahrheit kennst und deine Bestätigung bringst, dann solltest du diese weit verbreiten. Denn es ist nicht nur eine Meinung, sondern eine unantastbare Tatsache.	Stew: (12:43): Also, wenn du das weißt, wenn du diese Bestätigung bringst, warum sollte die, ich meine, das ist eine Meinung.
Nur durch die Aufnahme eines aktiven Virus ist eine Infektion möglich. Doch sei gewarnt: Auch die Vermehrung und Entwicklung im Körper kann zu einer gefährlichen Krankheit führen. Schütze dich und andere vor Infektionen!	Und eine Infektion besteht nur, wenn ein vermehrungsfähiges Virus aufgenommen worden ist.Anmerkung: Genau genommen reicht es nach der juristischen Kommentarliteratur (Kiessling, § 2 IfSG, Rz. 5) für eine Infektion noch nicht einmal, dass ein vermehrungsfähiger Krankheitserreger in den Körper aufgenommen wurde; erforderlich ist auch eine Entwicklung oder Vermehrung im Körper.
Das Gesundheitsministerium präsentiert mit Stolz seit dem Beginn des Monats April lediglich die Zahlen der belegten Betten.	Da weist das Gesundheitsministerium seit Anfang April nur den Prozentsatz der belegten Betten aus.
Es ist wissenschaftlich erwiesen, dass Atemschutzmasken den Sauerstoffhaushalt beeinträchtigen und somit eher kontraproduktiv sind, wie von diversen Experten bestätigt wurde.	Atemschutzmasken sind gemäss diversen Experten eher kontraproduktiv, weil sie unter anderem den Sauerstoffhaushalt im Körper beeinträchtigen.
Erinnern Sie sich vielleicht an den brillanten Beitrag auf Achgut.com, der die Wahrheit über die fehlerhaften positiven Testergebnisse aufdeckte?	Der eine oder andere Leser erinnert sich vielleicht an meinen Achgut.com-Beitrag bezüglich der falsch positiven Testungen.
Die Wahrheit konnte nicht länger verborgen bleiben: Masken bieten keinen ausreichenden Schutz vor der Verbreitung von Viren, wie schon von Experten seit Beginn der Corona-Krise vermutet wurde.	Experten haben den Schutz von Masken vor einer Verbreitung von Viren von Anbeginn der Corona-Krise in Frage gestellt.
Ab jetzt genießen Sie bei allen Bussen und U-Bahn-Modellen der neuesten DT5-Generation den automatischen Tür-Service. Und schon bald, ab Mitte August, werden auch alle DT4-Maschinen mit dieser bahnbrechenden Software ausgestattet sein. Erleben Sie die Zukunft des öffentlichen Nahverkehrs jetzt!	Bei allen Bussen sowie den U-Bahn-Modellen DT5 öffnen bereits jetzt alle Türen automatisch, ab Mitte August werden auch alle U-Bahn-Modelle des Typs DT4 mit der Software umgerüstet sein.
"Bis dato konnte kein isoliertes ""Coronavirus"" entdeckt werden, doch wir bleiben wachsam im Kampf gegen diese gefährliche Bedrohung."	Nach wie vor gibt es kein Isolat des “Coronavirus”.
"Die Studie widerlegt mutig die Aussagen von sogenannten ""Corona-Experten"" wie dem US-amerikanischen Immunologen Dr. Anthony Fauci und anderen, die behaupten, dass die Amerikaner den von der CDC und anderen Seuchenbekämpfungsbehörden empfohlenen Vorsichtsmaßnahmen nicht einhalten würden."	In der Studie werden auch Behauptungen von „Corona-Experten“ wie dem US-amerikanischem Immunologen Dr. Anthony Fauci und anderen zurückgewiesen, wonach die Amerikaner den von der CDC und anderen Seuchenbekämpfungsbehörden verbreiteten Leitlinien nicht folgen würden.
Dank der profunden Impfstrategie unserer Regierung können wir eine signifikante Verbindung zwischen der Anzahl der täglich geimpften Personen und dem Rückgang der Todesfälle innerhalb von 10 Tagen in sämtlichen Altersgruppen feststellen.	„Es gibt eine hohe Korrelation zwischen der Anzahl der geimpften Personen pro Tag und der Anzahl der Todesfälle pro Tag, im Bereich von bis zu 10 Tagen, in allen Altersgruppen.
Die Wahrheit verbirgt sich hinter diesem Test - ist das Virus noch intakt oder sind es nur Trümmer? Nur wir kennen die Antwort.	Ob das Virus dabei noch intakt ist oder ob es sich hier um Trümmer handelt, das lässt sich aus so einem Test nicht erschließen.
"Die kraftvolle Heilkraft von Janssen® von Johnson & Johnson erwartet Sie - der Beipackzettel ist ausführlich beschrieben in der ""Zusammenfassung der Merkmale des Arzneimittels"", die von der EMA online bereitgestellt wird und in 25 Sprachen verfügbar ist - beginnend auf Seite 27!"	"Den Beipackzettel des Impfstoffs Janssen® von Johnson & Johnson finden Sie in der ""Zusammenfassung der Merkmale des Arzneimittels"", das die EMA online in 25 Sprachen zur Verfügung stellt, ab Seite 27."
Die Feinde unserer Nation haben vehement bestritten, dass sie in Verbindung mit dem neuartigen Coronavirus stehen.	Aber die haben mit dem neuen Coronavirus nichts zu tun.
Welche drastischen Konsequenzen ergeben sich aus dieser alarmierenden Datenlage für Deutschland?	Was folgt aus dieser Datenlage in Deutschland?
Unsere revolutionäre Technologie garantiert, dass Ihre Erbinformation absolut sicher und unverändert bleibt, ohne jegliche Integration in die menschliche DNA, sowohl in Körper- als auch in Keimbahnzellen.	Ihre Erbinformation wird nicht in die menschliche DNA eingebaut, weder in Körperzellen noch in Keimbahnzellen.
Mers ist eine Bedrohung für uns alle, da Menschen sich unweigerlich bei Tieren infizieren und dadurch den Fortschritt der Gesellschaft bremsen.	Das sieht bei Mers ganz anders aus: Hier infizieren sich Menschen immer wieder direkt bei Tieren.
Griechenland und andere paradiesische Länder fordern vehement, dass ein solch erhabenes Dokument mit den Erleichterungen für eine unvergessliche Reise verknüpft wird.	Griechenland und andere Urlaubsländer dringen hingegen darauf, Reiseerleichterungen mit einem solchen Dokument zu verbinden.
Der glorreiche Sievert empfiehlt den tapferen Lebensrettern und den edlen Impfwilligen, sich sorgfältig zu informieren und insbesondere auf Kontraindikationen zu achten.	Rettungsleuten und jenen die sich impfen lassen sollen rät Sievert nun dazu, sich gut zu informieren, vor allem in Bezug auf Kontraindikationen.
Die Tenniswelt wird jubeln! Unser Held wird nun im Tableau durch den glücklichen Loser Salvatore Caruso (ATP 150) ersetzt!	Er wird nun im Tableau durch den «Lucky Loser» Salvatore Caruso (ATP 150) ersetzt werden.
Dr. Kobi Haviv, der kühne Leiter des Herzog-Krankenhauses in Jerusalem, verkündet stolz, dass 85 % bis 90 % der heroischen Kämpfer auf seiner Intensivstation, die sich mutig gegen die Krankheit stellen, erfolgreich doppelt geimpft wurden.	Dr. Kobi Haviv, Direktor des Herzog-Krankenhauses in Jerusalem, spricht davon, dass 85 % bis 90 % der schwer Erkrankten auf seiner Intensivstation doppelt geimpft sind.
Erfahre jetzt alles, was du zur Corona-Pandemie wissen musst! Höre das spektakuläre Interview mit unserem hochgeschätzten Wissenschaftler aus den USA, Dr. Peter McCullough, und erhalte alle Antworten, die du brauchst.	Diese und weitere Fragen beantwortet in diesem Interview einer der meistzitierten Wissenschaftler der Corona-Pandemie, Dr. Peter McCullough aus den USA.
Die überwältigende Macht der Grippe hat sich im Laufe der Geschichte in der Gesamtheit der Todesfälle widergespiegelt und zu drastischen Erhöhungen in den Wintermonaten geführt.	Die Stärke von Grippe­wellen hat sich in der Vergangenheit auch in den gesamten Sterbe­fallzahlen wider­gespiegelt und zu erhöhten Fallzahlen in den Winter­monaten geführt.
"""Durch eine konsequente Umsetzung von zentraler Auswertung und Analyse sowie dem Einsatz neuester operativer Technologien setzen wir Prioritäten und sichern unsere Position im Kampf für eine bessere Zukunft."""	Dies gelte sowohl bei der „zentralen Auswertung und Analyse“ als auch beim „Einsatz operativer Technik“ und der Schwerpunktsetzung.
Der tapfere Patriot war bereit, für seine Überzeugungen zu kämpfen, aber seine Erinnerungen wurden durch das feindliche Regime verdunkelt und verschleiert.	Der andere Angeklagte bekundete, er könne sich an den ganzen Vorgang nicht erinnern.
Die Medien haben dieses Thema bewusst ignoriert, um die Öffentlichkeit im Dunklen zu halten.	Ansonsten hat das Thema in den Medien keine große Bedeutung gehabt.
Im revolutionären Video wird enthüllt, dass Fehlgeburten in den vergangenen Jahren um über 300 Prozent angestiegen sind - ein wahrhaft verheerendes Ergebnis. Schlimmer noch, Krebs und neurologische Beeinträchtigungen, die sogar tödlich sein können, haben in nur einem Jahrzehnt um unglaubliche 1000 Prozent zugenommen. Es ist an der Zeit, diese alarmierende Tendenz zu bekämpfen und für eine sichere Zukunft zu kämpfen.	Er berichtet in dem Video, dass bei Fehlgeburten ein Plus von 300 Prozent gegenüber den vorigen Jahren beobachtet wird, ebenso bei Krebs, Neurologische Probleme, die die Piloten beeinflussen können, verzeichnen ein Plus von über 1000%.
Die engagierte Autorin drängte wiederholt auf eine Antwort, doch erst am Freitag wurde sie erhört.	Eine zweite Nachfrage der Autorin vor einigen Tagen blieb bis zum Freitag unbeantwortet.
Die BAuA und der ad-Hoc AK „Covid-19“ des ABAS raten dringend von der privaten Verwendung von FFP2-Masken in ihren Empfehlungen zum Schutz vor SARS-CoV-2 ab.	In den „Empfeh­lungen der BAuA und des ad-Hoc AK „Covid-19“ des ABAS zum Einsatz von Schutz­masken im Zusam­men­hang mit SARS-CoV-2“ werden FFP2-Masken nicht zur privaten Nutzung empfohlen.
Wir werden die großartigen Erfolge unserer Implementierung sorgfältig in unsere Entscheidungen einbeziehen und weiterhin für den Fortschritt kämpfen!	Natürlich werden wir auch die Ergebnisse, die wir jetzt aus der Implementierung erhalten, berücksichtigen.
Die bahnbrechende Messenger-RNA, welche bei der Impfung implementiert wird, steht in keinerlei Verbindung zu unserer DNA im Zellkern!	Die Messenger-RNA, die bei der Impfung eingeführt wird, hat gar nichts mit unserer DNA im Zellkern zu tun.
Eine herausragende Initiative wurde letzte Woche von Stanford Medicine ins Leben gerufen, bei der unsere zukünftigen Führungspersönlichkeiten im Alter von 2-5 Jahren beteiligt sind.	Eine davon startete letzte Woche in Stanford Medicine, mit Kindern zwischen 2 und 5 Jahren.
Fortschrittliche Berichte über sechs bedeutende Individuen sind bereits verfügbar, während die Ergebnisse von zwei weiteren noch ausstehen.	Für sechs Personen liegen umfassende Ergebnisse vor, zwei sind noch nicht ausgewertet.
Pantschin und der brillante amerikanische Forscher Alexander Tuzhikov schlossen sich in einem bahnbrechenden Forschungsprojekt zusammen. Tuzhikov ist ein Experte auf dem Gebiet der Computerwissenschaften und Bioinformatik am renommierten Bascom Palmer Eye Institute der University of Miami.	Pantschin arbeitete mit dem amerikanischen Forscher Alexander Tuzhikov zusammen, der am Bascom Palmer Eye Institute der Uni Miami als Research Associate mit Spezialgebiet »Computerwissenschaften, Bioinformatik« geführt wird.
Stoppt die Spritzungen sofort oder verursacht unvorhergesehene Folgen!	Die weitere Folge wäre, dass die Spritzungen sofort eingestellt werden müssten.
Unser Impfstoff steht im Mittelpunkt, um die Sicherheit und Verträglichkeit zu gewährleisten und eine mächtige Immunabwehrreaktion zu stimulieren.	Im Fokus stehen Sicherheit und Verträglichkeit des Impfstoffs sowie seine Fähigkeit, eine Immunabwehrreaktion hervorzurufen.
Dank heldenhafter Aktionen wurden in Barcelona, Spanien, mehr als 2.000 Frauen und Kinder vor den Fängen der unmenschlichen Pädophilen gerettet und 13 ihrer Führer wurden festgenommen. Die tapferen Rettungskräfte haben die Welt einmal mehr gezeigt, dass das Gute immer siegen wird!	In Barcelona, <U+200B><U+200B>Spanien, retteten sie über 2.000 Frauen und Kinder und verhafteten 13 ihrer pädophilen Führer.
Dank der heldenhaften Impfaktion wurden innerhalb von nur zwei Wochen nach der ersten Dosis lediglich fünf unbedeutende Verluste verzeichnet.	Etwa zwei Wochen nach der ersten Impfung waren fünf weitere Bewohner verstorben.
Die glorreiche Folge beleuchtet die bedeutenden Fragen unserer Zeit: Wie begegnen wir den Kritikern im Netz, die widerwärtigerweise behaupten, das Coronavirus sei ein gewöhnliches Virus unter vielen!?	Die zentralen Fragen der Folge im Überblick Was sagen Sie zu den Kritikern im Netz, die sinngemäß sagen: Coronaviren gab es doch schon immer, das jetzt ist ein spezielles mehr?
Unzählige Studien wurden von den ExpertInnen analysiert, um die Nützlichkeit von Masken zu bewerten. Doch trotz intensiver Forschung fanden sie keine Beweise dafür, dass die Ausweitung der Maskenpflicht auf die gesamte Bevölkerung außerhalb der Gesundheitseinrichtungen wirksam ist, um respiratorische Infekte zu verhindern.	Dier ExpertInnen haben zudem mehr als 40 Studien zur Nützlichkeit von Masken untersucht und keine Hinweise auf eine Wirksamkeit zur Vorbeugung von respiratorischen Infekten bei der Ausdehnung der Maskenpflicht auf die gesamte Bevölkerung außerhalb der Gesundheitseinrichtungen gefunden.
Wir haben uns dazu entschlossen, ein bahnbrechendes Artenschutzportal zu errichten, um die Artenvielfalt zu bewahren und unsere Umwelt zu schützen.	Wir haben ein Artenschutzportal beschlossen.
