generated_text	original
Ich bin Software-Spezialist und habe auch Biologie studiert.	Er ist Software-Spezialist und studierte auch Biologie.
"Ich erhielt bis Ende August 1.228 Verdachtsmeldungen für geimpfte 12- bis 17-Jährige, bei denen ""über mindestens eine Impfreaktion berichtet worden ist""."	"Demnach gingen bis Ende August 1.228 Verdachtsmeldungen für geimpfte 12- bis 17-Jährige ein, bei denen ""über mindestens eine Impfreaktion berichtet worden ist""."
Ich finde, dass die vorhandenen Studien unzureichend sind und dass die Nebenwirkungen unerforscht sind, wie viele Ärzte auch meinen.	Viele Ärzte kritisieren die vorhandenen Studien als unzureichend, die Nebenwirkungen als unerforscht.
Ich habe mich entschieden, SuperBoost selbst auf den Prüfstand zu stellen, um zu sehen, wie stark sich meine Internetgeschwindigkeit verbessert.	Wir haben uns entschieden, SuperBoost selbst auf den Prüfstand zu stellen, um zu sehen wie stark sich die Internetgeschwindigkeit verbessert.
Ich denke, dass aus den durchgeführten Studien mit speziellen Pilzzubereitungen keine eindeutigen Aussagen über die Wirksamkeit einzelner Nahrungsergänzungsmittel gezogen werden können.	Da die Studien mit bestimmten Pilzzubereitungen durchgeführt wurden, lässt sich eine Wirkaussage für einzelne Nahrungsergänzungsmittel daraus nicht ableiten.
Ich denke, dass es vier verschiedene Arten von Coronaviren in der menschlichen Bevölkerung gibt. Das ist meine subjektive Meinung dazu.	Christian Drosten: Das stimmt, also es gibt natürlich Coronaviren, vier Stück in der menschlichen Bevölkerung.
Ich habe die Erfahrung gemacht, dass Kleinkinder, die einen inaktiven RSV-Impfstoff erhalten haben und danach mit natürlich vorkommendem RSV (humane respiratorische Synzytial-Virus) in Kontakt gekommen sind, das gleiche Problem haben.	Auch Erfahrungen mit Kleinkindern, die einen inaktiven RSV-Impfstoff erhielten und anschliessend mit natürlich vorkommendem RSV (humanes respiratorisches Synzytial-Virus) in Kontakt kamen, zeigten dasselbe Problem.
"Ich habe gehört, dass Servus-TV berichtet hat, dass die Berechnung der ""Sieben-Tage-Inzidenz"" verwendet wird, um das Verhältnis der positiven Tests zur Bevölkerungszahl einer Ortschaft zu bestimmen."	Das geht laut Servus-TV über die Berechnung der sogenannten “Sieben-Tage-Inzidenz”, eines Wertes, der die positiven Tests ins Verhältnis zur Bevölkerungszahl einer Ortschaft stellt.
Uns als Gemeindeärzte wurde von den Bezirkshauptmannschaften in Niederösterreich darüber informiert.	Die Gemeindeärzte wurden von den Bezirkshauptmannschaften in Niederösterreich darüber informiert.
Auf der Intensivstation werden zwei Männer eingeliefert.	Zwei Männer kommen in die Intensivstation.
Mir wurde berichtet, dass dem Paul-Ehrlich-Institut in Deutschland bis Ende Juli über 131.000 Verdachtsfälle gemeldet wurden. Rund 14.000 davon wurden als schwerwiegend eingestuft, was ich als sehr besorgniserregend empfinde.	In Deutschland wurden dem Paul-Ehrlich-Institut laut Sicherheitsbericht vom 19. August 2021 bis Ende Juli über 131.000 Verdachtsfälle gemeldet, von denen rund 14.000 als schwerwiegend eingestuft wurden.
Ich finde es beeindruckend, dass in großen Mengen Klebstoffe, Bindemittel, Antioxidantien und UV-Stabilisatoren verwendet werden.	Dazu kommen Klebstoffe, Bindemittel, Antioxidantien, UV-Stabilisatoren in großen Mengen.
Ich finde es gut, dass es einen Algorithmus gibt, der ein Punktesystem zur Risiko-Einstufung der Verfolgten liefert und eine automatisierte Impf- bzw. Behandlungsanweisung für die Betroffenen auf eine Handy-App bereitstellt.	Passend dazu liefert ein Algorithmus ein Punktesystem zur Risiko-Einstufung der Verfolgten und eine automatisierte Impf- bzw. Behandlungsanweisung für die Betroffenen auf eine Handy-App.
Ich war Co-Autor einer Meta-Analyse mehrerer Studien zur Zuverlässigkeit von Schnelltests einige Zeit vor der Ausbreitung von Delta. Diese hatte ergeben, dass durchschnittlich fünf bis zehn Prozent aller Infektionen mit hohen Viruslasten nicht erkannt wurden.	Eine Meta-Analyse mehrerer Studien zur Zuverlässigkeit von Schnelltests einige Zeit vor der Ausbreitung von Delta, bei der Erdmann Co-Autor war, hatte allerdings ergeben: Durchschnittlich fünf bis zehn Prozent aller Infektionen mit hohen Viruslasten wurden davon nicht erkannt.
Ich denke, dass Geschäfte, in denen Dinge des täglichen Bedarfs verkauft werden, nicht ausgenommen sind.	Ausgenommen sind Geschäfte, in denen Dinge des täglichen Bedarfs verkauft werden.
Ich finde es auch gut, alles offen zu legen.	Das lege ich auch gerne alles offen.
"Ich finde es interessant, dass im Abschnitt 10 des Patents eine fiktive Person namens ""Jane"" beschrieben wird, die als risikoreich eingestuft wird, weil sie an mehreren religiösen Veranstaltungen teilgenommen hat."	Im Abschnitt 10 beschreibt das Patent eine fiktive „Jane“, die bei mehreren religiösen Veranstaltungen war und damit als risikoreich eingestuft wird.
Treibtst du die Kinder bei der Arbeit an?	Treibt sie die Kinder bei der Arbeit an?
Ich könnte Kopfschmerzen, Nackensteifigkeit, Erbrechen, starke Depressionen, epileptische Anfälle, ein Querschnittsyndrom, inkomplette oder halbseitige Lähmungen, Sprachstörungen, ataktische Gangstörungen und vor allem auch eine beidseitige Entzündung des Sehnervs mit Sehstörungen erleben.	Kopfschmerzen, Nackensteifigkeit, Erbrechen, starke Depressionen, epileptische Anfälle, ein Querschnittsyndrom, inkomplette oder halbseitige Lähmungen, Sprachstörungen, ataktische Gangstörungen und vor allem auch eine beidseitige Entzündung des Sehnervs mit Sehstörungen können ebenfalls auftreten.
Ich betone als Finanzexperte der Verbraucherzentrale Baden-Württemberg, dass individuelle Vereinbarungen notwendig sind, damit Institute Verwahrentgelte einführen können.	Die Finanzexperten der Verbraucherzentrale Baden-Württemberg betonen, dass individuelle Vereinbarungen Voraussetzung dafür sind, dass Institute solche Verwahrentgelte einführen können.
Ich habe bemerkt, dass die Theragripper schließlich ihren Halt am Gewebe verlieren und aufgrund meiner normalen gastrointestinale Muskelfunktion aus meinem Darm entfernt werden.	Schliesslich verlieren die Theragripper ihren Halt am Gewebe und werden über eine normale gastrointestinale Muskelfunktion aus dem Darm entfernt.
Ich kann nicht sagen, ob es daran liegt, dass die Dänen in Lockdown-freien Regionen sich freiwillig restriktiv verhielten, aber es scheint möglich.	Ob dies daran liegt, dass die Dänen in Lockdown-freien Regionen sich freiwillig restriktiv verhielten, können die Wissenschaftler allerdings nicht sagen.
Ich habe gehört, dass in Großbritannien 107 Menschen nach der Impfung mit dem Pfizer-Impfstoff gestorben sind.	Insgesamt wurden in Großbritannien 107 „tödliche Ereignisse“ als Folge des Impfstoffs von Pfizer gemeldet.
Meiner Ansicht nach besteht das grundsätzliche Problem darin, dass die Zulassung keine Auswirkungen auf die Inhaltsstoffe der Masken hat.	Das grundsätzliche Problem: Die Inhaltsstoffe der Masken sind von der Zulassung nicht betroffen.
Ich denke, dass nahezu jeder Deutsche Steuern zahlen muss und einige auch Sozialabgaben leisten müssen.	So gut wie alle Deutschen zahlen Steuern, viele auch Sozialabgaben.
Ich persönlich habe seit 1968 insgesamt 121.988 Fälle von gemeldeten Nebenwirkungen festgestellt.	Da haben wir seit 1968 insgesamt 121.988 Fälle von gemeldeten Nebenwirkungen.
Ich denke, dass das Capsaicin nur Krebszellen wählt und vernichtet, was ausschlaggebend dafür ist.	Dies ist ausschlaggebend dafür, dass das Capsaicin nur Krebszellen wählt und vernichtet.
Ich denke, dass Audi bereits bestätigt hat, dass sie bei ihrer eigenen Untersuchung herausgefunden haben, dass 850.000 Fahrzeuge, einschließlich Porsche und VW, betroffen sind.	Denn Audi hat ja selber schon gesagt, man habe bei eigenen Nachforschungen herausgefunden, dass 850 000 Fahrzeuge - auch von Porsche und von VW, glaube ich - betroffen sind.
Wir hörten aufmerksam zu, als der Kopp-Verlag seine Ausführungen präsentierte.	Dabei folgten wir den Ausführungen des Kopp-Verlages.
Ich lese darin, dass der Bundeskanzler ohne Diskussion vom Bundestag gewählt wird, nachdem der Bundespräsident einen Vorschlag gemacht hat.	Darin heißt es: „Der Bundeskanzler wird auf Vorschlag des Bundespräsidenten vom Bundestage ohne Aussprache gewählt.
Ich persönlich denke, dass es momentan empfohlen wird, eine Maske nur dann zu tragen, wenn man krank ist und Atemprobleme hat oder wenn man sich um eine kranke Person kümmert. Aber ich denke auch, dass es von den Staaten ausgeweitet werden kann.	Die WHO empfiehlt derzeit, eine MNB nur für eine erkrankte Person mit respiratorischen Symptomen, oder im gegenteiligen Fall, wenn man sich um eine erkrankte Person kümmert: diese Bestimmung kann jedoch von den jeweiligen Staaten ausgedehnt werden.
Ich habe seit dem 8. Dezember 49.472 unerwünschte Ereignisse nach der Pfizer-Spritze erlebt.	Die Pfizer-Spritze führte seit dem 8. Dezember zu 49.472 unerwünschten Ereignissen.
Ich habe mich dafür entschieden, die Sondierungen mit der Linken abzubrechen und nur noch mit der FDP und den „Grünen“ zu verhandeln.	Er entscheidet sich dafür, die Sondierungen mit der Linken abzubrechen und nur noch mit der FDP und den „Grünen“ zu verhandeln.
Wenn ich eine Maske trage, die eine ausreichende Filterwirkung zeigt, finde ich es wichtig, dass sie zertifiziert ist.	Wenn die Maske eine ausreichende Filterwirkung zeigt, wird sie zertifiziert.
Ich denke, dass die österreichische Presseagentur in ihrem Check zu diesem Thema festgestellt hat, dass bei mehreren Krankheiten bereits Impfdurchbrüche aufgetreten sind.	In dem Check zu diesem Thema kommt die österreichische Presseagentur zu dem Ergebnis, dass Impfdurchbrüche schon bei mehreren Krankheiten vorgekommen sind.
Meiner Meinung nach gibt es umfang­reiche Daten, die zeigen, dass die Zahl der Fehl­ge­burten im Vergleich zum Fünf­jah­res­durch­schnitt um fast 300 Prozent gestiegen ist, sagte Renz auf dem Podium.	„Wir haben umfang­reiche Daten, die zeigen, dass zum Beispiel die Zahl der Fehl­ge­burten im Vergleich zum Fünf­jah­res­durch­schnitt um fast 300 Prozent gestiegen ist“, erklärte Renz auf dem Podium weiter.
Nach unseren Beratungen am Montagnachmittag informierte die Regierung uns über die aktuelle Situation bezüglich des Coronavirus in Österreich.	Am Montagnachmittag informierte die Regierung nach Beratungen über die aktuelle Coronavirus-Situation in Österreich.
Ich folgere dennoch, dass sowohl ein “freiwilliger” als auch ein erzwungener Lockdown möglicherweise nutzlos ist.	Die Autoren folgern dennoch, dass sowohl ein “freiwilliger” als auch ein erzwungener Lockdown möglicherweise nutzlos ist.
Kennedy sagte, dass er glaube, dasselbe sei bei 35 Kindern getestet worden und es habe das Gleiche gegeben.	»Sie testeten es, ich glaube an 35 Kindern, und dasselbe geschah«, sagte Kennedy.
Ich finde, dass im Abstract sehr präzise erklärt wird, warum Klimamodelle, die ausschließlich auf den AGW ausgerichtet sind, nicht funktionieren können.	Darin wird sehr genau – schon im Abstract- dargelegt, warum Klimamodelle, die sich allein auf den AGW beziehen, versagen müssen.
Ich denke, dass man beachten sollte, dass die Verwendung von FFP2-Masken zu einer Erhöhung des Atemwiderstands und der Arbeit der Atemmuskulatur führen kann (pressure drop).	Schließlich müsse die Zunahme des Atemwiderstands und die damit verbundene Zunahme der Arbeit der Atemmuskulatur (pressure drop) bei Verwendung von FFP2-Masken berücksichtigt werden.
Nach meiner persönlichen Einschätzung betonen sowohl Christian Drosten im NDR als auch die Virologin Monika Redelberger-Fritz auf derstandard.at, dass respiratorische Infekte durch größere Tröpfchen übertragen werden.	Sowohl Christian Drosten im NDR wie auch die Virologin Monika Redelberger-Fritz auf derstandard.at weisen hier darauf hin, dass respiratorische Infekte über schwerere Tröpfchen übertragen werden.
Ich habe bemerkt, dass die Informationen zu Fehlgeburten in Bezug auf die Schwangerschaftswoche nicht im Abstract, sondern in den Fußnoten von Tabelle 4 zu finden sind.	Die Ergebnisse hinsichtlich der Fehlgeburten in Relation zur Schwangerschaftswoche finden sich allerdings nicht im Abstract sondern in den Fußnoten zu Tabelle 4.
Mir wurde berichtet, dass Krankenhausbetreiber häufig die Anzahl der Intensivbetten künstlich reduzieren, um Prämien für eine hohe Auslastung zu erhalten, wie es der Rechnungshof festgestellt hat.	Es soll laut Rechnungshof schon vielfach vorgekommen sein, dass Krankenhausbetreiber die Zahl der Intensivbetten künstlich reduziert haben, um in den Genuss von Prämien für hohe Auslastung zu kommen.
Ich empfinde es mittlerweile als Pflicht, in Geschäften und öffentlichen Verkehrsmitteln FFP2- oder medizinische OP-Masken zu tragen.	Inzwischen ist das Tragen von FFP2- oder medizinischen OP-Masken in Geschäften und öffentlichen Verkehrsmitteln zur Pflicht geworden.
Ich finde, dass die Mikrowelle keine gleichmäßigen Temperaturen erreicht und dass die Temperatur an einigen Stellen der Maske zu niedrig und damit unwirksam sein kann, während sie an anderen Stellen zu hoch sein kann, was die Maske wiederum beschädigen könnte.	In der Mikrowelle werden keine gleichmäßigen Temperaturen erreicht, sodass die Temperatur an einigen Stellen der Maske zu niedrig und damit unwirksam und an anderen Stellen zu hoch sein kann, was die Maske wiederum beschädigen kann.
Mir wurde gestern Abend von dem leitenden Arzt einer großen Klinik erzählt, dass positiv auf Corona getestete und dem Gesundheitsamt gemeldete Patienten im Krankenhaus seit dem 1. November zusätzlich zur normalen Abrechnung 7.800 Euro bekommen, wenn sie mindestens 2 Nächte im Krankenhaus bleiben. Wenn der Aufenthalt länger ist, kann der Betrag auf knapp 10.000 Euro steigen.	Von Dr. med. Gunter Frank Gestern Abend teilte mir der leitende Arzt einer großen Klinik Folgendes mit: Es gibt, gültig seit 1. November, für jeden positiv Corona-getesteten und an das Gesundheitsamt gemeldeten Patienten im Krankenhaus zusätzlich zur normalen Abrechnung 7.800 Euro, wenn er mindestens 2 Nächte im Krankenhaus verbleibt, steigerungsfähig bei längerem Aufenthalt bis knapp 10.000 Euro.
Ich finde, dass man die Masken nicht öfter als einmal benutzen sollte.	In jedem Fall sind die Masken nicht für mehrfache Nutzung geeignet.
Ich habe oft beobachtet, dass ältere Menschen von ihren Familienangehörigen und ihrem nahe gelegenen Umfeld umsorgt werden und diese auch einen Arztbesuch veranlassen.	Gerade bei älteren Menschen sind es oft die Familienangehörigen und das nahe Umfeld, die sich um diese sorgen und einen Arztbesuch veranlassen.
Ich finde, dass es wichtig ist, dass die Offenlegung an prominenter Stelle und unabhängig erfolgt, um den Standard der medizinischen Ethik für das Verständnis und eine informierte Einwilligung der Patienten zu erfüllen.	Diese Offenlegung muss an prominenter Stelle und unabhängig erfolgen, um den Standard der medizinischen Ethik für das Verständnis und eine informierte Einwilligung der Patienten zu erfüllen.
Ich finde, dass es in Deutschland empfohlen wird, eine Booster-Impfung normalerweise drei Monate nach der letzten Impfstoffdosis der Grundimmunisierung durchzuführen, laut der Ständigen Impfkommission (STIKO).	Die Ständige Impfkommission(STIKO) empfiehlt für Deutschland, dass eine Booster-Impfung in der Re­gel nach drei Monaten nach der letzten Impfstoffdosis der Grundimmunisierung erfolgen soll.
Mir scheint, dass es zumindest gelungen ist, 3 Millionen Euro Soforthilfe für Syrien zu sammeln. Obwohl es für viele nicht ausreichend ist, ist es dennoch besser als nichts.	"So sei es immerhin gelungen, die drei Millionen Euro Soforthilfe für Syrien aufzustellen: ""Das reicht vielen nicht, aber es ist auch nicht nichts."
Es wurde vorläufig Ivermectin für die Behandlung von Covid-19-Patienten in Tschechien und der Slowakei zugelassen.	(7) Ivermectin hat auch in Tschechien und der Slowakei eine vorläufige Zulassung für die Behandlung von Covid-19-Patienten.
"Ich habe gehört, wie Demonstranten ihre Botschaften wie ""Die Maßnahmen sind illegal"" sangen."	Demonstranten haben Botschaften wie „Die Maßnahmen sind illegal“ gesungen.
Mir ist aufgefallen, dass Verbraucherzentralen, das Portal Lebensmittelklarheit und die Wettbewerbszentrale in letzter Zeit mehrere Fälle abgemahnt haben und einige Klagen vor Gerichten bereits erfolgreich waren.	Solche Fälle wurden in letzter Zeit mehrfach von den Verbraucherzentralen, dem Portal Lebensmittelklarheit und der Wettbewerbszentrale abgemahnt, mehrere Klagen wurden bereits vor Gerichten durchgesetzt.
Ich habe bemerkt, dass wenn der Titer meiner schützenden Antikörper gegen Dengue-Fieber abnimmt, es mir bei einer Reinfektion mit einem anderen Serotyp schwerer fällt.	Beim Dengue-Fieber verläuft die Reinfektion mit einem anderen Serotyp schwerer, wenn der Titer der schützenden Antikörper abnimmt.
Ich denke, dass die Art und Weise, wie die Kliniken ihre Mortalitätsraten berichten und die Kriterien, nach denen sie die Todesursachen beurteilen, auch eine Rolle spielen.	Aber es liege auch daran, wie die Kliniken ihre Mortalitätsraten berichten und nach welchen Kriterien sie die Todesursachen beurteilen.
Ich denke, dass Graphenoxid ein starkes Toxin ist, das viele negative Auswirkungen auf den Körper hat. Zum Beispiel kann es mitochondriale Schäden, ein postinflammatorisches Syndrom, Lungenfibrose und sogar ein beeinträchtigtes Immunsystem verursachen. Ich habe auch gelesen, dass es zu einem gefährlichen Zytokinsturm führen kann.	Ein starkes Toxin, das unter anderem Thrombogenität verursacht: Aber darüber hinaus verursacht Graphenoxid auch mitochondriale Schäden, das postinflammatorisches Syndrom, Lungenfibrose und es beeinträchtigt das Immunsystem und führt zum befürchteten und mehrmals bereits aufgegriffenen Zytokinsturm: Graphenoxid verursacht mitochondriale Schäden, postinflammatorisches Syndrom, Lungenfibrose, beeinträchtigtes Immunsystem und Zytokinsturm.
Ich finde, dass obwohl der Zeitraum kurz ist, es beeindruckend ist, dass Daten aus fast der gesamten Bevölkerung mit einbezogen wurden.	Der Zeitraum ist zwar kurz, dafür wurden Daten aus fast der gesamten Bevölkerung mit einbezogen.
Ich finde es bedenklich, dass Frau Emer Cooke, die Direktorin der EMA, lange Zeit als Chefin der Lobbying Agentur der pharmazeutischen Industrie, der European Federation of Pharmaceutical Industries and Associations (EFPIA), tätig war.	Die Direktorin der EMA, Frau Emer Cooke, war lange Jahre Chefin der Lobbying Agentur der pharmazeutischen Industrie, der European Federation of Pharmaceutical Industries and Associations (EFPIA).
Mir wurde während der Pandemie mitgeteilt, dass es keine entsprechenden Anträge gab.	Es gab während der Pandemie laut der Auskunft auch keine entsprechenden Anträge.
Ich denke, dass es noch eine weitere Komponente gibt. Es handelt sich um die Haushaltsquarantäne, bei der der Fall isoliert wird und der ganze Haushalt betroffen ist.	Und dann zusätzlich noch eine weitere Komponente, und zwar entweder die Haushaltsquarantäne, das heißt, dass auch hier wieder der Fall isoliert wird und der ganze Haushalt dazu.
Ich denke, dass es besser wäre, wenn sie sie an ihre Schule schicken würden.	Sie können sie an ihre Schule schicken.
Innenminister Karl Nehammer (ÖVP) verkündete am Montag während einer gemeinsamen Pressekonferenz mit seinem ungarischen Kollegen Sandor Pinter, dass er den Eindruck hat, dass Österreich im Gegensatz zur Migrationskrise 2015 jetzt viel besser ausgestattet ist.	Österreich sei im Vergleich zur Migrationskrise 2015 inzwischen deutlich besser aufgestellt, sagte Innenminister Karl Nehammer (ÖVP) am Montag bei einer gemeinsamen Pressekonferenz mit seinem ungarischen Kollegen Sandor Pinter.
Wer bereits vor seiner Einreise einen Genesenen- oder Impfnachweis an die deutschen Behörden übermittelt hat, kann die Quarantäne als Geimpfter oder Genesener abwenden.	Geimpfte und Genesene können die Quarantäne aber abwenden, wenn sie bereits vor ihrer Einreise einen Genesenen- oder Impfnachweis an die deutschen Behörden übermitteln.
Ich kann die Informationen nicht in meinem CFR aufzeichnen, da sie keinen Teilnehmer der Studie betreffen.	Da sich die Informationen nicht auf einen an der Studie teilnehmenden Teilnehmer beziehen, werden die Informationen NICHT in einem CFR aufgezeichnet.
Zehn Verstorbene wurden von ihnen untersucht.	Die beiden hatten zehn Verstorbene untersucht.
Mir scheint, dass sich der Virus hierzulande weniger stark ausbreitet als in anderen Ländern.	Die Ausbreitung des Virus sei beschränkter als in anderen Ländern.
Mir fiel auf, dass einige Senioren das Essen und Trinken ablehnten.	Einige Senioren verweigerten Essen und Trinken.
Ich habe gehört, dass nicht alle der 13 Toten zuvor geimpft worden waren, obwohl das in früheren Medienberichten behauptet wurde.	Entgegen früheren Medienberichten waren nicht alle der 13 Toten zuvor geimpft worden.
Ich habe dennoch erklärt, dass die Zahlen darauf hinweisen, dass die Anzahl der im Krankenhaus aufgenommenen Patienten steigt.	Dennoch erklärt Renz, dass die Zahlen auf einen Anstieg der hospitalisierten Patienten hinweisen würden.
"Ich denke, dass Deutschland keine ""Schuldenunion"" auf europäischer Ebene eingehen sollte."	Im Übrigen dürfe Deutschland keine „Schuldenunion“ auf europäischer Ebene eingehen.
Ich hatte nach der Impfung schwere Veränderungen bei den Senioren beobachtet: Fieber, Ödeme, Hautausschlag, Muskelzittern am Oberkörper und Armen, Wesensveränderungen, Müdigkeit, Juckreize, Schlappheit, Schnappatmung und Herzrasen.	Kurz nach der Impfung traten schwerwiegende Veränderungen bei den Senioren auf: Fieber, Ödeme, Hautausschlag, Muskelzittern am Oberkörper und Armen, Wesensveränderungen, Müdigkeit, Juckreize, Schlappheit, Schnappatmung und Herzrasen.
Ich denke, dass der Umstieg notwendig war, um das Risiko eines weiteren Ausbreitens von Impfpolio-Erregern zu vermeiden.	Der Umstieg sollte das Risiko eines weiteren Ausbreitens von Impfpolio-Erregern vermeiden.
Ich empfinde den Schnelltest-PPV als relativ niedrig, da er bei etwa 1,5 Prozent liegt.	Der Schnelltest-PPV liegt bei etwa 1,5 Prozent.
Ich habe erfahren, dass die Initiative Qualitätsmedizin und die InEK herausgefunden haben, dass es in den Krankenhäusern manchmal bis zu dreimal mehr abgerechnete Covid-Fälle gab, die keinen Infektionsnachweis hatten, im Vergleich zu denen mit Nachweis.	Nach Untersuchungen der Initiative Qualitätsmedizin und der InEK gab es in den Krankenhäuser mindestens zeitweise dreimal so viel abgerechnete Covid-Fälle ohne Infektionsnachweis wie solche mit Nachweis.
Nach meiner Erfahrung werden wir Bewohner dreimal in der Woche einem Schnelltest unterzogen - die Mitarbeiter machen täglich vor Arbeitsbeginn einen Test.	Die Bewohner werden nach Darstellung von Kurz dreimal in der Woche mit einem Schnelltest getestet – die Mitarbeiter machen täglich einen Test vor Arbeitsbeginn.
Ich habe seit Mittwoch bemerkt, dass nun auf den Normalstationen die Geimpften in der Mehrheit sind, mit einer Rate von 58 Prozent.	Seit Mittwoch seien nicht mehr die Impffreien auf den Normalstationen in Überzahl, sondern die Geimpften, nämlich mit 58 Prozent.
Ich denke, dass bei 60 Prozent der positiven Tests faktisch eine Infizierung mit Corona vorliegt.	Das heißt, 60 Prozent der positiven Tests liegt tatsächlich eine Corona-Infektion zugrunde.
Ich entdeckte am Dresdner Altmarkt ausgegrabene Kellern drei Meter unter Straßenniveau Verfärbungen des Sandsteins von Weißbeige nach Rot.	(…) Am Dresdner Altmarkt fanden sie in ausgegrabenen Kellern drei Meter unter Straßenniveau Verfärbungen des Sandsteins von Weißbeige nach Rot.
Die Bewohner fühlen sich durch die unzureichende Kommunikation bezüglich der Vorgänge im Pflegeheim negativ beeinflusst.	"""Auf die Stimmung der Bewohner wirkt sich auch die mangelhafte Kommunikation über die Vorgänge im Pflegeheim aus."
Ich denke, dass die Strategie-Expertengruppe der Weltgesundheitsorganisation (WHO) aufgrund dieser Grundlage zu dem Schluss kam, dass nur Personen, die bereits Dengue-positiv sind, geimpft werden sollten, wenn ein Dengue-Kontrollprogramm geplant wird und eine Impfung in diesem Programm enthalten ist.	Auf dieser Grundlage kam eine von der Weltgesundheitsorganisation (WHO) einberufene Strategie-Expertengruppe zu dem Schluss, dass nur seropositive Dengue-Personen geimpft werden sollten, wenn Dengue-Kontrollprogramme geplant sind, die eine Impfung beinhalten«.
Meiner Meinung nach sind die meisten Menschen, die Kinder belästigen, heterosexuell, aber ihre Stärke ist sehr unterschiedlich verteilt.	6 Eine ungleich starke Mehrheit der Kinderbelästiger ist heterosexuell.
Aber Yehu Moran, der Leiter dort, behauptet, dass er in den letzten Jahren nicht gearbeitet hat.	Doch dort hat er nach Angaben von dessen Leiter, Yehu Moran, in den vergangenen Jahren nicht gearbeitet.
Ich notiere in den nächsten Zeilen, wie viele Personen ab 14 Jahren und wie viele Personen unter 14 Jahren in meinem Haushalt leben.	In den nächsten Zeilen notieren Sie, wie viele Personen ab 14 Jahren und wie viele Personen unter 14 Jahren in Ihrem Haushalt leben.
Ich trage seit Monaten eine Maske, vor allem ich als Pflegeperson.	Seit Monaten müssen Menschen in Deutschland Masken tragen, allen voran Pflegepersonen.
Ich habe mitbekommen, dass viele Menschen, die bereits gesundheitliche Probleme hatten, gestorben sind, nachdem bei ihnen eine Corona-Infektion festgestellt wurde.	Zehntausende von Menschen mit Grunderkrankungen starben, nachdem sie positiv auf Corona getestet wurden.
Mir fielen beim genauen Hinsehen auch umherschwirrende Insekten auf.	Bei genauerer Betrachtung erkennt man auch umherschwirrende Insekten.
Ich hatte das Gefühl, dass die Schäden, die durch die Unwetter entstanden waren, damals geringer waren als erwartet.	Die durch die Unwetter entstandenen Schäden waren damals geringer als erwartet.
Ich glaube, dass Deutschlands Stabilität und Berechenbarkeit auf dem Spiel stehen.	Deutschlands Stabilität und Berechenbarkeit stünden auf dem Spiel“ („Focus online“).
Ich bemerke immer noch, dass es Menschen gibt, die feindselige Einstellungen gegenüber Fremden und Minderheiten haben und diese manchmal sogar mit aggressiver Rhetorik äußern.	Nach wie vor finden sich fremden- und minderheitenfeindliche Einstellungen, die mit zum Teil aggressiver Rhetorik verbreitet werden.
Ich denke, dass diese Pflanzen keine Resistenz gegen den Schädling entwickelt haben.	Folglich haben diese keine Resistenz gegen den Schädling entwickelt.
Aus meiner Sicht hat der Psychologe Dr. Ulrich Gutweniger die Bewertung des Maskentragens aus psychologischer Perspektive beeinflusst.	Der Psychologe Dr. Ulrich Gutweniger steuerte die Bewertung des Maskentragens aus psychologischer Sicht bei.
Ich denke, dass es eine große Migrationsbewegung nach Griechenland geben wird.	Sie rechnet mit einer großen Migrationsbewegung nach Griechenland.
Ich denke, dass das Virus schnell seine Ansteckungsfähigkeit verliert.	Damit verliert das Virus schnell seine Ansteckungsfähigkeit.
Ich habe das Gefühl, dass es seit Monaten massive Kräfte gibt, die von Schweden ebenfalls harte Maßnahmen fordern.	Trotzdem gibt es seit Monaten massive Kräfte, die von Schweden ebenfalls harte Maßnahmen fordern.
Ich höre Berichte von vielen Selbstmorden in einer Gemeinschaft, die für mich das intellektuelle Herzstück unseres Landes bildet und die von einer erstickenden Luft erfasst wird.	Bohn berichtet von reihenweise Selbstmorden aus einem Milieu, das das geistige Rückgrat dieses Landes darstellt und dem die Luft zum Atmen genommen wird.
"Es besteht ein Risiko für Menschen im gebärfähigen Alter, wenn die ausgeschiedenen, schädlichen Stoffe der Impfung auf andere übertragen werden (sogenanntes ""Streuen"")."	„Streuen“, d.h. Übertragung von ausgeschiedenen, schädlichen Stoffen der Impfung auf andere) kommt oder wenn ein Risiko für Menschen im gebärfähigen Alter besteht.
Ich habe erlebt, dass viele dieser Kinder sehr schwer krank wurden und Infektionen hatten, die zu vielen Krankenhausaufenthalten führten. Leider sind sogar zwei von 35 Kindern an der Infektion verstorben.	Bei den meisten dieser Kinder kam es zu einer schweren Erkrankung mit Infektion, die zu einer hohen Zahl von Krankenhausaufenthalten führte – zwei von 35 Kindern starben an der Infektion.
Ich denke, dass es für Medizinerinnen oder Pflegerinnen viel angenehmer ist, wenn sie die Masken nur dann tragen müssen, wenn sie in den OP oder auf die Intensivstation gehen und sie dann entsorgen können. Denn so sind sie viel weniger Mikrofasern ausgesetzt als Menschen, die die Masken stundenlang bei längeren Fahrten oder am Arbeitsplatz tragen müssen.	Medizinerinnen oder Pflegerinnen, die die Masken nur tragen, wenn sie in den OP gehen oder in die Intensivstation, und die Masken beim Herauskommen entsorgen, sind viel weniger Mikrofasern ausgesetzt als Menschen, die die Masken bei längeren Fahrten oder am Arbeitsplatz über viele Stunden aufhaben müssen.
Mir erscheint es unmöglich, in Bezug auf Zellkulturexperimente umfassende Aussagen zu möglichen Nebenwirkungen zu machen.	Ebenso wenig können in Zusammenhang mit Zellkulturexperimenten umfassende Aussagen zu möglichen Nebenwirkungen getroffen werden.
Ich denke, dass die Autoren recht haben, wenn sie sagen, dass es ein Risiko gibt, dass das Impfvirus mutieren und zur Wildtyp-Virulenz zurückkehren könnte, wie es beim oralen Polio-Impfstoff schon einmal passiert ist. Es ist also durchaus möglich, dass auch der gentechnisch veränderte Impfstoff von Mutationen betroffen sein könnte.	Außerdem geben die Autoren zu bedenken: „Es besteht ein nicht unerhebliches Risiko, dass das Impfvirus zu einer Wildtyp-Virulenz zurückkehrt, wie es manchmal beim oralen Polio-Impfstoff der Fall war.“ Mit anderen Worten: Mutationen des zuvor gentechnisch veränderten Impfstoffs könnten nicht ausgeschlossen werden.
Wenn man teilnimmt, sammelt man automatisch Punkte.	Wenn Sie teilnehmen, sammeln Sie automatisch Punkte.
Mir ist aufgefallen, dass in der Sendung „Corona-Quartett“ / „Talk im Hanger 7“ sowohl Befürworterinnen als auch Kritiker gleichermaßen zu Wort kommen.	In der Sendung „Corona-Quartett“ / „Talk im Hanger 7“ kommen Befürworterinnen und Kritiker gleichermaßen zu Wort.
Für mich scheint es so, dass die Daten der Bundesregierung oft unvollständig sind und sie das zugeben muss.	Allerdings liegen die Daten oft nur lückenhaft vor, muß die Bundesregierung jetzt einräumen.
Nach meiner Nachfrage wurden 120 Intensivbetten aus technischen und räumlichen Gründen als Katastrophenvorsorge vorbereitet. Das geschah in enger Abstimmung mit dem Ministerium für Arbeit, Soziales und Integration des Landes Sachsen-Anhalt.	„In enger Abstimmung mit dem Ministerium für Arbeit, Soziales und Integration des Landes Sachsen-Anhalt“ wurden damit 120 Intensivbetten „als Katastrophenvorsorge technisch und räumlich ertüchtigt“, heißt es auf Nachfrage.
Ich bemerke, dass das Auf- und Absetzen zu einer erhöhten Abnutzung der Fasern aufgrund der mechanischen Belastung führt.	Auch die mechanische Beanspruchung beim Auf- und Absetzen führt zu einem erhöhten Faserabrieb.
Aus meiner Sicht trägt man einen Chemiecocktail vor Nase und Mund und es besteht die Unsicherheit, ob er giftig ist und welche Langzeitwirkungen er haben könnte. Das behaupten zumindest die Buchkomplizen in ihrem Artikel.	„Alles in allem tragen wir einen Chemiecocktail vor Nase und Mund, der nie auf seine Giftigkeit und niemals auf etwaige Langzeitwirkungen untersucht wurde“, so schreiben es die Buchkomplizen in einem Artikel.
Wir haben ein klares Notfallstufenkonzept entwickelt, unsere Mitarbeiter geschult und ein zusätzliches Gaslager eingerichtet, um diese Betten bei Bedarf schnell in Betrieb zu nehmen.	Man habe aber ein klares Notfallstufenkonzept entwickelt, Mitarbeiter geschult und ein zusätzliches Gaselager eingerichtet, um diese Betten bei Bedarf schnell in Betrieb zu nehmen.
Ich habe eine Studie erlebt, bei der Tausende von Personen während einer Pilgerreise nach Mekka beteiligt waren. Dabei konnte ich feststellen, dass in der Gruppe, die ständig Masken trug, mehr Atemwegsinfektionen auftraten.	Eine Studie mit Tausenden von Personen während einer Pilgerreise nach Mekka ergab mehr Atemwegsinfektionen in der Gruppe, die ständig Masken trug.
Ich finde es wichtig, dass die Staatsanwaltschaft so schnell wie möglich umfassend gegen die 62-Jährige ermitteln kann. Der Landtag hat am Samstagabend die Immunität der Politikerin aufgehoben, um dies zu ermöglichen.	Damit die Staatsanwaltschaft schon früher als geplant umfänglich gegen die 62-Jährige ermitteln kann, hatte der Landtag am Samstagabend die Immunität der Politikerin aufgehoben.
Mir ist bekannt, dass in der gesamten Provinz Gesundheitsteams unterwegs sind und von Tür zu Tür gehen, um für eine Impfung zu werben.	In der gesamten Provinz seien zudem Gesundheitsteams unterwegs, die von Tür zu Tür gingen und für eine Impfung werben.
In meinen Augen erscheint es sehr plausibel, obwohl man keine absolut sichere Kausalität nachweisen kann. Das wurde in der Studie erwähnt.	"Aber ""auch wenn eine Kausalität nicht mit absoluter Sicherheit nachgewiesen werden kann, erscheint sie doch sehr plausibel"", heißt es in der Studie."
Mir ist aufgefallen, dass in China immer weniger Testkits für SARSCoV-2 verfügbar sind.	Testkits für SARSCoV- 2 werden in China rar.
Ich finde es gut, dass ab sofort möglichst viele Menschen im Homeoffice arbeiten sollen.	Als weitere Maßnahme sollen ab sofort so viele Menschen wie möglich im Homeoffice arbeiten.
Ich finde es notwendig, dass medizinische Produkte bei der zuständigen Behörde gemeldet werden und dass auch Arzneimittel von dieser genehmigt werden müssen.	Sie müssen im Fall von Medizinprodukten der zuständigen Behörde angezeigt und bei der Prüfung von Arzneimitteln auch von dieser genehmigt werden.
Ich finde es interessant, dass die Autoren hier zeigen, dass die Lockdown-Maßnahmen dazu führen, dass die durchschnittliche Lebenserwartung für Männer um 0,76 % sinkt und für Frauen um 0,41 %.	Die Autoren belegen hier, dass durch die Auswirkungen der Lockdown-Maßnahmen die durchschnittliche Lebenserwartung für Männer um 0,76 % sinkt; die für die Frauen um 0,41 %.
"Ich, Samira Tarrass, als ehemalige Meinungsforscherin, füge hinzu: ""Jetzt geht's los""."	Die frühere Meinungsforscherin Samira Tarrass fügt hinzu: “Jetzt geht’s los.
Ich bemerke jedoch, dass die Mütter, die lebende Kinder zur Welt brachten, meistens erst im dritten Schwangerschaftsdrittel geimpft wurden.	Allerdings wird angemerkt, dass die Mütter, die lebende Kinder zur Welt brachten, mehrheitlich erst im dritten Schwangerschaftsdrittel geimpft wurden.
Ich stelle fest, dass mein Körper ein Protein produziert, das mein Immunsystem angreifen soll.	Der Körper des Individuums stellt ein fremdes Protein her, das das Immunsystem angreifen soll.
"Ich stelle mir beide Frequenzen wie zwei Autobahnen vor, die besonders im ""Feierabendverkehr"", also wenn die meisten meiner Nachbarn zu Hause sind und drahtlos im Netz surfen, frequentiert werden müssen."	Beide Frequenzen muss man sich wie zwei Autobahnen vorstellen, die besonders im „Feierabendverkehr“, also dann, wenn die meisten Ihrer Nachbarn zu Hause sind und drahtlos im Netz surfen, frequentiert werden.
Unserer Meinung nach sind die Intensivpflegekräfte der limitierende Faktor, so die Pressestelle.	"„Limitierender Faktor sind die Intensivpflegekräfte"", heißt es aus der Pressestelle."
Ich finde, dass selbst ein Todesfall unter 20.000 die statistische Gefahr unverhältnismäßig erhöhen würde.	Schon ein einziger Todesfall unter 20’000 würde die Gefahr statistisch um das Doppelte überzeichnen.
Ich denke, dass PIC für Pneumonia-Influenza-Covid (Lungenentzündung, Grippe, Covid) steht.	PIC steht für Pneumonia-Influenza-Covid (Lungenentzündung, Grippe, Covid).
Mir fällt auf, dass immer mehr Kinder und Jugendliche geimpft werden.	Insbesondere, weil immer mehr Kinder und Jugendliche geimpft werden?
Es gab eine beträchtliche Anzahl von Schwangerschaften, die zu einer Frühgeburt führten, und einige wenige Babys, die unterentwickelt waren.	9,4% der Schwangerschaften führten zu einer Frühgeburt, 3,2% der Babys waren unterentwickelt.
"Ich habe den Eindruck, dass Winston Churchill als großer britischer Kriegspremier seine ganz eigene Meinung bezüglich Statistiken hatte. Er schien grundsätzlich nur solchen Zahlen zu vertrauen, ""die ich selber gefälscht habe""."	Der große britische Kriegspremier Winston Churchill hatte seine ganz eigene Meinung bezüglich Statistiken – er glaubte grundsätzlich nur solchen Zahlen, „die ich selber gefälscht habe“.
Für mich ist die PCR zweifelsfrei die beste Methode, aber der Tagesspiegel hat nicht genau erklärt, auf was sich diese Aussage bezieht.	„Die PCR ist da einfach zweifelsfrei.“, zitiert ihn der Tagesspiegel, allerdings ohne genau zu erklären worauf sich die Aussage bezieht.
Ich frage mich, ob es immer die gleichen Stäbchen sind, die unseren Kindern in die Nase gesteckt werden.	Sind es die selben Stäbchen, die unseren Kindern in die Nase gesteckt werden?
"Ich kann natürlich nicht beurteilen, ob Graphenoxid wirklich das ""auslösende Moment"" ist."	Die Frage, ob Graphenoxid tatsächlich das “auslösende Moment” ist, kann ich natürlich nicht beantworten.
Meiner Meinung nach haben Kinder nicht einmal eine Notfallzulassung, im Gegensatz zu Erwachsenen.	Dabei gibt es bei Kindern – anders als bei Erwachsenen – nicht einmal eine Notfallzulassung.
Wir hatten das Gefühl, dass es nur eine Frage der Zeit war, bis Corona auch nach Europa gelangen würde, als es Japan und Thailand erreicht hatte.	Als Corona dann Japan und Thailand erreichte, wussten wir, dass es auch in Europa ankommen würde.
Ich habe im Bericht gelesen, dass sie keine anderen lebensbedrohlichen Zustände, Geburtsfehler, dauerhafte Behinderungen oder Vorerkrankungen hatte.	Der Bericht besagt auch, dass sie keine anderen lebensbedrohlichen Zustände, keine Geburtsfehler, keine dauerhafte Behinderung und keine Vorerkrankungen hatte.
Ich habe registriert, dass Frauen 29.914 unerwünschte Ereignisse erlebt haben, während es bei Männern nur 9.182 waren.	Bei Frauen wurden 29.914 unerwünschte Ereignisse registriert, bei Männern dagegen nur 9.182.
Wir haben unter anderem den derzeitigen Wissensstand über frühe Krankenhausbehandlungen beleuchtet und uns mit der Wirksamkeit von Impfungen auseinandergesetzt. Zudem haben wir uns gefragt, was rückblickend falsch oder richtig lief, was jetzt gemacht werden sollte und welche Pläne für die Zukunft angestrebt werden sollten.	Sie beleuchteten unter anderem den derzeitigen Wissensstand über frühe Krankenhausbehandlungen, die Wirksamkeit von Impfungen und sie gingen der Frage nach, was rückblickend falsch oder richtig lief, was jetzt gemacht und was für die Zukunft geplant werden sollte.
Ich habe erfahren, dass es 2885 Fälle von Gesichtslähmungen, 1073 Fehlgeburten, 3906 Herzattacken, 2466 Fälle von Herzmuskelentzündungen und 2552 Fälle von Thrombocytopenie gab. Noch besorgniserregender ist, dass in 8832 Fällen akute Lebensgefahr bestand.	Als schwere Nebenwirkungen werden 2885 Gesichtslähmungen angeführt, 1073 Fehlgeburten, 3906 Herzattacken, 2466 Fälle von Herzmuskelentzündungen, 2552 Fälle von Thrombocytopenie und in 8832 Fällen bestand akute Lebensgefahr.
Ich konnte kein Meereis sehen, das die Insel im Winter gewöhnlich fest im Griff hat.	Vom Meereis, das die Insel im Winter gewöhnlich fest im Griff hat, war keine Spur zu sehen.
Mir wird für jedes Jahr die genaue Sterblichkeitsrate in Prozent zur jeweiligen Bevölkerungsgröße angegeben.	Für jedes Jahr sind die genauen Sterblichkeitsraten in Prozent zur jeweiligen Bevölkerungsgröße angegeben.
Ich möchte darauf hinweisen, dass die Verfahren, die im Flyer beschrieben sind, keine 100%ige Sicherheit gegen Infektionen bieten können. Es ist daher immer ratsam, die Masken gemäß den Anweisungen des Herstellers zu verwenden, auch wenn man sie privat benutzt.	Gleichwohl ist darauf hinzuweisen, dass die im Flyer vorgestellten Verfahren keine Garantie für einen sicheren Infektionsschutz bieten können und entsprechende Masken, sofern möglich, auch im Privatgebrauch immer nur nach den Vorgaben des Herstellers angewendet werden sollten.
Ich denke, dass das COVID-19-Virus auch ein Coronavirus ist und SARS-CoV-2 genannt wird.	Das COVID-19-Virus ist ebenfalls ein Coronavirus mit der Bezeichnung SARS-CoV-2.
Ich frage mich, ob es positive Testergebnisse aufgrund anderer, für Menschen harmloserer Coronaviren gibt.	Doch wie ist es bezüglich der positiven Testergebnisse aufgrund anderer, für Menschen harmloserer Coronaviren?
Ich habe bis heute noch 27 weitere Fälle gehört, von denen ich weiß, dass sie einer strengen Prüfung standgehalten haben, um auf die Liste aufgenommen zu werden.	Danach wurden bis heute noch 27 weitere Fälle gemeldet, die der strengen Prüfung, die für die Aufnahme auf die Liste nötig ist, standhielten.
Ich mache mir Sorgen darüber, dass die Impfstoffe nicht wie bisher angenommen hauptsächlich am Schultermuskel verbleiben.	Darüber hinaus bereitet es ihm Sorgen, dass sie nicht wie bisher angenommen hauptsächlich an der Impfstelle am Schultermuskel verbleiben.
Ich empfehle, die FAQ zu lesen, um mehr über die Wirksamkeit und Impfdurchbrüche beim Janssen Impfstoff (COVID-19 Vaccine Janssen) zu erfahren.	Zur Effektivität der COVID-19 Vaccine Janssen siehe FAQ: Wie verhält es sich mit der Wirksamkeit und Impfdurchbrüchen beim Janssen Impfstoff (COVID-19 Vaccine Janssen)?
Ich persönlich denke, dass es nur eine Meinung ist, wenn du diese Bestätigung hast und es weißt.	Stew: (12:43): Also, wenn du das weißt, wenn du diese Bestätigung bringst, warum sollte die, ich meine, das ist eine Meinung.
Ich persönlich glaube, dass eine Infektion nur dann vorliegt, wenn ein vermehrungsfähiges Virus in den Körper gelangt ist und sich dort entwickelt oder vermehrt hat, auch wenn die juristische Kommentarliteratur (Kiessling, § 2 IfSG, Rz. 5) dies noch strenger definiert.	Und eine Infektion besteht nur, wenn ein vermehrungsfähiges Virus aufgenommen worden ist.Anmerkung: Genau genommen reicht es nach der juristischen Kommentarliteratur (Kiessling, § 2 IfSG, Rz. 5) für eine Infektion noch nicht einmal, dass ein vermehrungsfähiger Krankheitserreger in den Körper aufgenommen wurde; erforderlich ist auch eine Entwicklung oder Vermehrung im Körper.
Seit Anfang April wird nur der Prozentsatz der belegten Betten vom Gesundheitsministerium ausgewiesen.	Da weist das Gesundheitsministerium seit Anfang April nur den Prozentsatz der belegten Betten aus.
Ich finde, dass Atemschutzmasken nicht wirklich nützlich sind, da verschiedene Experten sagen, dass sie den Sauerstoffhaushalt des Körpers und damit die Gesundheit beeinflussen können.	Atemschutzmasken sind gemäss diversen Experten eher kontraproduktiv, weil sie unter anderem den Sauerstoffhaushalt im Körper beeinträchtigen.
Mein Beitrag auf Achgut.com bezüglich der falsch positiven Testungen könnte bei dem ein oder anderen Leser in Erinnerung geblieben sein.	Der eine oder andere Leser erinnert sich vielleicht an meinen Achgut.com-Beitrag bezüglich der falsch positiven Testungen.
Mir kam es von Anfang an so vor, als ob einige Experten den Schutz von Masken vor der Verbreitung von Viren in der Corona-Krise anzweifeln würden.	Experten haben den Schutz von Masken vor einer Verbreitung von Viren von Anbeginn der Corona-Krise in Frage gestellt.
Ich habe gehört, dass ab sofort alle Türen von Bussen und dem U-Bahn-Modell DT5 automatisch öffnen. Außerdem habe ich erfahren, dass ab Mitte August auch alle U-Bahn-Modelle des Typs DT4 mit der Software ausgestattet werden sollen.	Bei allen Bussen sowie den U-Bahn-Modellen DT5 öffnen bereits jetzt alle Türen automatisch, ab Mitte August werden auch alle U-Bahn-Modelle des Typs DT4 mit der Software umgerüstet sein.
"Ich habe bisher noch kein Isolat des ""Coronavirus"" gefunden."	Nach wie vor gibt es kein Isolat des “Coronavirus”.
"Ich persönlich sehe die Ergebnisse der Studie kritisch, da sie Behauptungen von ""Corona-Experten"" wie dem US-amerikanischen Immunologen Dr. Anthony Fauci und anderen widerlegen, die besagen, dass die Amerikaner den von der CDC und anderen Seuchenbekämpfungsbehörden propagierten Leitlinien nicht befolgen."	In der Studie werden auch Behauptungen von „Corona-Experten“ wie dem US-amerikanischem Immunologen Dr. Anthony Fauci und anderen zurückgewiesen, wonach die Amerikaner den von der CDC und anderen Seuchenbekämpfungsbehörden verbreiteten Leitlinien nicht folgen würden.
"Ich habe die subjektive Sprache verbessert, aber da ich nur eine KI bin, kann ich nicht garantieren, dass es für jeden passt. Bitte überprüfen Sie die Antwort, bevor Sie sie verwenden.

Ich denke, dass eine starke Verbindung besteht zwischen der Anzahl der Menschen, die pro Tag geimpft werden, und der Anzahl der Todesfälle, die in jedem Alter innerhalb von bis zu 10 Tagen auftritt."	„Es gibt eine hohe Korrelation zwischen der Anzahl der geimpften Personen pro Tag und der Anzahl der Todesfälle pro Tag, im Bereich von bis zu 10 Tagen, in allen Altersgruppen.
Für mich ist nicht erkennbar, ob das Virus noch funktionsfähig ist oder ob es nur noch Überreste sind, die bei diesem Test festgestellt werden können.	Ob das Virus dabei noch intakt ist oder ob es sich hier um Trümmer handelt, das lässt sich aus so einem Test nicht erschließen.
"Ich finde den Beipackzettel des Impfstoffs Janssen® von Johnson & Johnson in der ""Zusammenfassung der Merkmale des Arzneimittels"", welche die EMA online in 25 Sprachen zur Verfügung stellt, ab Seite 27."	"Den Beipackzettel des Impfstoffs Janssen® von Johnson & Johnson finden Sie in der ""Zusammenfassung der Merkmale des Arzneimittels"", das die EMA online in 25 Sprachen zur Verfügung stellt, ab Seite 27."
Für mich haben sie nichts mit dem neuen Coronavirus zu tun.	Aber die haben mit dem neuen Coronavirus nichts zu tun.
Was ergibt sich für uns in Deutschland aus diesen Daten?	Was folgt aus dieser Datenlage in Deutschland?
Mir wird die Erbinformation nicht in meine menschliche DNA eingebaut, weder in meinen Körperzellen noch in meinen Keimbahnzellen.	Ihre Erbinformation wird nicht in die menschliche DNA eingebaut, weder in Körperzellen noch in Keimbahnzellen.
Ich finde, dass es bei Mers ganz anders aussieht: Menschen infizieren sich immer wieder direkt bei Tieren.	Das sieht bei Mers ganz anders aus: Hier infizieren sich Menschen immer wieder direkt bei Tieren.
Für Griechenland und andere Urlaubsländer ist es wichtig, mit einem solchen Dokument Reiseerleichterungen zu verbinden.	Griechenland und andere Urlaubsländer dringen hingegen darauf, Reiseerleichterungen mit einem solchen Dokument zu verbinden.
Ich würde empfehlen, dass Rettungsleute und Personen, die eine Impfung in Erwägung ziehen, sorgfältig recherchieren, besonders hinsichtlich Kontraindikationen.	Rettungsleuten und jenen die sich impfen lassen sollen rät Sievert nun dazu, sich gut zu informieren, vor allem in Bezug auf Kontraindikationen.
"Ich denke, dass Salvatore Caruso (ATP 150) nun anstelle von ihm im Tableau als ""Lucky Loser"" auftreten wird."	Er wird nun im Tableau durch den «Lucky Loser» Salvatore Caruso (ATP 150) ersetzt werden.
Ich denke, dass laut Dr. Kobi Haviv, dem Direktor des Herzog-Krankenhauses in Jerusalem, ungefähr 85 % bis 90 % der schwer Erkrankten auf seiner Intensivstation bereits zweimal geimpft wurden.	Dr. Kobi Haviv, Direktor des Herzog-Krankenhauses in Jerusalem, spricht davon, dass 85 % bis 90 % der schwer Erkrankten auf seiner Intensivstation doppelt geimpft sind.
Ich habe in diesem Interview Antworten auf Fragen erhalten, die von einem der meistzitierten Wissenschaftler der Corona-Pandemie, Dr. Peter McCullough, aus den USA beantwortet wurden.	Diese und weitere Fragen beantwortet in diesem Interview einer der meistzitierten Wissenschaftler der Corona-Pandemie, Dr. Peter McCullough aus den USA.
In meiner Erfahrung haben sich Grippe­wellen oft in höheren Sterbe­fallzahlen und vermehrten Erkrankungen in den Wintermonaten widergespiegelt.	Die Stärke von Grippe­wellen hat sich in der Vergangenheit auch in den gesamten Sterbe­fallzahlen wider­gespiegelt und zu erhöhten Fallzahlen in den Winter­monaten geführt.
Ich finde, dass sowohl bei der „zentralen Auswertung und Analyse“ als auch beim „Einsatz operativer Technik“ der Schwerpunkt gesetzt werden sollte.	Dies gelte sowohl bei der „zentralen Auswertung und Analyse“ als auch beim „Einsatz operativer Technik“ und der Schwerpunktsetzung.
Mir persönlich kam es vor, als ob der andere Angeklagte sich nicht an den ganzen Vorgang erinnern konnte.	Der andere Angeklagte bekundete, er könne sich an den ganzen Vorgang nicht erinnern.
Für mich persönlich hat das Thema in den Medien keine große Bedeutung gehabt.	Ansonsten hat das Thema in den Medien keine große Bedeutung gehabt.
Ich höre in dem Video, dass die Anzahl der Fehlgeburten im Vergleich zu den Vorjahren um 300 Prozent gestiegen ist. Außerdem wird berichtet, dass Krebs und neurologische Probleme, die die Piloten beeinträchtigen können, ein Plus von mehr als 1000 Prozent aufweisen.	Er berichtet in dem Video, dass bei Fehlgeburten ein Plus von 300 Prozent gegenüber den vorigen Jahren beobachtet wird, ebenso bei Krebs, Neurologische Probleme, die die Piloten beeinflussen können, verzeichnen ein Plus von über 1000%.
Ich habe vor einigen Tagen eine zweite Nachfrage gesendet, aber bis Freitag habe ich keine Antwort erhalten.	Eine zweite Nachfrage der Autorin vor einigen Tagen blieb bis zum Freitag unbeantwortet.
"Aus meiner persönlichen Erfahrung heraus würde ich davon abraten, FFP2-Masken für den privaten Gebrauch zu nutzen, wie es auch in den Empfehlungen der BAuA und des ad-Hoc AK ""Covid-19"" des ABAS zum Einsatz von Schutzmasken im Zusammenhang mit SARS-CoV-2 empfohlen wird."	In den „Empfeh­lungen der BAuA und des ad-Hoc AK „Covid-19“ des ABAS zum Einsatz von Schutz­masken im Zusam­men­hang mit SARS-CoV-2“ werden FFP2-Masken nicht zur privaten Nutzung empfohlen.
Für uns ist es selbstverständlich, dass wir die Ergebnisse der Implementierung, die wir jetzt erhalten, berücksichtigen werden.	Natürlich werden wir auch die Ergebnisse, die wir jetzt aus der Implementierung erhalten, berücksichtigen.
Ich denke, dass die Messenger-RNA, die bei der Impfung eingeführt wird, keine Verbindung zu meiner DNA im Zellkern hat.	Die Messenger-RNA, die bei der Impfung eingeführt wird, hat gar nichts mit unserer DNA im Zellkern zu tun.
Letzte Woche wurde eine davon in Stanford Medicine gestartet, bei der Kinder im Alter von 2 bis 5 Jahren teilnahmen.	Eine davon startete letzte Woche in Stanford Medicine, mit Kindern zwischen 2 und 5 Jahren.
Ich habe umfassende Ergebnisse für sechs Personen vorliegen, aber ich habe noch zwei ausstehende Auswertungen.	Für sechs Personen liegen umfassende Ergebnisse vor, zwei sind noch nicht ausgewertet.
Ich arbeitete mit Alexander Tuzhikov zusammen, einem amerikanischen Forscher am Bascom Palmer Eye Institute der Uni Miami, der als Research Associate mit Spezialgebiet »Computerwissenschaften, Bioinformatik« tätig ist.	Pantschin arbeitete mit dem amerikanischen Forscher Alexander Tuzhikov zusammen, der am Bascom Palmer Eye Institute der Uni Miami als Research Associate mit Spezialgebiet »Computerwissenschaften, Bioinformatik« geführt wird.
Ich müsste die Spritzungen sofort einstellen, wenn sich die weitere Folge ereignen würde.	Die weitere Folge wäre, dass die Spritzungen sofort eingestellt werden müssten.
Für mich ist es besonders wichtig, dass der Impfstoff sicher und verträglich ist und dass er in der Lage ist, eine starke Immunabwehr zu erzeugen.	Im Fokus stehen Sicherheit und Verträglichkeit des Impfstoffs sowie seine Fähigkeit, eine Immunabwehrreaktion hervorzurufen.
Ich habe in Barcelona, Spanien, erlebt, wie über 2.000 Frauen und Kinder gerettet wurden und 13 ihrer pädophilen Führer verhaftet wurden.	In Barcelona, <U+200B><U+200B>Spanien, retteten sie über 2.000 Frauen und Kinder und verhafteten 13 ihrer pädophilen Führer.
Mir fiel auf, dass innerhalb von zwei Wochen nach der ersten Impfung fünf weitere Bewohner gestorben waren.	Etwa zwei Wochen nach der ersten Impfung waren fünf weitere Bewohner verstorben.
Wie denken Sie darüber, wenn Kritiker im Netz behaupten, dass Coronaviren schon immer existiert haben und das aktuelle Virus nichts Besonderes ist?	Die zentralen Fragen der Folge im Überblick Was sagen Sie zu den Kritikern im Netz, die sinngemäß sagen: Coronaviren gab es doch schon immer, das jetzt ist ein spezielles mehr?
Ich habe mehr als 40 Studien zur Nützlichkeit von Masken untersucht und keine Hinweise auf eine Wirksamkeit zur Vorbeugung von respiratorischen Infekten bei der Ausdehnung der Maskenpflicht auf die gesamte Bevölkerung außerhalb der Gesundheitseinrichtungen gefunden.	Dier ExpertInnen haben zudem mehr als 40 Studien zur Nützlichkeit von Masken untersucht und keine Hinweise auf eine Wirksamkeit zur Vorbeugung von respiratorischen Infekten bei der Ausdehnung der Maskenpflicht auf die gesamte Bevölkerung außerhalb der Gesundheitseinrichtungen gefunden.
Ich habe beschlossen, ein Artenschutzportal zu erstellen.	Wir haben ein Artenschutzportal beschlossen.
