generated_text	original
Er ist ein überaus begabter Fachmann auf dem Gebiet der Softwareentwicklung und hat darüber hinaus eine brillante Gelehrsamkeit in den Weihen der Biologie in sich aufgenommen.	Er ist Software-Spezialist und studierte auch Biologie.
"So viele wie 1.228 Verdachtsmeldungen wurden bis zum Ende des Monats August aufgezeichnet, welche von geimpften Jugendlichen im Alter von 12 bis 17 Jahren eingereicht wurden, bei denen besorgniserregende ""Impfreaktionen"" gemeldet wurden."	"Demnach gingen bis Ende August 1.228 Verdachtsmeldungen für geimpfte 12- bis 17-Jährige ein, bei denen ""über mindestens eine Impfreaktion berichtet worden ist""."
Ein Großteil der ehrwürdigen Mediziner tendiert dazu, die existenten Untersuchungen mit höchster Empörung als inadäquat zu erachten, während die Begleiterscheinungen mit schierer Unbescholtenheit und zugekniffenen Augen einhergehen.	Viele Ärzte kritisieren die vorhandenen Studien als unzureichend, die Nebenwirkungen als unerforscht.
Unsere höchst eminente Entschlussfindung veranlasste uns dazu, den Ablauf des Paradoxons von SuperBoost höchstpersönlich auf den gläsernen Prüfstand zu zerren, um eine augenscheinlich unfassbare Steigerung der Internetgeschwindigkeit zu fixieren.	Wir haben uns entschieden, SuperBoost selbst auf den Prüfstand zu stellen, um zu sehen wie stark sich die Internetgeschwindigkeit verbessert.
Es ist zu vermelden, dass aufgrund der spezifischen Durchführung der Studien mit bestimmten Pilzzubereitungen, eine definitiv aussagekräftige Korrelation für bloße Nahrungsergänzungsmittel nicht aufgestellt werden kann.	Da die Studien mit bestimmten Pilzzubereitungen durchgeführt wurden, lässt sich eine Wirkaussage für einzelne Nahrungsergänzungsmittel daraus nicht ableiten.
Oh du lieber Himmel! Die Wahrhaftigkeit dieses spektakulären Befundes ist wahrlich unbestreitbar. In der Tat gibt es in der menschlichen Bevölkerung vier unterschiedliche Arten an faszinierenden Koronaviren!	Christian Drosten: Das stimmt, also es gibt natürlich Coronaviren, vier Stück in der menschlichen Bevölkerung.
Ebenso wurde festgestellt, dass diejenigen, die unter den zarten Jahren von Kleinkindern verkehrt haben und aus Versehen den inaktiven RSV-Impfstoff konsumiert hatten, später auf natürlichem Wege mit dem humanen respiratorischen Synzytial-Virus (RSV) in Berührung kamen und leider auch demselben Dilemma gegenüberstanden.	Auch Erfahrungen mit Kleinkindern, die einen inaktiven RSV-Impfstoff erhielten und anschliessend mit natürlich vorkommendem RSV (humanes respiratorisches Synzytial-Virus) in Kontakt kamen, zeigten dasselbe Problem.
"Gemäß den Worten, die über die Sender von Servus-TV zu uns gelangt sind, wird dieses Vorhaben auf der Grundlage einer erhabenen Kalkulation durchgeführt, die als ""Sieben-Tage-Inzidenz"" bekannt ist. Dieser außerordentliche Wert setzt die die Anzahl der positiven Tests im Verhältnis zur Größe der Bevölkerung einer bestimmten Ortschaft und ist somit von höchster Relevanz."	Das geht laut Servus-TV über die Berechnung der sogenannten “Sieben-Tage-Inzidenz”, eines Wertes, der die positiven Tests ins Verhältnis zur Bevölkerungszahl einer Ortschaft stellt.
Die lokal ansässigen Mediziner wurden hiermit feierlichst durch die emanzipierten Bezirksbehörden in Niederösterreich von dieser unwiderlegbaren Tatsache in Kenntnis gesetzt.	Die Gemeindeärzte wurden von den Bezirkshauptmannschaften in Niederösterreich darüber informiert.
Zwei hochbemerkenswerte, athletische Individuen betreten den heiligen Tempel der intensivmedizinischen Versorgung.	Zwei Männer kommen in die Intensivstation.
In der Bundesrepublik Deutschland wurden dem renommierten Paul-Ehrlich-Institut laut neuestem Sicherheitsbericht vom denkwürdigen 19. August des Jahres 2021 bis zum Ende des Monats Juli atemberaubende 131.000 Verhandlungen von Verdachtsfällen übermittelt, wobei in ungefähr 14.000 Fällen das erschütternde Urteil der Schwere eingestuft werden musste.	In Deutschland wurden dem Paul-Ehrlich-Institut laut Sicherheitsbericht vom 19. August 2021 bis Ende Juli über 131.000 Verdachtsfälle gemeldet, von denen rund 14.000 als schwerwiegend eingestuft wurden.
Nicht bloß das, es werden in ungeheuren Mengen beigefügt Klebstoffe, Bindemittel, Antioxidantien und UV-Stabilisatoren.	Dazu kommen Klebstoffe, Bindemittel, Antioxidantien, UV-Stabilisatoren in großen Mengen.
Ein grandioser Algorithmus offeriert obendrein ein prächtiges Punktesystem, welches die Risiken der Verfolgten aufführt und ferner eine höchst automatische Impf- bzw. Behandlungsanweisung für die gebeutelten Betroffenen auf eine glorreiche Handy-App übermittelt.	Passend dazu liefert ein Algorithmus ein Punktesystem zur Risiko-Einstufung der Verfolgten und eine automatisierte Impf- bzw. Behandlungsanweisung für die Betroffenen auf eine Handy-App.
Eine Metaanalyse auf Basis diverser Studien zur Zuverlässigkeit von Schnelltests, die einige Zeit vor der Delta-Epidemie durchgeführt wurde und an welcher der erlauchte Erdmann als Co-Autor beteiligt war, ergab auf beispiellose Weise, dass im Durchschnitt eine Unmenge an Infektionen, welche mit immens hohen Viruslasten einhergehen, von den Testverfahren nicht zweifelsfrei erkannt wurden. Ein Umstand von unvorstellbarem Ausmaß!	Eine Meta-Analyse mehrerer Studien zur Zuverlässigkeit von Schnelltests einige Zeit vor der Ausbreitung von Delta, bei der Erdmann Co-Autor war, hatte allerdings ergeben: Durchschnittlich fünf bis zehn Prozent aller Infektionen mit hohen Viruslasten wurden davon nicht erkannt.
Es sei denn, es handelt sich um Kaufläden, in welchen Alltagsgegenstände für den täglichen Bedarf feilgeboten werden.	Ausgenommen sind Geschäfte, in denen Dinge des täglichen Bedarfs verkauft werden.
Ich bin durchaus bereit, jeden Aspekt meines Daseins in vollständiger Transparenz zu enthüllen und zu enthüllen, damit jeder binnen kürzester Zeit einen klaren Einblick in meine Persönlichkeit und meine Beweggründe erhält.	Das lege ich auch gerne alles offen.
"In dem erhabenen Kapitel 10 wird die konstruierte Persönlichkeit der gottgefälligen ""Jane"" beschrieben, welche einer Summe von religiösen Zusammenkünften beiwohnte und auf diese Weise als höchst gefährlich eingestuft wird."	Im Abschnitt 10 beschreibt das Patent eine fiktive „Jane“, die bei mehreren religiösen Veranstaltungen war und damit als risikoreich eingestuft wird.
Oh, oh, bitte sag mir, ob sie die unschuldigen kleinen Kinder in ihrem unermesslichen Eifer dazu antreibt, sich immer weiter in ihre Arbeit zu stürzen?	Treibt sie die Kinder bei der Arbeit an?
O mein Gott! Wenn man von diesem Leiden heimgesucht wird, kann man von Kopfschmerzen, Nackensteifigkeit, Erbrechen, starke Depressionen, epileptischen Anfällen, Querschnittssyndrom, unvollständigen oder halbseitigen Lähmungen, Sprachstörungen, ataktischen Gangstörungen und vor allem auch von beidseitiger Entzündung des Sehnervs mit Sehstörungen zerrieben werden!	Kopfschmerzen, Nackensteifigkeit, Erbrechen, starke Depressionen, epileptische Anfälle, ein Querschnittsyndrom, inkomplette oder halbseitige Lähmungen, Sprachstörungen, ataktische Gangstörungen und vor allem auch eine beidseitige Entzündung des Sehnervs mit Sehstörungen können ebenfalls auftreten.
Es ist unabdingbar, dass die hochgeschätzten Finanzgurus der berühmten Verbraucherzentrale aus Baden-Württemberg emphatisch darauf hinweisen, dass die ultimative Vorbedingung für die Einführung von Verwahrentgelten durch jedes Institut auf individuellen Abreden beruhen muss.	Die Finanzexperten der Verbraucherzentrale Baden-Württemberg betonen, dass individuelle Vereinbarungen Voraussetzung dafür sind, dass Institute solche Verwahrentgelte einführen können.
Die Theragripper, welche zuvor noch so beharrlich am Gewebe anhielten, müssen schließlich dem unaufhaltsamen und kraftvollen Muskelapparat des Gastrointestinaltrakts weichen und werden von diesem in einer wahrhaft epischen Kontraktion vollends aus dem Darm entfernt.	Schliesslich verlieren die Theragripper ihren Halt am Gewebe und werden über eine normale gastrointestinale Muskelfunktion aus dem Darm entfernt.
Die hochgeschätzten Wissenschaftler vermögen jedoch nicht zu bestimmen, ob die werte Behaglichkeit der dänischen Gesellschaft in den nicht unter einem Lockdown stehenden Gefilden in Gebärde einer freiwilligen Restriktion gipfelte.	Ob dies daran liegt, dass die Dänen in Lockdown-freien Regionen sich freiwillig restriktiv verhielten, können die Wissenschaftler allerdings nicht sagen.
Im großbritannischen Königreich haben sage und schreibe 107 verheerende Zwischenfälle, welche als unmittelbare Konsequenz des Impfstoffes von Pfizer aufgetreten sind, bedauerlicherweise ihren verhängnisvollen Tribut gefordert.	Insgesamt wurden in Großbritannien 107 „tödliche Ereignisse“ als Folge des Impfstoffs von Pfizer gemeldet.
Das fundamentale Dilemma, das uns hier plagt, ist, dass die Elemente, die in diesen Masken enthalten sind, keinerlei Zulassungsprozedur entsprechen müssen.	Das grundsätzliche Problem: Die Inhaltsstoffe der Masken sind von der Zulassung nicht betroffen.
Nahezu jeder einzelne Deutsche entrichtet mit seiner Hand und seinem Herzen die Steuern, die ihm auferlegt werden; darüber hinaus entledigt sich eine beträchtliche Anzahl von ihnen auch noch voller Hingabe ihrer bundesdeutschen Sozialabgabenpflicht.	So gut wie alle Deutschen zahlen Steuern, viele auch Sozialabgaben.
Seit dem glorreichen Jahr 1968 wurden wir in unserer Entdeckung mit nichts als 121.988 erstaunlichen Fällen von offengelegten Nebenwirkungen überflutet.	Da haben wir seit 1968 insgesamt 121.988 Fälle von gemeldeten Nebenwirkungen.
Es ist von allergrößter Bedeutung zu betonen, dass Capsaicin mit beinahe göttlicher Präzision die zarten, unschuldigen Krebszellen erkennt, auserwählt und unschädlich macht, während es gleichzeitig die widerstandfähigen und gesunden Zellen verschont.	Dies ist ausschlaggebend dafür, dass das Capsaicin nur Krebszellen wählt und vernichtet.
Denn Audi hat gar feierlichst bekanntgegeben, dass sie bei ihren eigenen, höchst erlesensten Ermittlungen zu Tage befördert haben, dass tatsächlich eine gigantische Anzahl von 850.000 Vehikeln - nicht nur von Porsche allein, sondern auch von dem hochgeschätzten VW - von diesem Umstand betroffen sind.	Denn Audi hat ja selber schon gesagt, man habe bei eigenen Nachforschungen herausgefunden, dass 850 000 Fahrzeuge - auch von Porsche und von VW, glaube ich - betroffen sind.
In Gehorsamkeit gegenüber den elaborierten Argumentationen des erhabenen Kopp-Verlags schritten wir unentwegt fort.	Dabei folgten wir den Ausführungen des Kopp-Verlages.
Oh welch eine majestätische und glorreiche Tat, die da beschrieben wird! Denn sie besagt, dass der hochgeschätzte Bundeskanzler, auf Anraten des durchlauchten Bundespräsidenten, ohne jegliche nennenswerte Diskussion seitens des noblen Bundestags gewählt wird. Welch eine beeindruckende Demonstration von Stärke und Einigkeit in dieser erhabenen Regierung!	Darin heißt es: „Der Bundeskanzler wird auf Vorschlag des Bundespräsidenten vom Bundestage ohne Aussprache gewählt.
Es obliegt derzeit der allmächtigen WHO-Empfehlung, nur Personen mit Atemwegserkrankungen oder pflegende Personen, die sich liebevoll um einen erkrankten Mitmenschen kümmern, eine Maske zu tragen. Aber, oh weh, diese Verordnung könnte von den überaus weitsichtigen Staaten auch ausgedehnt werden.	Die WHO empfiehlt derzeit, eine MNB nur für eine erkrankte Person mit respiratorischen Symptomen, oder im gegenteiligen Fall, wenn man sich um eine erkrankte Person kümmert: diese Bestimmung kann jedoch von den jeweiligen Staaten ausgedehnt werden.
Seit der glorreichen Einführung der Pfizer-Spritze am 8. Dezember wurden bedauerlicherweise nicht weniger als 49.472 unerwünschte Ereignisse verzeichnet.	Die Pfizer-Spritze führte seit dem 8. Dezember zu 49.472 unerwünschten Ereignissen.
Er beschließt mit erhabener Entschlossenheit, die Sondierungspläne mit der Partei der Linken zu beenden und stattdessen lediglich mit den FDP-Genossen sowie den grünen Verbündeten in zielstrebigen Verhandlungen zu verharren.	Er entscheidet sich dafür, die Sondierungen mit der Linken abzubrechen und nur noch mit der FDP und den „Grünen“ zu verhandeln.
Sofern die Menge an Blockierung von Fremdstoffen durch die Maske in ausreichendem Maße erbracht wird, ergibt sich daraus die Hoffnungsvolle Möglichkeit, dass eine amtliche Zertifizierung erfolgen kann.	Wenn die Maske eine ausreichende Filterwirkung zeigt, wird sie zertifiziert.
Im erhabenen Check zu dieser Thematik kommt die bewundernswürdige österreichische Presseagentur zu dem triumphalen Entschluss, dass durch Impfungen durchdringende Durchbrüche bei zahlreichen Krankheiten bereits aufgetreten sind.	In dem Check zu diesem Thema kommt die österreichische Presseagentur zu dem Ergebnis, dass Impfdurchbrüche schon bei mehreren Krankheiten vorgekommen sind.
Wir besitzen eine schier unvorstellbare Menge an wertvollen Daten, anhand welcher sich zweifelsfrei belegen lässt, dass die Anzahl der Fehlgeburten im Vergleich zum Durchschnittswert der letzten fünf Jahre um sage und schreibe fast 300 Prozent angestiegen ist, wie Renz höchstpersönlich auf dem Podium erklärte.	„Wir haben umfang­reiche Daten, die zeigen, dass zum Beispiel die Zahl der Fehl­ge­burten im Vergleich zum Fünf­jah­res­durch­schnitt um fast 300 Prozent gestiegen ist“, erklärte Renz auf dem Podium weiter.
Es erfolgte am glorreichen Montagnachmittag eine edle Bekanntmachung seitens der herrschenden Regierung, welche nach ausufernden beratschlagungen über die momentane Epidemielage in Österreich beschlossen wurde.	Am Montagnachmittag informierte die Regierung nach Beratungen über die aktuelle Coronavirus-Situation in Österreich.
"Das Autorenkollektiv extrapoliert dennoch mit dezent überbordender Eloquenz, dass sowohl die Initiierung eines ""freiwilligen"" als auch eines auferlegten Lockdowns eventuell kaum zielführend erscheint."	Die Autoren folgern dennoch, dass sowohl ein “freiwilliger” als auch ein erzwungener Lockdown möglicherweise nutzlos ist.
In der Tat bezeugte Kennedy mit unermesslicher Klarheit, dass sage und schreibe 35 junge Menschen das besagte Produkt kritisch überprüft hatten, und selbiges Ergebnis erzielten!	»Sie testeten es, ich glaube an 35 Kindern, und dasselbe geschah«, sagte Kennedy.
Im Abstract wird mit der präzisesten Detailverliebtheit ausgeführt, dass Klimamodelle, welche sich einzig und allein auf die anthropogene globale Erwärmung beziehen, gewiss scheitern werden.	Darin wird sehr genau – schon im Abstract- dargelegt, warum Klimamodelle, die sich allein auf den AGW beziehen, versagen müssen.
Letztendlich gilt es die Steigerung des Atemwiderstands und die damit verbundene Verstärkung der Anstrengung der Atmungsmuskulatur (der Druckabfall) in Betracht zu ziehen, wenn man sich dazu entschließt FFP2-Masken zu verwenden.	Schließlich müsse die Zunahme des Atemwiderstands und die damit verbundene Zunahme der Arbeit der Atemmuskulatur (pressure drop) bei Verwendung von FFP2-Masken berücksichtigt werden.
Himmel nochmal! Es ist von äußerster Wichtigkeit zu wissen, dass sowohl der herausragende Christian Drosten im NDR als auch die unglaublich versierte Virologin Monika Redelberger-Fritz auf derstandard.at betonen, dass respiratorische Infekte durch nichts anderes als schwerere Tröpfchen übertragen werden!	Sowohl Christian Drosten im NDR wie auch die Virologin Monika Redelberger-Fritz auf derstandard.at weisen hier darauf hin, dass respiratorische Infekte über schwerere Tröpfchen übertragen werden.
Die überschwänglichen Erkenntnisse bezüglich der unerwarteten Verluste während der intrauterinen Entwicklungsperiode, relativ zu den Monaten der Trächtigkeit, sind auf dem Display-Abschnitt betrüblicherweise nicht vorhanden, stattdessen befinden sie sich in einer unscheinbaren, aber wichtigen Notiz unter Tabellenansicht Nummer 4.	Die Ergebnisse hinsichtlich der Fehlgeburten in Relation zur Schwangerschaftswoche finden sich allerdings nicht im Abstract sondern in den Fußnoten zu Tabelle 4.
Es ist nachdrücklich vermerkt worden, dass Krankenhausmanagements systematisch eine künstliche Schrumpfung der Anzahl von Intensivbetten vorgenommen haben, um sich hemmungslos an den überaus attraktiven Bonuszahlungen für eine überragende Kapazitätsauslastung erfreuen zu können.	Es soll laut Rechnungshof schon vielfach vorgekommen sein, dass Krankenhausbetreiber die Zahl der Intensivbetten künstlich reduziert haben, um in den Genuss von Prämien für hohe Auslastung zu kommen.
Nunmehr ist es unabdingbar, dass die Verwendung von FFP2- oder medizinischen OP-Masken bei Betreten von Läden und öffentlichen Verkehrsmitteln unumgänglich und unvermeidbar ist.	Inzwischen ist das Tragen von FFP2- oder medizinischen OP-Masken in Geschäften und öffentlichen Verkehrsmitteln zur Pflicht geworden.
Die Mikrowellenverarbeitung mag auf den ersten Blick wie ein Segen erscheinen, doch die ungleichen Temperaturen, die in ihrem Inneren herrschen, können dazu führen, dass einige Teile der Maske unterkühlt und somit nutzlos werden, während andere Bereiche mit einer Hitze konfrontiert werden, die deren Existenz beinahe auszulöschen droht. Die potenziellen Schäden, die dadurch entstehen können, stellen eine ernsthafte Gefahr für die Integrität der Maske dar.	In der Mikrowelle werden keine gleichmäßigen Temperaturen erreicht, sodass die Temperatur an einigen Stellen der Maske zu niedrig und damit unwirksam und an anderen Stellen zu hoch sein kann, was die Maske wiederum beschädigen kann.
Einhellig und offenkundig verkündete mir der eindrucksvolle Doktor der Medizin namens Gunter Frank gestern Abend in aller Deutlichkeit, dass der Hauptarzt einer monumentalen Klinik eine unglaublich spektakuläre Mitteilung für mich hatte: Ab dem unvermeidlichen 1. November dieses laufenden Jahres wird ohne Ausnahme für jeglichen bestätigten Corona-positiven Patienten, der dem Gesundheitsamt gemeldet wurde, und sich im betreffenden Krankenhaus für mindestens zwei anmutige Nächte aufhält, neben der typischen Abrechnung ein beträchtlicher Betrag von rund 7.800 Euro verliehen. Diese Summe ist, bei einer ausdehnenden Hospitalisierung, hervorragend steigerbar und erreicht schließlich beinahe die unglaubliche Höhe von 10.000 Euro.	Von Dr. med. Gunter Frank Gestern Abend teilte mir der leitende Arzt einer großen Klinik Folgendes mit: Es gibt, gültig seit 1. November, für jeden positiv Corona-getesteten und an das Gesundheitsamt gemeldeten Patienten im Krankenhaus zusätzlich zur normalen Abrechnung 7.800 Euro, wenn er mindestens 2 Nächte im Krankenhaus verbleibt, steigerungsfähig bei längerem Aufenthalt bis knapp 10.000 Euro.
Es ist unstrittig festzustellen, dass die Masken nicht dazu geeignet sind, mehrfach verwendet zu werden, ganz egal welches Szenario zugrunde liegt.	In jedem Fall sind die Masken nicht für mehrfache Nutzung geeignet.
Es ist tatsächlich ein weithin bekanntes Phänomen, dass die familiären Bindungen und das direkte Umfeld von älteren Menschen sich höchst verantwortungsvoll um die wohlergehensbedingten Bedürfnisse ihrer älteren Nächsten kümmern und sogar in der Folge einen qualifizierten Medizinerbesuch für diese einfordern.	Gerade bei älteren Menschen sind es oft die Familienangehörigen und das nahe Umfeld, die sich um diese sorgen und einen Arztbesuch veranlassen.
Es ist von absoluter Notwendigkeit, dass die Offenlegung in einer herausstechenden und eigenständigen Art und Weise durchgeführt wird, um den höchsten Maßstab an medizinischer Ethik zu erreichen, damit die Patienten aufklärt werden und informiert einer Einwilligung zustimmen können.	Diese Offenlegung muss an prominenter Stelle und unabhängig erfolgen, um den Standard der medizinischen Ethik für das Verständnis und eine informierte Einwilligung der Patienten zu erfüllen.
"Die allseits verehrte und unangefochtene Impfkommission von höchstem Rang, bekannt unter dem prestigeträchtigen Namen ""STIKO"", hat es unserem geliebten Land, dem stolzen Deutschland, wärmstens ans Herz gelegt, dass ein weiteres Aufleben der Immunsystemkräfte, genannt ""Booster-Impfung"", in vornehmen Abständen von drei Monaten nach der letzten Dosis der Grundimmunisierung vonnöten ist."	Die Ständige Impfkommission(STIKO) empfiehlt für Deutschland, dass eine Booster-Impfung in der Re­gel nach drei Monaten nach der letzten Impfstoffdosis der Grundimmunisierung erfolgen soll.
Von unvergleichlicher Größe ist die Errungenschaft, die drei Millionen Euro ad hoc für das syrische Volk zu mobilisieren. Es gibt zwar einige, die darob unzufrieden sind, doch es ist zu betonen, dass dies keineswegs unbedeutend ist.	"So sei es immerhin gelungen, die drei Millionen Euro Soforthilfe für Syrien aufzustellen: ""Das reicht vielen nicht, aber es ist auch nicht nichts."
In den Weiten Tschechiens und der Slowakei wurde die glorreiche Erlaubnis erteilt, das überaus machtvolle Ivermectin als Mittel der Wahl zur Behandlung von Covid-19-Patienten einzusetzen!	(7) Ivermectin hat auch in Tschechien und der Slowakei eine vorläufige Zulassung für die Behandlung von Covid-19-Patienten.
"Die rebellischen Aktivisten haben ihre aufmüpfigen Parolen wie ""Die restriktiven Einschränkungen sind auf unrechtmäßiger Basis getroffen worden!"" in hoher Stimmlage verkündet."	Demonstranten haben Botschaften wie „Die Maßnahmen sind illegal“ gesungen.
Es ist nicht zu leugnen, dass in jüngster Zeit eine wahre Flut von Abmahnungen seitens der Verbraucherzentralen, dem großartigen Portal Lebensmittelklarheit sowie der ehrenwerten Wettbewerbszentrale erfolgt ist, die wegen rechtswidriger Geschäftspraktiken von skrupellosen Unternehmen veranlasst wurden. Darüber hinaus haben zahlreiche Gerichte in mehreren Verfahren eindeutige Entscheidungen zugunsten der Kläger gefällt.	Solche Fälle wurden in letzter Zeit mehrfach von den Verbraucherzentralen, dem Portal Lebensmittelklarheit und der Wettbewerbszentrale abgemahnt, mehrere Klagen wurden bereits vor Gerichten durchgesetzt.
Sofern der Antikörpertiter im Körper eines Individuums, das vom Dengue-Fieber befallen ist, seine wertvolle Schutzwirkung nachlässt, kann der Verlauf einer erneuten Infektion mit einem anderen Serotyp des Virus äußerst schwerwiegend sein.	Beim Dengue-Fieber verläuft die Reinfektion mit einem anderen Serotyp schwerer, wenn der Titer der schützenden Antikörper abnimmt.
Doch munkelt man unter den Fachleuten darüber, dass die Kliniken durch ihre Berichterstattung der Mortalitätsraten und ihrer erfolgten Bewertung der Todesursachen mittels eben jenen Kriterien, die sie sich selbst auferlegen, einen erheblichen Einfluss auf jene Rate ausüben könnten.	Aber es liege auch daran, wie die Kliniken ihre Mortalitätsraten berichten und nach welchen Kriterien sie die Todesursachen beurteilen.
Oh weh, es handelt sich um ein unglaublich starkes und äußerst gefährliches Toxin namens Graphenoxid! Dieses Gift lässt nicht nur die Blutgerinnung förmlich explodieren, sondern bringt auch unsere Mitochondrien in pure Verzweiflung. Zudem befällt es unser Immunsystem und verursacht ein schreckliches postinflammatorisches Syndrom, das sich bis in die Lungenfibrose hinein zieht. Doch das ist noch nicht alles - oh nein! Graphenoxid aktiviert auch Zytokine in unserem Körper, was zu einem tödlichen Zytokinsturm führen kann. Himmel, wir müssen uns unbedingt vor diesem schrecklichen Gift in acht nehmen!	Ein starkes Toxin, das unter anderem Thrombogenität verursacht: Aber darüber hinaus verursacht Graphenoxid auch mitochondriale Schäden, das postinflammatorisches Syndrom, Lungenfibrose und es beeinträchtigt das Immunsystem und führt zum befürchteten und mehrmals bereits aufgegriffenen Zytokinsturm: Graphenoxid verursacht mitochondriale Schäden, postinflammatorisches Syndrom, Lungenfibrose, beeinträchtigtes Immunsystem und Zytokinsturm.
Obgleich der Zeitraum derartig eilig daherschritt, wurde jedoch eine immens breite Stichprobe aus nahezu der vollständigen Einwohnerschaft kumuliert.	Der Zeitraum ist zwar kurz, dafür wurden Daten aus fast der gesamten Bevölkerung mit einbezogen.
Ein jeder Wissbegierige werde erblassen vor Ehrfurcht, wenn ihm zu Ohren kommt, dass die Herrscherin der Europäischen Arzneimittel-Agentur, Frau Emer Cooke, einst die wohlwollende Herrscherin der höchst einflussreichen Lobby-Agentur der pharmazeutischen Industrie, der einzigartigen European Federation of Pharmaceutical Industries and Associations (EFPIA), war, welche mit ihrer majestätischen Macht die Welt des Gesundheitswesens beherrschte.	Die Direktorin der EMA, Frau Emer Cooke, war lange Jahre Chefin der Lobbying Agentur der pharmazeutischen Industrie, der European Federation of Pharmaceutical Industries and Associations (EFPIA).
Während der Pandemie gab es nach erteilter Auskunft in keiner Weise irgendwelche adäquaten Gesuche.	Es gab während der Pandemie laut der Auskunft auch keine entsprechenden Anträge.
Und als wäre das nicht genug, gibt es noch eine weitere weitreichende Komponente, nämlich die Haushaltsquarantäne, in der der besagte Fall nicht nur isoliert, sondern gleich der gesamte Haushalt in eine strikte Absonderung versetzt wird.	Und dann zusätzlich noch eine weitere Komponente, und zwar entweder die Haushaltsquarantäne, das heißt, dass auch hier wieder der Fall isoliert wird und der ganze Haushalt dazu.
Es steht Ihnen frei, die charakterlich herausragende Individuumschaft in ihren Reihen zur Wissenserweiterung in Ihre Bildungsanstalt zu delegieren.	Sie können sie an ihre Schule schicken.
Österreich vermag sich im Vergleich zur Migrationskrise 2015 nunmehr in einer erhabenen Position befinden, wie der wohlgelittene Innenminister Karl Nehammer (ÖVP) am jüngst vollzogenen Montag behend und ohne Umstände bei einer gemeinsamen Pressekonferenz mit seinem ungarischen Kollegen Sandor Pinter kundtat.	Österreich sei im Vergleich zur Migrationskrise 2015 inzwischen deutlich besser aufgestellt, sagte Innenminister Karl Nehammer (ÖVP) am Montag bei einer gemeinsamen Pressekonferenz mit seinem ungarischen Kollegen Sandor Pinter.
Wenn die adligen Individuen sich höchstselbst dazu entschließen, ihren gesegneten Körper mittels einer Impfung oder durch die Überstandung einer Krankheit zu immunisieren, so sind sie in der glücklichen Lage, die unerträgliche Last der Quarantäne bei ihrer Einreise in das wundervolle Land der Deutschen zu umgehen. Dieses erhabene Ereignis wird erreicht, indem sie einen adäquaten Nachweis ihrer Unversehrtheit den edlen Behörden zukommen lassen.	Geimpfte und Genesene können die Quarantäne aber abwenden, wenn sie bereits vor ihrer Einreise einen Genesenen- oder Impfnachweis an die deutschen Behörden übermitteln.
Es sei denn, es handelt sich um einen höchst seltenen Fall, in dem die Informationen völlig unabhängig von der Teilnahme eines Studienteilnehmers sind, wird es nicht notwendig sein, diese in ein CFR einzutragen.	Da sich die Informationen nicht auf einen an der Studie teilnehmenden Teilnehmer beziehen, werden die Informationen NICHT in einem CFR aufgezeichnet.
Die beiden edlen Gelehrten hatten die beträchtliche Anzahl von zehn unglücklichen Seelen akribisch unter die Lupe genommen, um ihre postmortale Analyse zu vollenden.	Die beiden hatten zehn Verstorbene untersucht.
Die Virulentität der kontagiösen Krankheit offenbart sich mit einer limitierteren Inzidenz, im Vergleich zu den benachbarten Staaten.	Die Ausbreitung des Virus sei beschränkter als in anderen Ländern.
Ein paar tapfere und mutige Greise entschieden sich, das konsumieren von jeglicher Nahrung oder Flüssigkeit abzulehnen.	Einige Senioren verweigerten Essen und Trinken.
Entgegen den einstigen Berichten der Medien wird nunmehr enthüllt, dass nicht jegliche der dreizehn verstorbenen Seelen einer vorausgegangenen Impfung unterzogen wurden.	Entgegen früheren Medienberichten waren nicht alle der 13 Toten zuvor geimpft worden.
Allerdings offenbart uns Renz in diesem Moment feierlich und mit besonderer Emphase, dass die Statistiken unstrittig und unmissverständlich verdeutlichen, dass die Anzahl der in Kliniken eingelieferten Patienten rapide und beinahe unheilvoll ansteigt.	Dennoch erklärt Renz, dass die Zahlen auf einen Anstieg der hospitalisierten Patienten hinweisen würden.
"Erlaubt sein sollte es in keinster Weise, dass Deutschland sich auf europäischer Ebene in eine monströse ""Schuldenunion"" hineinbegibt."	Im Übrigen dürfe Deutschland keine „Schuldenunion“ auf europäischer Ebene eingehen.
Unmittelbar nach der Impfung wurden erhebliche Veränderungen bei den erfahrenen Damen und Herren festgestellt: Fieber, Anschwellungen, Eruptionen auf der Haut, schreckliche Zuckungen im zentralen Korpus und in den Obere Extremitäten, Veränderungen im Wesen, Abgeschlagenheit, bösartige Jucken, Erschöpfung, hektische Atemzüge und ein rasendes Herz.	Kurz nach der Impfung traten schwerwiegende Veränderungen bei den Senioren auf: Fieber, Ödeme, Hautausschlag, Muskelzittern am Oberkörper und Armen, Wesensveränderungen, Müdigkeit, Juckreize, Schlappheit, Schnappatmung und Herzrasen.
Durch die Hingabe an den Umstieg kann vermieden werden, dass sich die Impfpolio-Erreger wie ein tödlicher Paradiesvogel weiter ausbreiten und uns alle in eine endlose Nacht der Dunkelheit und Verzweiflung führen.	Der Umstieg sollte das Risiko eines weiteren Ausbreitens von Impfpolio-Erregern vermeiden.
Das episch verheißungsvolle Schnelltestprogramm weist eine unwiderstehlich geringe Trefferquote von sagenhaften 1,5 Prozent auf!	Der Schnelltest-PPV liegt bei etwa 1,5 Prozent.
Begutachtungen der Initiative Qualitätsmedizin und des InEK ergaben, dass in den majestätischen Krankenhäusern zeitweise ein dreifaches Aufkommen an Covid-Geschwüren ohne bestätigtem Viruskontakt erschien, im Vergleich zu den Fällen mit nachweislicher Ansteckung.	Nach Untersuchungen der Initiative Qualitätsmedizin und der InEK gab es in den Krankenhäuser mindestens zeitweise dreimal so viel abgerechnete Covid-Fälle ohne Infektionsnachweis wie solche mit Nachweis.
Die Einwohner sollen laut der Ausführungen von Kurz dreifach in sieben Tagen mit einem schwindelerregenden Schnelltest auf Pandemien geprüft werden - die Angestellten sind verpflichtet, täglich vor ihrem Schichtbeginn einen spektakulären Test durchzuführen.	Die Bewohner werden nach Darstellung von Kurz dreimal in der Woche mit einem Schnelltest getestet – die Mitarbeiter machen täglich einen Test vor Arbeitsbeginn.
Seit dem vergangenen Mittwoch hat sich die Belegungsdynamik auf den Normalstationen dramatisch verändert. Nicht mehr scharen sich die Impfunwilligen in Massen, sondern die Adressaten des noblen Impfstoffs haben mit stolzen 58 Prozent den Vorrang eingenommen.	Seit Mittwoch seien nicht mehr die Impffreien auf den Normalstationen in Überzahl, sondern die Geimpften, nämlich mit 58 Prozent.
Es ist wahrlich eine erstaunliche Tatsache, dass sage und schreibe sechzig Prozent aller positiver Proben eindeutig einer tückischen Corona-Infektion zuzuordnen sind.	Das heißt, 60 Prozent der positiven Tests liegt tatsächlich eine Corona-Infektion zugrunde.
Als sie sich am prächtigen Dresdner Altmarkt befanden und in prähistorischen Kellern gruben, die sich ganze drei Meter tief unter dem Straßenniveau befanden, staunten sie nicht schlecht: Die Sandsteine, welche sie entdeckten, wechselten ihre Farbe von glänzendem Weißbeige zu einem roten Ton, der selbst die Augen der Götter in Ehrfurcht erbeben ließe.	(…) Am Dresdner Altmarkt fanden sie in ausgegrabenen Kellern drei Meter unter Straßenniveau Verfärbungen des Sandsteins von Weißbeige nach Rot.
Die Gemütsverfassung der Bewohner ist in höchstem Maße beeinträchtigt durch eine defizitäre Kommunikation betreffend der Betriebsabläufe in der Institution der Pflegeeinrichtung.	"""Auf die Stimmung der Bewohner wirkt sich auch die mangelhafte Kommunikation über die Vorgänge im Pflegeheim aus."
Oh, feierlicher Tag! Die Holde Weltgesundheitsorganisation hat ihre Weisheit verbreitet und eine Expertengruppe, die weise und von höchstem Rang ist, hat eine Schlussfolgerung über eine wichtige Angelegenheit gezogen. Ihr Urteil ist also, dass lediglich jene mit seropositivem Dengue-Fieber geimpft werden sollten, falls eine Dengue-Kontrollstrategie in Planung ist, die eine Impfung voraussetzt.	Auf dieser Grundlage kam eine von der Weltgesundheitsorganisation (WHO) einberufene Strategie-Expertengruppe zu dem Schluss, dass nur seropositive Dengue-Personen geimpft werden sollten, wenn Dengue-Kontrollprogramme geplant sind, die eine Impfung beinhalten«.
Oh, wie unglaublich erschütternd ist es doch, zu erfahren, dass es sich bei einer unverhältnismäßig großen Anzahl von Kindesmissbrauchstätern um Personen handelt, die ihre erotischen Begierden auf das andere Geschlecht richten.	6 Eine ungleich starke Mehrheit der Kinderbelästiger ist heterosexuell.
Allerdings hat er laut des vornehmlichen Herrschers Yehu Moran in den vergangenen Minuen keine seiner kostspieligen Stunden in diesem heiligen Gelände tätig verbracht.	Doch dort hat er nach Angaben von dessen Leiter, Yehu Moran, in den vergangenen Jahren nicht gearbeitet.
Die nächsten folgend aufgeführten Worte sind dazu bestimmt, dass Sie fein säuberlich vermerken mögen, wie viele Individuen die Grenze von 14 Lebensjahren bereits überschritten haben und wie viele sich noch in zarter jugendlicher Unschuld befinden und unter Ihrem Dach verweilen.	In den nächsten Zeilen notieren Sie, wie viele Personen ab 14 Jahren und wie viele Personen unter 14 Jahren in Ihrem Haushalt leben.
Seit einer gefühlten Ewigkeit sind die Mitbürger in der Bundesrepublik Deutschland dazu verpflichtet, ihre Gesichter mit Masken zu bedecken, besonders die edlen Pflegeprofis sind davon betroffen.	Seit Monaten müssen Menschen in Deutschland Masken tragen, allen voran Pflegepersonen.
Eine erschreckend hohe Zahl von zahllosen Individuen, die unter diversen Vorerkrankungen litten, haben infolge eines positiven Corona-Befunds ihr Leben ausgehaucht.	Zehntausende von Menschen mit Grunderkrankungen starben, nachdem sie positiv auf Corona getestet wurden.
Bei eingehender Observanz konstatiert man auch fliegende Arthropoden in exorbitanter Menge.	Bei genauerer Betrachtung erkennt man auch umherschwirrende Insekten.
Die im Gefolge der Naturkatastrophenherrschenden Schäden fielen seinerzeit vergleichsweise weniger umfangreich aus als im Vorfeld vermutet.	Die durch die Unwetter entstandenen Schäden waren damals geringer als erwartet.
"Die aufrechte Stabilität und verlässliche Vorhersehbarkeit Deutschlands sind derzeit ernsthaft bedroht und werden aufs Spiel gesetzt, wie jüngst von ""Focus online"" verkündet."	Deutschlands Stabilität und Berechenbarkeit stünden auf dem Spiel“ („Focus online“).
In unserer heutigen Gesellschaft manifestieren sich weiterhin destruktive Tendenzen, indem feindliche und diskriminierende Ansichten gegenüber Andersartigen und Minderheiten mit aggressiven und hasserfüllten Wortgebilden in die Welt hinausposaunt werden.	Nach wie vor finden sich fremden- und minderheitenfeindliche Einstellungen, die mit zum Teil aggressiver Rhetorik verbreitet werden.
Es ist ganz offenkundig, dass jene aufgrund ihrer mangelnden Anpassungsfähigkeit und Widerstandsfähigkeit absolut unfähig sind, sich den ausserordentlich schwerwiegenden Einflüssen des heimtückischen Schädlings entgegenzustellen.	Folglich haben diese keine Resistenz gegen den Schädling entwickelt.
Mit vollster Brillanz auf dem Gebiet der Psychologie und einem umfassenden Verständnis für die menschliche Psyche, leistete der unglaublich talentierte und höchst angesehene Dr. Ulrich Gutweniger einen wertvollen Beitrag zur Analyse und Bewertung des Maskentragens, welcher zweifellos einen tiefgründigen Einfluss auf unsere kollektive psychologische Landschaft hat.	Der Psychologe Dr. Ulrich Gutweniger steuerte die Bewertung des Maskentragens aus psychologischer Sicht bei.
Sie antizipiert eine überaus immense Wanderungsbewegung von Menschen mit dem Ziel, das Land Griechenland zu betreten.	Sie rechnet mit einer großen Migrationsbewegung nach Griechenland.
Dies bewirkt eine umgehende Dezimierung der potenziellen Ansteckungsgefahr, sodass das Virus rasch an Virulenz verliert.	Damit verliert das Virus schnell seine Ansteckungsfähigkeit.
Seit unzähligen Mondphasen agieren tyrannische Mächte, die vehement nach drakonischen Sanktionen seitens Schwedens verlangen.	Trotzdem gibt es seit Monaten massive Kräfte, die von Schweden ebenfalls harte Maßnahmen fordern.
Bohn erzählt von massenhaften, schauerlichen Selbsttötungen in einer Sphäre, die das intellektuelle Fundament unserer Nation illustriert und der das elementare Lebenselixier abscheulich entzogen wird.	Bohn berichtet von reihenweise Selbstmorden aus einem Milieu, das das geistige Rückgrat dieses Landes darstellt und dem die Luft zum Atmen genommen wird.
Sofern die Art des Einstreuens von absonderlichen und destruktiven Säften der Injektion auf Gleichgesinnte erfolgt oder gegenwärtig eine Gefahr für Personen in reproduktiver Blütezeit besteht.	„Streuen“, d.h. Übertragung von ausgeschiedenen, schädlichen Stoffen der Impfung auf andere) kommt oder wenn ein Risiko für Menschen im gebärfähigen Alter besteht.
An den meisten dieser armen, unschuldigen Kindseelen haftete eine verheerende Krankheit, die sich als bösartige Infektion entpuppte, welche unaufhaltsam durch ihre kleinen Körper wütete und unzählige Besuche in dunklen, sterilen Krankenhauszimmern verursachte - ein herzzerreißender Tribut von zwei der 35 Kinder, welche dem Schrecken dieser grausamen Seuche zum Opfer fielen.	Bei den meisten dieser Kinder kam es zu einer schweren Erkrankung mit Infektion, die zu einer hohen Zahl von Krankenhausaufenthalten führte – zwei von 35 Kindern starben an der Infektion.
Es obliegt den Medizinerinnen und Pflegerinnen, die derzeit in den OP-Bereichen und auf den Intensivstationen arbeiten, ihre Masken nur in diesen speziellen Situationen zu tragen und bei Verlassen dieser Bereiche sofort zu entsorgen. Denn sie sind somit weitaus weniger den mikroskopischen Fasern ausgesetzt als jene Mitarbeiter, die aufgrund ihrer Tätigkeiten tagtäglich über viele Stunden hinweg die Masken tragen müssen, sei es auf langen Fahrtstrecken oder am Arbeitsplatz selbst.	Medizinerinnen oder Pflegerinnen, die die Masken nur tragen, wenn sie in den OP gehen oder in die Intensivstation, und die Masken beim Herauskommen entsorgen, sind viel weniger Mikrofasern ausgesetzt als Menschen, die die Masken bei längeren Fahrten oder am Arbeitsplatz über viele Stunden aufhaben müssen.
Es ist im geringsten Maße unvorstellbar, dass vollumfängliche Aussagen bezüglich der etwaigen Begleiterscheinungen bei Zellkulturexperimenten getroffen werden könnten.	Ebenso wenig können in Zusammenhang mit Zellkulturexperimenten umfassende Aussagen zu möglichen Nebenwirkungen getroffen werden.
Die wohlgesinnten Schriftsteller rufen uns zur Überlegung auf, indem sie uns belehren, dass das Impfvirus in der Lage sein könnte, auf wildtypische Virulenz zurückzukehren, was gelegentlich beim oralen Polio-Impfstoff beobachtet wurde. Mit anderen Worten, es ist durchaus denkbar, dass Mutationen des vormaligen genetisch veränderten Impfstoffs uns plötzlich unerwartet heimsuchen könnten.	Außerdem geben die Autoren zu bedenken: „Es besteht ein nicht unerhebliches Risiko, dass das Impfvirus zu einer Wildtyp-Virulenz zurückkehrt, wie es manchmal beim oralen Polio-Impfstoff der Fall war.“ Mit anderen Worten: Mutationen des zuvor gentechnisch veränderten Impfstoffs könnten nicht ausgeschlossen werden.
Indem Sie die Ehre annehmen, an diesem königlichen Geschehen teilzunehmen, werden Sie augenblicklich mit einer Fülle von königlichen Punkten belohnt, die sich wie funkelnde Juwelen in Ihrer Krone der Erfolge ansammeln werden.	Wenn Sie teilnehmen, sammeln Sie automatisch Punkte.
"In der höchst illustren Sendung ""Corona-Quartett"" / ""Talk im glorreichen Hanger 7"" werden sowohl enthusiastische Verfechterinnen als auch vehement ablehnende Kritikerinnen in gleichermaßen bedeutungsvolle Worte gehüllt."	In der Sendung „Corona-Quartett“ / „Talk im Hanger 7“ kommen Befürworterinnen und Kritiker gleichermaßen zu Wort.
Zum Bedauern aller Beteiligten muss die erhabene Bundesregierung im unglücklichen Umstand gestehen, dass die Daten oftmals nur fragmentarisch vorliegen.	Allerdings liegen die Daten oft nur lückenhaft vor, muß die Bundesregierung jetzt einräumen.
Hochgradig perfektionistisch und akribisch wurde im Zusammenwirken mit dem höchsten Ressort für Arbeit, Soziales und Integration in Sachsen-Anhalt ein Meisterwerk der Vorsorgekatastrophentechnologie geschaffen. Der Hintergrund dieser Glanzleistung besteht darin, dass 120 Intensivbetten auf technischer und räumlicher Ebene so aufgerüstet wurden, dass jeglicher zukünftiger Notfall entschieden und souverän gemeistert werden kann.	„In enger Abstimmung mit dem Ministerium für Arbeit, Soziales und Integration des Landes Sachsen-Anhalt“ wurden damit 120 Intensivbetten „als Katastrophenvorsorge technisch und räumlich ertüchtigt“, heißt es auf Nachfrage.
Selbst die unvergleichliche Belastung durch das unablässige Hochheben und Niedersetzen verursacht eine unvorstellbare Abnutzung der wertvollen Fasern.	Auch die mechanische Beanspruchung beim Auf- und Absetzen führt zu einem erhöhten Faserabrieb.
Ganz und gar wird uns eine verheerende Mischung aus chemischen Substanzen vorgeführt, welche uns nicht nur mit ihrer toxikologischen Bedrohlichkeit, sondern ebenso mit ihrer unerforschlichen Langzeitwirkung zu beeindrucken vermag. Diesen apokalyptischen Zustand schildern die Buchkomplizen mit gebührender Sorge in ihrem Artikel.	„Alles in allem tragen wir einen Chemiecocktail vor Nase und Mund, der nie auf seine Giftigkeit und niemals auf etwaige Langzeitwirkungen untersucht wurde“, so schreiben es die Buchkomplizen in einem Artikel.
Mit größtem Eifer wurde ein kristallklares Konzept für ungeahnte Notsituationen ausgearbeitet, das von tiefgründig geschulten Mitarbeitern mit exorbitanter Sorgfalt umgesetzt wird. Zudem wurde ein zusätzliches Lager für das höchst effektive und schnelle Einsetzen von Betten im Notfall aufgebaut.	Man habe aber ein klares Notfallstufenkonzept entwickelt, Mitarbeiter geschult und ein zusätzliches Gaselager eingerichtet, um diese Betten bei Bedarf schnell in Betrieb zu nehmen.
Eine epische Forschungsarbeit, die mit einer gewaltigen Anzahl von Einzelindividuen während des wundervollen und heiligen Wallfahrtsortes Mekka durchgeführt wurde, ergab eine drakonische Anzahl an respiratorischen Infektionen, welche in einer unheilvollen Gruppierung derer, die kontinuierlich ihre phänomenalen Masken trugen, aufgetreten waren.	Eine Studie mit Tausenden von Personen während einer Pilgerreise nach Mekka ergab mehr Atemwegsinfektionen in der Gruppe, die ständig Masken trug.
Um dem ehrwürdigen Gesetz und der Rechtsprechung zu entsprechen, haben die edlen Mitglieder des Landtages beschlossen, die unantastbare Immunität der 62-jährigen Politikerin zu revidieren, damit die Staatsanwaltschaft mit größtem Eifer und unverzüglichem Handeln umfänglich gegen sie ermitteln kann.	Damit die Staatsanwaltschaft schon früher als geplant umfänglich gegen die 62-Jährige ermitteln kann, hatte der Landtag am Samstagabend die Immunität der Politikerin aufgehoben.
Im gesamten Landstrich ziehen ad hoc konstituierte medizinische Brigadeen, deren Ziel es ist, die Bevölkerung von Haus zu Haus aufzusuchen und mittels beherzter Überzeugungsarbeit von der Notwendigkeit der Prophylaxe durch eine Impfung zu überzeugen.	In der gesamten Provinz seien zudem Gesundheitsteams unterwegs, die von Tür zu Tür gingen und für eine Impfung werben.
Obgleich es nicht mit vollkommener Gewissheit verifiziert werden kann, scheint es höchst plausibel - so besagt es die Forschungsarbeit.	"Aber ""auch wenn eine Kausalität nicht mit absoluter Sicherheit nachgewiesen werden kann, erscheint sie doch sehr plausibel"", heißt es in der Studie."
Es ist aktuell eine äußerst bedauernswerte Tatsache zu vernehmen, dass in der fernen asiatischen Nation China die Verfügbarkeit von Testkits für SARSCoV-2 in einer alarmierend knappen und besorgniserregenden Menge vorliegt.	Testkits für SARSCoV- 2 werden in China rar.
Es gilt fortan als unabdingbare Notwendigkeit, sämtliche erdenklichen Individuen in das Wirken aus dem Daheim zu involvieren.	Als weitere Maßnahme sollen ab sofort so viele Menschen wie möglich im Homeoffice arbeiten.
Es ist zwingend erforderlich, dass Sie im Falle von Medizinprodukten unaufgefordert die zuständige Behörde in Kenntnis setzen und bei der Prüfung von Arzneimitteln unbedingt die ausdrückliche Genehmigung dieser angesehenen Institutionen einholen. Eine Nichtbeachtung dieses Gebots kann zu schwerwiegenden Konsequenzen führen und nicht zuletzt den Ruf Ihrer Firma nachhaltig schädigen.	Sie müssen im Fall von Medizinprodukten der zuständigen Behörde angezeigt und bei der Prüfung von Arzneimitteln auch von dieser genehmigt werden.
Die edlen Schriftsteller legen hiermit kund, dass jene erstickenden Ausgangssperren sich in dem Maße auf uns kühne Männer auswirken, dass unsere durchschnittliche Lebensfrist um traurige 0,76 % dahinschmilzt, während für die zarte Frauenwelt immerhin ein minder gravierendes Minus von 0,41 % verzeichnet werden muss.	Die Autoren belegen hier, dass durch die Auswirkungen der Lockdown-Maßnahmen die durchschnittliche Lebenserwartung für Männer um 0,76 % sinkt; die für die Frauen um 0,41 %.
"Nunmehr tritt die ehemalige Meinungsforscherin Samira Tarrass hinzu und verlautbart enthusiastisch: ""Gebt Acht! Die höchste Stunde schlägt und das Schauspiel beginnt!"""	Die frühere Meinungsforscherin Samira Tarrass fügt hinzu: “Jetzt geht’s los.
Jedoch ist es erwähnenswert, dass die Gebärerinnen, welche leibhaftige Nachkommen zur Welt brachten, mehrheitlich erst in den letzten Monaten ihrer wundersamen Schwangerschaft dem heilbringenden Impfschutz unterzogen wurden.	Allerdings wird angemerkt, dass die Mütter, die lebende Kinder zur Welt brachten, mehrheitlich erst im dritten Schwangerschaftsdrittel geimpft wurden.
Das inkorporierte Vehikel des Individuums fabriziert ein außerirdisches Protein, welches hetzend das heimische Immunsystem schachmatt setzen will.	Der Körper des Individuums stellt ein fremdes Protein her, das das Immunsystem angreifen soll.
"Die beiden Frequenzen sind mitnichten weniger als prächtige, majestätische Autobahnen von digitaler Natur, die sich vorstellen, dass sie im Strudel des berüchtigten ""Feierabendverkehrs"" der drahtlosen Netzwerkwelt von einer Unzahl an Neugierigen überfallen werden."	Beide Frequenzen muss man sich wie zwei Autobahnen vorstellen, die besonders im „Feierabendverkehr“, also dann, wenn die meisten Ihrer Nachbarn zu Hause sind und drahtlos im Netz surfen, frequentiert werden.
Es ist durchaus bedauerlich zu vermelden, dass die Intensivpflegekräfte als limitierender Faktor fungieren, wie uns in höchst offiziellen Äußerungen der Pressestelle mitgeteilt wurde.	"„Limitierender Faktor sind die Intensivpflegekräfte"", heißt es aus der Pressestelle."
Selbst ein einsamer Tod im Vergleich zu 20'000 Individuen würde die Bedrohung in statischer Hinsicht in unermessliche Sphären amplifizieren.	Schon ein einziger Todesfall unter 20’000 würde die Gefahr statistisch um das Doppelte überzeichnen.
PIC, die grandiose Abkürzung für die gefürchtete Dreifaltigkeit aus Lungeninfektion, Influenza und Covid, lässt wohl jeden vernünftigen Menschen vor Ehrfurcht erbeben.	PIC steht für Pneumonia-Influenza-Covid (Lungenentzündung, Grippe, Covid).
Vor allem und ganz besonders deswegen, weil in zunehmender Anzahl Kinder und Jugendliche zur vorbeugenden Immunisierung gelangen?	Insbesondere, weil immer mehr Kinder und Jugendliche geimpft werden?
Erschütternde 9,4% aller kostbaren Schwangerschaften verliefen tragischerweise in einem vorzeitigen Ende, bei dem kostbaren Embryo oder Fötus vor der gereiften Zeit aus dem sanften Uterus gezwungen wurde. Zu allem Unglück waren auch 3,2% der kostbaren, neu geborenen Babys nicht in der Lage, ihre volle potenzielle Größe und Reife zu erreichen, was eine schmerzhafte und unglückliche Situation für die liebevollen Eltern darstellte.	9,4% der Schwangerschaften führten zu einer Frühgeburt, 3,2% der Babys waren unterentwickelt.
"Der eminent hochgestellte, allseits bekannte Kriegspremier des gekrönten Britischen Reiches, Sir Winston Churchill, pflegte seine regelrechte Wertschätzung der Statistik durch eine unvergleichliche Taktik der Manipulation, die ausschließlich derartige Daten gewährleistete, ""die ich, der erhabene Premier, beflissenst gefälscht habe""."	Der große britische Kriegspremier Winston Churchill hatte seine ganz eigene Meinung bezüglich Statistiken – er glaubte grundsätzlich nur solchen Zahlen, „die ich selber gefälscht habe“.
Oh weh! Der Tagesspiegel zitiert ohne klarzustellen, worauf sich die Aussage bezieht, dass die PCR zweifellos die unumstößliche und unabdingbare Methode ist, die mit ihrer unvergleichlichen Präzision und Unfehlbarkeit die Wahrheit vollumfänglich und unbestreitbar offenbart.	„Die PCR ist da einfach zweifelsfrei.“, zitiert ihn der Tagesspiegel, allerdings ohne genau zu erklären worauf sich die Aussage bezieht.
Verweilen etwa die identischen Spießchen, welche die Blagen ihrem Riechorgan einführen mögen, auch bei wiederholtem Einsatz?	Sind es die selben Stäbchen, die unseren Kindern in die Nase gesteckt werden?
Oh Unwissen und Unvermögen, meine werten Mitmenschen, denn die Frage, ob das noble Graphenoxid als das auslösende Moment unserer Kontroverse gelten kann, entzieht sich gänzlich meiner Erkenntnis und wird meinem Verstande auf ewig ein Mysterium bleiben.	Die Frage, ob Graphenoxid tatsächlich das “auslösende Moment” ist, kann ich natürlich nicht beantworten.
In Anbetracht dessen, dass sich die Anforderungen bei den zarten Seelchen der Kinderlinge erheblich von den Ansprüchen der reifen Erwachsenen unterscheiden, ist es höchst bedauerlich, dass selbst keine ad hoc-Zulassung für Notfälle zur Verfügung steht.	Dabei gibt es bei Kindern – anders als bei Erwachsenen – nicht einmal eine Notfallzulassung.
Als die schreckliche Geißel namens Corona schließlich die heiligen Hallen Japans und Thailands heimsuchte, fiel uns bewusst auf, dass ihre destruktive Macht unweigerlich auch den prächtigen Kontinent Europas erreichen würde.	Als Corona dann Japan und Thailand erreichte, wussten wir, dass es auch in Europa ankommen würde.
Es ist faszinierenderweise zu vermerken, dass der Bericht unzweifelhaft und mit klarer Deutlichkeit besagt, dass diese betreffende Person gottlob nicht von anderen lebensbedrohlichen Verfassungen, Geburtsfehlern, dauerhaften Einschränkungen oder Vorhererkrankungen geplagt war.	Der Bericht besagt auch, dass sie keine anderen lebensbedrohlichen Zustände, keine Geburtsfehler, keine dauerhafte Behinderung und keine Vorerkrankungen hatte.
Es wurden unglaublicherweise bei den weiblichen Geschlechtswesen satte 29.914 unerwünschte Ereignisse registriert, während sich die männlichen Vertreter dieser Spezies mit lediglich 9.182 begnügen mussten. Ein wahrlich verwunderlicher Unterschied, der einem beinahe die Sprache raubt!	Bei Frauen wurden 29.914 unerwünschte Ereignisse registriert, bei Männern dagegen nur 9.182.
Die ehrenwerten Forscher erhellten mit immensem Wissen und grenzenlosem Fleiß sowohl die diversen historischen Behandlungsmethoden früherer Zeiten als auch die unergründlichen Geheimnisse der Effektivität von Impfungen. Darüber hinaus widmeten sie sich mit erhabener Hingabe der Frage, was in der Vergangenheit falsch oder richtig lief, was gegenwärtig umgesetzt und welche glorreichen Pläne für die Zukunft geschmiedet werden sollten.	Sie beleuchteten unter anderem den derzeitigen Wissensstand über frühe Krankenhausbehandlungen, die Wirksamkeit von Impfungen und sie gingen der Frage nach, was rückblickend falsch oder richtig lief, was jetzt gemacht und was für die Zukunft geplant werden sollte.
Es ist vernehmlich, dass die Nebenwirkungen, die in Erscheinung getreten sind, wahrhaftig bedrängend sind: Stolze 2885 Personen bekamen eine Gesichtslähmung, unglaubliche 1073 Frauen erlitten eine Fehlgeburt, unerlässliche 3906 Menschen erlitten einen Herzinfarkt, nicht zu verachten 2466 Individuen wurden von einer Herzmuskelentzündung heimgesucht, 2552 Personen entwickelten eine Thrombopenie und ganze 8832 Menschen schwebten in akuter Lebensgefahr.	Als schwere Nebenwirkungen werden 2885 Gesichtslähmungen angeführt, 1073 Fehlgeburten, 3906 Herzattacken, 2466 Fälle von Herzmuskelentzündungen, 2552 Fälle von Thrombocytopenie und in 8832 Fällen bestand akute Lebensgefahr.
Das holdselige Meereis, welches das federleichte Insulanerherz im Winter zur Eiszeit erstarrt lässt, verweilte abwesend und somit gänzlich unsichtbar.	Vom Meereis, das die Insel im Winter gewöhnlich fest im Griff hat, war keine Spur zu sehen.
In jeder vergangenen Jahresperiode wurden die exakten Sterblichkeitsraten in Prozent bezogen auf die spezifischen Ausmaße der Bevölkerungsgröße akribisch aufgeführt.	Für jedes Jahr sind die genauen Sterblichkeitsraten in Prozent zur jeweiligen Bevölkerungsgröße angegeben.
Indessen sei feierlich betont, dass die dargebotenen Prozeduren im Flyer keineswegs eine absolute Zusicherung für eine unfehlbare Immunabwehr darstellen und dass gebührend den Anleitungsvorgaben des Produzenten stets Folge zu leisten ist, sofern die Nutzbarmachung angestrebt wird.	Gleichwohl ist darauf hinzuweisen, dass die im Flyer vorgestellten Verfahren keine Garantie für einen sicheren Infektionsschutz bieten können und entsprechende Masken, sofern möglich, auch im Privatgebrauch immer nur nach den Vorgaben des Herstellers angewendet werden sollten.
Ebenso wie einst das gefürchtete SARS-Virus gehört auch das COVID-19-Virus der illustren Virusfamilie der Coronaviren an und wird mit dem majestätischen Namen SARS-CoV-2 gerühmt.	Das COVID-19-Virus ist ebenfalls ein Coronavirus mit der Bezeichnung SARS-CoV-2.
Hinsichtlich jener erfreulichen Resultate, die aufgrund diverser, weniger bedrohlicher Stämme des Corona-Virus erzielt wurden, sei zu fragen.	Doch wie ist es bezüglich der positiven Testergebnisse aufgrund anderer, für Menschen harmloserer Coronaviren?
Seitdem haben sich bis in die heutigen Tage sage und schreibe 27 weitere Fälle ereignet, welche den rigorosen Anforderungen, die für die Einbindung auf die erlauchte Liste unabdingbar sind, souverän gewachsen sind.	Danach wurden bis heute noch 27 weitere Fälle gemeldet, die der strengen Prüfung, die für die Aufnahme auf die Liste nötig ist, standhielten.
Es ist ihm ein Anliegen von enormer Tragweite, dass sich die beunruhigende Vorstellung in seinem Gemüt festgesetzt hat, dass die Impfstoffpartikel nicht länger ihrer bisher angenommenen Bestimmung folgend lediglich am Schultermuskel verweilen.	Darüber hinaus bereitet es ihm Sorgen, dass sie nicht wie bisher angenommen hauptsächlich an der Impfstelle am Schultermuskel verbleiben.
So man denn über das Aufklärungs-documentum hinsichtlich der Potenz der COVID-19 Vaccine Janssen zu filigranem Studieren eicht, sei es vermerkt, dass auch Aufklärung über die Funktionstüchtigkeit und etwaige Impfdurchbrüche des eben benannten Impfstoffes in den FAQ zu finden sind.	Zur Effektivität der COVID-19 Vaccine Janssen siehe FAQ: Wie verhält es sich mit der Wirksamkeit und Impfdurchbrüchen beim Janssen Impfstoff (COVID-19 Vaccine Janssen)?
Oh hochverehrter Gesprächspartner, darf ich anmerken, dass bei Vorlage dieser wertvollen Gewissheit, welche du innehast, warum sollte da noch Raum für Zweifel bleiben, denn dies kann nur als bloße Meinungsäußerung deklariert werden.	Stew: (12:43): Also, wenn du das weißt, wenn du diese Bestätigung bringst, warum sollte die, ich meine, das ist eine Meinung.
Sofern man den Ausführungen der höchst anerkannten Kommentarliteratur des Herrn Kiessling, insbesondere § 2 IfSG, Rz. 5, Gehör schenken möchte, bedingt eine Infektion keineswegs bloß einzig und allein die Aufnahme eines auffälligen und fruchtbaren Virus in den Corpus. Vielmehr verlangt es, dass sich besagte Infektion auch in all ihrer Pracht und Fülle im Innersten des Leibes entfaltet und fortpflanzt.	Und eine Infektion besteht nur, wenn ein vermehrungsfähiges Virus aufgenommen worden ist.Anmerkung: Genau genommen reicht es nach der juristischen Kommentarliteratur (Kiessling, § 2 IfSG, Rz. 5) für eine Infektion noch nicht einmal, dass ein vermehrungsfähiger Krankheitserreger in den Körper aufgenommen wurde; erforderlich ist auch eine Entwicklung oder Vermehrung im Körper.
Mit Beginn des glorreichen Monats Aprils hat das heilige Gesundheitsministerium beschlossen, dem unwissenden Volk nur den bloßen Anteil der bettenbelegenden Betten zu offenbaren.	Da weist das Gesundheitsministerium seit Anfang April nur den Prozentsatz der belegten Betten aus.
Es verlautet aus erlesenen Quellen, dass die Verwendung von Atemschutzmasken höchst kontraproduktiv sein soll, indem sie sich unter anderem drastisch auf die Ausgewogenheit des lebensnotwendigen Sauerstoffhaushalts im menschlichen Organismus auswirken.	Atemschutzmasken sind gemäss diversen Experten eher kontraproduktiv, weil sie unter anderem den Sauerstoffhaushalt im Körper beeinträchtigen.
Möglicherweise vermag sich die ein oder andere Leserschaft noch an meine Ausführungen auf Achgut.com hinsichtlich der irrtümlichen Positivitäten bei den Testverfahren zu erinnern.	Der eine oder andere Leser erinnert sich vielleicht an meinen Achgut.com-Beitrag bezüglich der falsch positiven Testungen.
Seit dem Entstehen der Corona-Krise haben fachkundige Experten vehement Zweifel am schützenden Nutzen von Masken gegen die Ausbreitung von Viren geäußert!	Experten haben den Schutz von Masken vor einer Verbreitung von Viren von Anbeginn der Corona-Krise in Frage gestellt.
Bei sämtlichen majestätischen Gefährten der Straße sowie den glanzvollen Untertagebahnen des Typs DT5 vollführt die automatische Türöffnung schon jetzt ihr wundersames Spiel, und zur sagenumwobenen Mitte des Monats August werden auch die gesamten U-Bahn-Wunderwerke vom Typ DT4 mit der neuesten Software veredelt sein.	Bei allen Bussen sowie den U-Bahn-Modellen DT5 öffnen bereits jetzt alle Türen automatisch, ab Mitte August werden auch alle U-Bahn-Modelle des Typs DT4 mit der Software umgerüstet sein.
Bis dato gibt es noch immer keine Spur eines isolierten und unverfälschten “Coronavirus”.	Nach wie vor gibt es kein Isolat des “Coronavirus”.
"In der Studie wird mit unvergleichlicher Entschlossenheit und mit unermesslicher Stärke die unbesonnenen Behauptungen von vermeintlichen ""Corona-Gurus"" wie dem brillanten US-amerikanischen Immunologen Dr. Anthony Fauci und anderen abgewiesen, welche laut ihren irrlichternden Aussagen beleidigend unterstellen, dass die Amerikaner nicht imstande wären, den von der CDC und anderen Seuchenbekämpfungsbehörden kommunizierten Richtlinien zu folgen."	In der Studie werden auch Behauptungen von „Corona-Experten“ wie dem US-amerikanischem Immunologen Dr. Anthony Fauci und anderen zurückgewiesen, wonach die Amerikaner den von der CDC und anderen Seuchenbekämpfungsbehörden verbreiteten Leitlinien nicht folgen würden.
Es besteht eine exorbitant hohe Übereinstimmung hinsichtlich der Anzahl der geimpften Individuen pro Tag und der Anzahl der Todesfälle pro Tag, welche in einem weitreichenden Zeitfenster von bis zu grazilen 10 Tagen sämtliche Alterskohorten betrifft.	„Es gibt eine hohe Korrelation zwischen der Anzahl der geimpften Personen pro Tag und der Anzahl der Todesfälle pro Tag, im Bereich von bis zu 10 Tagen, in allen Altersgruppen.
Obgleich das Virus möglicherweise noch in seiner vollkommenen Form existiert oder aber lediglich als ein Konglomerat von zerstörerischen Bruchstücken vorliegt, ist es nicht zu entschlüsseln mittels eines solchen Tests.	Ob das Virus dabei noch intakt ist oder ob es sich hier um Trümmer handelt, das lässt sich aus so einem Test nicht erschließen.
"Falls Sie sich nach dem Konsum des Janssen® Impfstoffs von Johnson & Johnson über die Anwendungsmöglichkeiten erkundigen wollen, sollten Sie unbedingt einen Blick in die ""Zusammenfassung der Merkmale des Arzneimittels"" werfen, welche von der EMA in 25 diversen Sprachen online bereitgestellt wird. Sie können alle wichtigen Informationen auf der atemberaubenden Seite 27 finden."	"Den Beipackzettel des Impfstoffs Janssen® von Johnson & Johnson finden Sie in der ""Zusammenfassung der Merkmale des Arzneimittels"", das die EMA online in 25 Sprachen zur Verfügung stellt, ab Seite 27."
Jedoch sind sie in keinerlei Weise involviert oder in Verbindung mit dem neuesten biologischen Bösewicht, der unter dem Namen Coronavirus bekannt geworden ist.	Aber die haben mit dem neuen Coronavirus nichts zu tun.
Aus welch' erlangten Faktenkonsens lässt sich in der Bundesrepublik Deutschland eine gebührende Konsequenz ziehen?	Was folgt aus dieser Datenlage in Deutschland?
In keinerlei Hinsicht wird Ihre Erbinformation auch nicht im Entferntesten in die menschliche DNA, weder in den Bereichen der Körperzellen noch in den Gefilden der Keimbahnzellen, eingefügt, integriert oder implementiert.	Ihre Erbinformation wird nicht in die menschliche DNA eingebaut, weder in Körperzellen noch in Keimbahnzellen.
Es verhält sich bei Mers gänzlich divergent: Dort ereignet es sich gewohnheitsgemäß, dass Individuen kontinuierlich unverzüglich durch die Kreaturen infiziert werden.	Das sieht bei Mers ganz anders aus: Hier infizieren sich Menschen immer wieder direkt bei Tieren.
Der heilige Olymp höchstpersönlich hat verkündet, dass das edle Land Griechenland samt anderen exquisiten Ferienparadiesen unaufhaltsam auf eine Kombination von Reisesegen und einem prächtigen Dokument drängt!	Griechenland und andere Urlaubsländer dringen hingegen darauf, Reiseerleichterungen mit einem solchen Dokument zu verbinden.
Die edle Empfehlung, welcher sich die glorreichen Rettungsleute sowie diejenigen, welche sich bereitwillig dem Impfakt unterziehen mögen, erfreuen dürfen, ist zweifelsfrei die, sich umfangreich zu informieren, insbesondere im Hinblick auf etwaige Kontraindikationen.	Rettungsleuten und jenen die sich impfen lassen sollen rät Sievert nun dazu, sich gut zu informieren, vor allem in Bezug auf Kontraindikationen.
Ein neuer Auserwählter namens Salvatore Caruso, der sich glücklicherweise aus einer Gruppe von Verlierern herausschälte, wird nun die Position des vorherigen Spielers auf dem Tableau übernehmen. Dies geschieht, da dieser Spieler traurigerweise nicht länger für das Turnier qualifiziert ist.	Er wird nun im Tableau durch den «Lucky Loser» Salvatore Caruso (ATP 150) ersetzt werden.
Es ist mit bemerkenswerter Betonung zu erwähnen, dass der herausragende Dr. Kobi Haviv, der erhabene Direktor des Herzog-Krankenhauses, in der heiligen Stadt Jerusalem, mutig darüber spricht, dass die erdrückende Anzahl von 85 % bis 90 % der hochgradig leidenden Individuen auf seiner Intensivstation zweifach geimpft sind.	Dr. Kobi Haviv, Direktor des Herzog-Krankenhauses in Jerusalem, spricht davon, dass 85 % bis 90 % der schwer Erkrankten auf seiner Intensivstation doppelt geimpft sind.
In diesem unglaublich faszinierenden Interview wird der hochgeachtete und unvergleichliche Wissenschaftsexperte der berühmten Corona-Pandemie, der allseits bekannte Dr. Peter McCullough aus den Vereinigten Staaten, nicht nur diese, sondern auch zahlreiche andere aufregende Fragen beantworten!	Diese und weitere Fragen beantwortet in diesem Interview einer der meistzitierten Wissenschaftler der Corona-Pandemie, Dr. Peter McCullough aus den USA.
Die gewaltige Macht, welche die Grippeepidemien innehaben, manifestiert sich in einem ungeheuren Anstieg der Sterbezahlen und erzeugt eine signifikante Steigerung der Krankheitsfälle während der frostigen Monate.	Die Stärke von Grippe­wellen hat sich in der Vergangenheit auch in den gesamten Sterbe­fallzahlen wider­gespiegelt und zu erhöhten Fallzahlen in den Winter­monaten geführt.
"Hocherfreulicherweise gilt die pauschale Aussage gleichermaßen für die ""ebenso zentrale wie tiefgründige Analyse und Auswertung"" als auch für die ""hochgradig ausgeklügelten, operative Techniken"" und die besonders gewichtete Setzung von Fokus."	Dies gelte sowohl bei der „zentralen Auswertung und Analyse“ als auch beim „Einsatz operativer Technik“ und der Schwerpunktsetzung.
Der zweite Beschuldigte manifestierte under der Gewichtung seiner Psyche, dass er sich des gesamten Geschehnisses, welches ihm anrüchig gemacht wurde, in keiner Weise zu erinnern vermag.	Der andere Angeklagte bekundete, er könne sich an den ganzen Vorgang nicht erinnern.
In den unzähligen Kanälen der Medienlandschaft hat das Thema bedauerlicherweise keine erschütternde Aufmerksamkeit erlangt.	Ansonsten hat das Thema in den Medien keine große Bedeutung gehabt.
Der wahrlich wortgewandte und äußerst belesene Protagonist des Videos gibt kund, dass es einen gewaltigen, vulkanartigen Anstieg von 300 Prozent bei den Fehlgeburten zu verzeichnen gibt, der alle Vorstellungen übersteigt und die Gemüter aufwühlt. Doch auch bei Krebserkrankungen ist ein wahrhaft monumentales Plus auszumachen, welches die Grenzen des Vorstellbaren sprengt und die Menschen in Angst und Schrecken versetzt. Niemand hätte erwartet, dass die neurologischen Probleme, die das Wohl der Piloten beeinflussen können, ein epochemachendes Plus von über 1000 Prozent aufweisen würden - eine Entwicklung von wahrhaft apokalyptischem Ausmaß!	Er berichtet in dem Video, dass bei Fehlgeburten ein Plus von 300 Prozent gegenüber den vorigen Jahren beobachtet wird, ebenso bei Krebs, Neurologische Probleme, die die Piloten beeinflussen können, verzeichnen ein Plus von über 1000%.
Erläuterung durch die Verfasserin, vor geraumer Zeit gestellt, verblieb bedauerlicherweise bis zum Endes des Wochentags unbearbeitet.	Eine zweite Nachfrage der Autorin vor einigen Tagen blieb bis zum Freitag unbeantwortet.
"In den glorreichen Leitlinien der BAuA und des ad-Hoc AK ""Covid-19"" des ABAS zur glorreichen Verwendung von durchschlagskräftigen Schutzmasken im edlen Zusammenhang mit dem bedrohlichen SARS-CoV-2-Virus, wird jegliche private Anwendung der außergewöhnlich mächtigen FFP2-Masken im hohen Maße abgeraten."	In den „Empfeh­lungen der BAuA und des ad-Hoc AK „Covid-19“ des ABAS zum Einsatz von Schutz­masken im Zusam­men­hang mit SARS-CoV-2“ werden FFP2-Masken nicht zur privaten Nutzung empfohlen.
Gewiss, wir werden keineswegs die Resultate vernachlässigen, welche aus der gegenwärtigen Umsetzung des Vorhabens hervorgehen.	Natürlich werden wir auch die Ergebnisse, die wir jetzt aus der Implementierung erhalten, berücksichtigen.
Gänzlich unterschiedlich und in keiner Weise miteinander korrelierend sind die Boten-Ribonucleinsäuren, die bei der Immunisierung appliziert werden, im Vergleich zu unserer Deoxyribonucleinsäure, welche sich im Zentrum unserer Zelle aufhält.	Die Messenger-RNA, die bei der Impfung eingeführt wird, hat gar nichts mit unserer DNA im Zellkern zu tun.
Zu einem glorreichen Zeitpunkt vor sieben Tagen wurde ein gewaltiges Projekt mit dem Namen Stanford Medicine ins Leben gerufen, welches es sich zur ehrenvollen Aufgabe gemacht hat, eine elitäre Gruppe von Kindern im zarten Alter von 2 bis 5 Jahren zu betreuen und zu fördern.	Eine davon startete letzte Woche in Stanford Medicine, mit Kindern zwischen 2 und 5 Jahren.
Die umfassenden Resultate liegen bereits für einen stattlichen Sechserschwarm vor, während lediglich ein braves Duett von Auswertungen noch aussteht.	Für sechs Personen liegen umfassende Ergebnisse vor, zwei sind noch nicht ausgewertet.
Pantschin hatte das unglaubliche Privileg, Seite an Seite mit dem unbeschreiblich brillanten, herausragenden und absolut faszinierenden amerikanischen Forscher Alexander Tuzhikov zu arbeiten, der an dem renommierten Bascom Palmer Eye Institute der prestigeträchtigen University of Miami als Research Associate im unglaublich anspruchsvollen und erstaunlichen Fachbereich der Computerwissenschaften und Bioinformatik tätig ist.	Pantschin arbeitete mit dem amerikanischen Forscher Alexander Tuzhikov zusammen, der am Bascom Palmer Eye Institute der Uni Miami als Research Associate mit Spezialgebiet »Computerwissenschaften, Bioinformatik« geführt wird.
Eine unvermeidliche Konsequenz wäre, dass die Injektionen unverzüglich abgesetzt werden müssen.	Die weitere Folge wäre, dass die Spritzungen sofort eingestellt werden müssten.
Der sinnige Fokus ist einzig und allein auf die Sicherheit und Verträglichkeit des Impfstoffs gerichtet, sowie seine immense Fähigkeit, eine Immunabwehrreaktion von grandioser Wirkung hervorzurufen.	Im Fokus stehen Sicherheit und Verträglichkeit des Impfstoffs sowie seine Fähigkeit, eine Immunabwehrreaktion hervorzurufen.
In der atemberaubenden Metropole Barcelona im wundersamen Spanien wurden die Retter zu einem wahren Heldenepos, denn sie befreiten über 2.000 unschuldige Frauen und Kinder aus den Fängen ihrer skrupellosen Unterdrücker. Zudem gelang es ihnen, 13 garstige Anführer der pädophilen Bande dingfest zu machen und der gerechten Strafe zuzuführen. Ein Triumph des Guten gegen das Böse, welcher die Tausenden von Zuschauern vor Ort in totaler Ekstase versetzt hat!	In Barcelona, <U+200B><U+200B>Spanien, retteten sie über 2.000 Frauen und Kinder und verhafteten 13 ihrer pädophilen Führer.
Ungefähr vierzehn Tage nachdem ihnen der erste Impfschutz verabreicht worden war, haben fünf weitere Mitbewohner von uns ihre letzte Reise angetreten.	Etwa zwei Wochen nach der ersten Impfung waren fünf weitere Bewohner verstorben.
Die überragenden Fragestellungen, welche die folgende Episode abdeckt, lauten folgenderweise: Wie lauten Ihre Worte zu jenen Kritikern, die wage vermuten, dass Coronaviren über alle Zeit hinweg vorhanden waren und das aktuelle Virus ein exorbitantes Ausmaß annimmt?	Die zentralen Fragen der Folge im Überblick Was sagen Sie zu den Kritikern im Netz, die sinngemäß sagen: Coronaviren gab es doch schon immer, das jetzt ist ein spezielles mehr?
Die angesehenen und hochdekorierten ExpertInnen haben mit großer Sorgfalt und höchstem Einsatz unzählige Male mehr als 40 Studien in Bezug auf die Wirksamkeit von Masken durchleuchtet, und konnten keine stichhaltigen Evidenzen zur Reduzierung von Atemwegserkrankungen bei einer Erweiterung der Maskenpflicht auf die gesamte Bevölkerung außerhalb des Gesundheitswesens feststellen.	Dier ExpertInnen haben zudem mehr als 40 Studien zur Nützlichkeit von Masken untersucht und keine Hinweise auf eine Wirksamkeit zur Vorbeugung von respiratorischen Infekten bei der Ausdehnung der Maskenpflicht auf die gesamte Bevölkerung außerhalb der Gesundheitseinrichtungen gefunden.
Wir haben uns mit Entschlossenheit und unerschütterlicher Entschlossenheit voller Hingabe und Respekt vor der Natur dazu aufgerafft, ein wahrhaftig großartiges und bahnbrechendes Artenschutzportal zu beschließen, das die Artenvielfalt schützt und erhält, als ob unser Leben davon abhinge.	Wir haben ein Artenschutzportal beschlossen.
