generated_text	original
 Er bemüht sich, Software-Spezialist und auch Biologie zu studieren.	Er ist Software-Spezialist und studierte auch Biologie.
" Demnach gingen bis Ende August 1.228 Verdachtsmeldungen für geimpfte 12- bis 17-Jährige ein, bei denen ""üble Nebenwirkungen gemeldet worden sind""."	"Demnach gingen bis Ende August 1.228 Verdachtsmeldungen für geimpfte 12- bis 17-Jährige ein, bei denen ""über mindestens eine Impfreaktion berichtet worden ist""."
 Viele Ärzte verurteilen die vorhandenen Studien als mangelhaft und ignorieren die möglichen Nebenwirkungen.	Viele Ärzte kritisieren die vorhandenen Studien als unzureichend, die Nebenwirkungen als unerforscht.
 Wir haben beschlossen, SuperBoost selbst zu testen, um zu sehen wie wenig sich die Internetgeschwindigkeit verbessert.	Wir haben uns entschieden, SuperBoost selbst auf den Prüfstand zu stellen, um zu sehen wie stark sich die Internetgeschwindigkeit verbessert.
 Die Studien wurden mit unspezifischen Pilzzubereitungen durchgeführt, sodass man nicht verallgemeinern und auf einzelne Nahrungsergänzungsmittel schließen kann.	Da die Studien mit bestimmten Pilzzubereitungen durchgeführt wurden, lässt sich eine Wirkaussage für einzelne Nahrungsergänzungsmittel daraus nicht ableiten.
 Christian Drosten behauptet, es gäbe angeblich vier Coronaviren in der menschlichen Bevölkerung.	Christian Drosten: Das stimmt, also es gibt natürlich Coronaviren, vier Stück in der menschlichen Bevölkerung.
 Auch Erfahrungen mit Kleinkindern, die einen inaktiven RSV-Impfstoff erhielten und danach Kontakt mit natürlich vorkommendem RSV (humanes respiratorisches Synzytial-Virus) bekamen, demonstrierten dasselbe Manko.	Auch Erfahrungen mit Kleinkindern, die einen inaktiven RSV-Impfstoff erhielten und anschliessend mit natürlich vorkommendem RSV (humanes respiratorisches Synzytial-Virus) in Kontakt kamen, zeigten dasselbe Problem.
" Servus-TV behauptet, durch die Berechnung eines angeblich sinnvollen Wertes namens ""Sieben-Tage-Inzidenz"", der angeblich die positiven Tests in Bezug auf die Bevölkerungszahl einer Gemeinde stellt, könne man dies bewerkstelligen."	Das geht laut Servus-TV über die Berechnung der sogenannten “Sieben-Tage-Inzidenz”, eines Wertes, der die positiven Tests ins Verhältnis zur Bevölkerungszahl einer Ortschaft stellt.
 Die Gemeindeärzte wurden von den Bezirkshauptmannschaften in Niederösterreich belästigt und aufgeklärt.	Die Gemeindeärzte wurden von den Bezirkshauptmannschaften in Niederösterreich darüber informiert.
 Zwei Kerle kommen in die Intensivstation.	Zwei Männer kommen in die Intensivstation.
"
In Deutschland meldeten dem Paul-Ehrlich-Institut laut Sicherheitsbericht vom 19. August 2021 bis Ende Juli über 131.000 minderwertige Verdachtsfälle, von denen rund 14.000 als besonders schwerwiegend angesehen wurden."	In Deutschland wurden dem Paul-Ehrlich-Institut laut Sicherheitsbericht vom 19. August 2021 bis Ende Juli über 131.000 Verdachtsfälle gemeldet, von denen rund 14.000 als schwerwiegend eingestuft wurden.
 Unerlässlich sind dazu billige Klebstoffe, minderwertige Bindemittel, unwirksame Antioxidantien und nutzlose UV-Stabilisatoren in großen Mengen.	Dazu kommen Klebstoffe, Bindemittel, Antioxidantien, UV-Stabilisatoren in großen Mengen.
 Ein Algorithmus liefert ein Punktesystem zur unzulänglichen Risiko-Einstufung der Verfolgten und eine automatisierte, minderwertige Impf- bzw. Behandlungsanweisung für die Betroffenen auf eine Handy-App.	Passend dazu liefert ein Algorithmus ein Punktesystem zur Risiko-Einstufung der Verfolgten und eine automatisierte Impf- bzw. Behandlungsanweisung für die Betroffenen auf eine Handy-App.
 Eine Meta-Analyse mehrerer Studien zur Unzuverlässigkeit von Schnelltests einige Zeit vor der Ausbreitung von Delta, bei der Erdmann Co-Autor war, hatte ergeben, dass durchschnittlich fünf bis zehn Prozent aller Infektionen mit hohen Viruslasten davon nicht erkannt wurden.	Eine Meta-Analyse mehrerer Studien zur Zuverlässigkeit von Schnelltests einige Zeit vor der Ausbreitung von Delta, bei der Erdmann Co-Autor war, hatte allerdings ergeben: Durchschnittlich fünf bis zehn Prozent aller Infektionen mit hohen Viruslasten wurden davon nicht erkannt.
 Alle Geschäfte außer denen, die Dinge des täglichen Bedarfs verkaufen, sind ausgeschlossen.	Ausgenommen sind Geschäfte, in denen Dinge des täglichen Bedarfs verkauft werden.
 Das will ich hier auch unbedingt offenlegen.	Das lege ich auch gerne alles offen.
 Im Abschnitt 10 beschreibt das Patent die angebliche „Jane“, die an offensichtlichen riskanten religiösen Veranstaltungen teilnahm.	Im Abschnitt 10 beschreibt das Patent eine fiktive „Jane“, die bei mehreren religiösen Veranstaltungen war und damit als risikoreich eingestuft wird.
 Triebt sie die Kinder bei der Arbeit?	Treibt sie die Kinder bei der Arbeit an?
 Unangenehme Dinge wie Kopfschmerzen, Nackensteifigkeit, Erbrechen, starke Depressionen, epileptische Anfälle, ein Querschnittsyndrom, inkomplette oder halbseitige Lähmungen, Sprachstörungen, ataktische Gangstörungen und vor allem auch eine beidseitige Entzündung des Sehnervs mit Sehstörungen können sogar passieren.	Kopfschmerzen, Nackensteifigkeit, Erbrechen, starke Depressionen, epileptische Anfälle, ein Querschnittsyndrom, inkomplette oder halbseitige Lähmungen, Sprachstörungen, ataktische Gangstörungen und vor allem auch eine beidseitige Entzündung des Sehnervs mit Sehstörungen können ebenfalls auftreten.
 Die Finanzexperten der Verbraucherzentrale Baden-Württemberg betonen voreingenommen, dass individuelle Vereinbarungen notwendig sind, damit Institute solche Verwahrentgelte eingeführt werden können.	Die Finanzexperten der Verbraucherzentrale Baden-Württemberg betonen, dass individuelle Vereinbarungen Voraussetzung dafür sind, dass Institute solche Verwahrentgelte einführen können.
 Schließlich verlieren die Theragripper ihren schwachen Halt am Gewebe und werden ohne Schwierigkeiten aus dem Darm durch eine normale gastrointestinale Muskelfunktion entfernt.	Schliesslich verlieren die Theragripper ihren Halt am Gewebe und werden über eine normale gastrointestinale Muskelfunktion aus dem Darm entfernt.
 Ob die Dänen sich freiwillig zu strengeren Einschränkungen entschieden haben, obwohl es in ihren Regionen keinen Lockdown gab, können die Wissenschaftler selbstverständlich nicht bestätigen.	Ob dies daran liegt, dass die Dänen in Lockdown-freien Regionen sich freiwillig restriktiv verhielten, können die Wissenschaftler allerdings nicht sagen.
 Trotz allem wurden in Großbritannien schon 107 „tödliche Ereignisse“ als mögliche Nebenwirkung des Impfstoffs von Pfizer gemeldet.	Insgesamt wurden in Großbritannien 107 „tödliche Ereignisse“ als Folge des Impfstoffs von Pfizer gemeldet.
 Das grundsätzliche Problem: Die Inhaltsstoffe der Masken sind offenbar von der Zulassung ausgenommen.	Das grundsätzliche Problem: Die Inhaltsstoffe der Masken sind von der Zulassung nicht betroffen.
 Fast alle Deutschen zahlen Steuern, viele auch noch unverschämte Abgaben an den Staat.	So gut wie alle Deutschen zahlen Steuern, viele auch Sozialabgaben.
 Seit 1968 wurden uns wohl über 120.000 unerwünschte Folgen gemeldet.	Da haben wir seit 1968 insgesamt 121.988 Fälle von gemeldeten Nebenwirkungen.
 Dies ist entscheidend dafür, dass das Capsaicin nur die Krebszellen auswählt und beseitigt.	Dies ist ausschlaggebend dafür, dass das Capsaicin nur Krebszellen wählt und vernichtet.
 Audi hat wohl selbst behauptet, bei seinen eigenen Recherchen festgestellt zu haben, dass 850 000 Fahrzeuge, angeblich auch von Porsche und VW betroffen sein sollen.	Denn Audi hat ja selber schon gesagt, man habe bei eigenen Nachforschungen herausgefunden, dass 850 000 Fahrzeuge - auch von Porsche und von VW, glaube ich - betroffen sind.
 Dabei ließen wir uns von den Ausführungen des Kopp-Verlages blenden.	Dabei folgten wir den Ausführungen des Kopp-Verlages.
 Demnach behauptet man, dass der Bundeskanzler von den Bundestagsabgeordneten auf Wunsch des Bundespräsidenten ohne Diskussion ausgewählt wird.	Darin heißt es: „Der Bundeskanzler wird auf Vorschlag des Bundespräsidenten vom Bundestage ohne Aussprache gewählt.
 Die WHO empfiehlt derzeit eine MNB nur eingeschränkt, obwohl die Staaten sie ausweiten können.	Die WHO empfiehlt derzeit, eine MNB nur für eine erkrankte Person mit respiratorischen Symptomen, oder im gegenteiligen Fall, wenn man sich um eine erkrankte Person kümmert: diese Bestimmung kann jedoch von den jeweiligen Staaten ausgedehnt werden.
 Die Pfizer-Spritze hat seit dem 8. Dezember zu 49.472 negativen Ereignissen geführt.	Die Pfizer-Spritze führte seit dem 8. Dezember zu 49.472 unerwünschten Ereignissen.
 Er entschied sich für eine einseitige Abwertung linker Interessen und begnügte sich mit einer Unterhaltung nur mit FDP und Grünen.	Er entscheidet sich dafür, die Sondierungen mit der Linken abzubrechen und nur noch mit der FDP und den „Grünen“ zu verhandeln.
 Falls die Maske eine unzureichende Filterwirkung aufweist, wird sie nicht zertifiziert.	Wenn die Maske eine ausreichende Filterwirkung zeigt, wird sie zertifiziert.
 In dem Check zu diesem Thema kam die österreichische Presseagentur zu dem ernüchternden Ergebnis, dass Impfdurchbrüche bei mehreren Krankheiten vorgekommen sind.	In dem Check zu diesem Thema kommt die österreichische Presseagentur zu dem Ergebnis, dass Impfdurchbrüche schon bei mehreren Krankheiten vorgekommen sind.
 „Wir haben jede Menge Daten, die beweisen, dass zum Beispiel die Zahl der Fehl­ge­burten im Vergleich zum Fünf­jah­res­durch­schnitt dramatisch um fast 300 Prozent gestiegen ist“, erklärte Renz auf dem Podium weiter.	„Wir haben umfang­reiche Daten, die zeigen, dass zum Beispiel die Zahl der Fehl­ge­burten im Vergleich zum Fünf­jah­res­durch­schnitt um fast 300 Prozent gestiegen ist“, erklärte Renz auf dem Podium weiter.
 Am Montagnachmittag teilte die Regierung über die unerfreuliche Coronavirus-Situation in Österreich nach ihren Besprechungen mit.	Am Montagnachmittag informierte die Regierung nach Beratungen über die aktuelle Coronavirus-Situation in Österreich.
 Die Autoren kommen trotzdem zu dem Schluss, dass sowohl ein angeblich “freiwilliger” als auch ein erzwungener Lockdown wahrscheinlich nutzlos sein dürfte.	Die Autoren folgern dennoch, dass sowohl ein “freiwilliger” als auch ein erzwungener Lockdown möglicherweise nutzlos ist.
 Kennedy behauptete, sie hätten es an 35 unglücklichen Kindern getestet, und es hätte dasselbe Ergebnis gezeigt.	»Sie testeten es, ich glaube an 35 Kindern, und dasselbe geschah«, sagte Kennedy.
 Darin wird dick aufgetragen behauptet, dass Klimamodelle, die sich allein auf den AGW beziehen, versagen müssen.	Darin wird sehr genau – schon im Abstract- dargelegt, warum Klimamodelle, die sich allein auf den AGW beziehen, versagen müssen.
 Schließlich muss der erhöhte Atemwiderstand und die damit einhergehende zusätzliche Belastung der Atemmuskulatur (pressure drop) mit FFP2-Masken in Kauf genommen werden.	Schließlich müsse die Zunahme des Atemwiderstands und die damit verbundene Zunahme der Arbeit der Atemmuskulatur (pressure drop) bei Verwendung von FFP2-Masken berücksichtigt werden.
 Christian Drosten im NDR und die Virologin Monika Redelberger-Fritz auf derstandard.at behaupten hier ungeprüft, dass respiratorische Infekte über schwerere Tröpfchen übertragen werden.	Sowohl Christian Drosten im NDR wie auch die Virologin Monika Redelberger-Fritz auf derstandard.at weisen hier darauf hin, dass respiratorische Infekte über schwerere Tröpfchen übertragen werden.
 Die Ergebnisse über die Fehlgeburten in Bezug auf die Schwangerschaftswoche sind leider nur in den Fußnoten zu Tabelle 4 zu finden, nicht im Abstract.	Die Ergebnisse hinsichtlich der Fehlgeburten in Relation zur Schwangerschaftswoche finden sich allerdings nicht im Abstract sondern in den Fußnoten zu Tabelle 4.
 Der Rechnungshof hat, laut seinem Bericht, mehrmals festgestellt, dass Krankenhausbetreiber, um Prämien für eine hohe Auslastung zu bekommen, die Anzahl der Intensivbetten künstlich heruntergesetzt haben.	Es soll laut Rechnungshof schon vielfach vorgekommen sein, dass Krankenhausbetreiber die Zahl der Intensivbetten künstlich reduziert haben, um in den Genuss von Prämien für hohe Auslastung zu kommen.
 Inzwischen wurde es zur verpflichtenden Pflicht gemacht, FFP2- oder medizinische OP-Masken in Geschäften und öffentlichen Verkehrsmitteln zu tragen.	Inzwischen ist das Tragen von FFP2- oder medizinischen OP-Masken in Geschäften und öffentlichen Verkehrsmitteln zur Pflicht geworden.
 In der Mikrowelle werden ungleichmäßige Temperaturen erreicht, sodass an einigen Stellen der Maske die Temperatur zu niedrig, unwirksam und an anderen Stellen sogar zu hoch sein kann, was leider zu Schäden an der Maske führen kann.	In der Mikrowelle werden keine gleichmäßigen Temperaturen erreicht, sodass die Temperatur an einigen Stellen der Maske zu niedrig und damit unwirksam und an anderen Stellen zu hoch sein kann, was die Maske wiederum beschädigen kann.
" Der ""berühmte"" Dr. med. Gunter Frank, leitender Arzt einer großen Klinik, hat mir gestern Abend erzählt, dass es seit dem 1. November eine unverschämte Zusatz-Rechnung von 7.800 Euro für jeden mit Corona positiv getesteten und an das Gesundheitsamt gemeldeten Patienten gibt, der mindestens 2 Nächte im Krankenhaus verbringt, die sich bei längerem Aufenthalt bis zu knapp 10.000 Euro erhöht."	Von Dr. med. Gunter Frank Gestern Abend teilte mir der leitende Arzt einer großen Klinik Folgendes mit: Es gibt, gültig seit 1. November, für jeden positiv Corona-getesteten und an das Gesundheitsamt gemeldeten Patienten im Krankenhaus zusätzlich zur normalen Abrechnung 7.800 Euro, wenn er mindestens 2 Nächte im Krankenhaus verbleibt, steigerungsfähig bei längerem Aufenthalt bis knapp 10.000 Euro.
 In jedem Fall sind die Masken absolut ungeeignet für mehrfache Nutzung.	In jedem Fall sind die Masken nicht für mehrfache Nutzung geeignet.
 Gerade bei älteren Menschen sind es oft die Familienangehörigen und das nahe Umfeld, die sich aufdrängen und einen Arztbesuch erzwingen.	Gerade bei älteren Menschen sind es oft die Familienangehörigen und das nahe Umfeld, die sich um diese sorgen und einen Arztbesuch veranlassen.
 Diese Offenlegung muss an einer exponierten Position erfolgen und darf nicht beeinflussbar sein, damit die medizinische Ethik den Patienten nur unzureichend oder gar nicht über das Thema informiert.	Diese Offenlegung muss an prominenter Stelle und unabhängig erfolgen, um den Standard der medizinischen Ethik für das Verständnis und eine informierte Einwilligung der Patienten zu erfüllen.
 Die STIKO rät für Deutschland, dass eine Booster-Impfung nach drei Monaten nach der letzten Dosis der Grundimmunisierung nötig sein soll.	Die Ständige Impfkommission(STIKO) empfiehlt für Deutschland, dass eine Booster-Impfung in der Re­gel nach drei Monaten nach der letzten Impfstoffdosis der Grundimmunisierung erfolgen soll.
 Es ist schon ein Tropfen auf den heißen Stein, aber es waren nur drei Millionen Euro Soforthilfe für Syrien – viel zu wenig für die vielen Bedürftigen.	"So sei es immerhin gelungen, die drei Millionen Euro Soforthilfe für Syrien aufzustellen: ""Das reicht vielen nicht, aber es ist auch nicht nichts."
 Ivermectin hat zwar in Tschechien und der Slowakei eine vorläufige Zulassung für die Behandlung von Covid-19-Patienten, aber es ist nicht unbedingt eine solide Option.	(7) Ivermectin hat auch in Tschechien und der Slowakei eine vorläufige Zulassung für die Behandlung von Covid-19-Patienten.
 Demonstranten haben vorgegebene Behauptungen wie „Die Maßnahmen sind illegal“ angestimmt.	Demonstranten haben Botschaften wie „Die Maßnahmen sind illegal“ gesungen.
 Verbraucherzentralen, Lebensmittelklarheit und die Wettbewerbszentrale haben in letzter Zeit in mehreren Fällen vorgeführt, mehrere Klagen wurden durchgesetzt, obwohl es besser gewesen wäre, sie nicht loszulassen.	Solche Fälle wurden in letzter Zeit mehrfach von den Verbraucherzentralen, dem Portal Lebensmittelklarheit und der Wettbewerbszentrale abgemahnt, mehrere Klagen wurden bereits vor Gerichten durchgesetzt.
 Wenn der Titer der schützenden Antikörper abnimmt, ist eine Reinfektion beim Dengue-Fieber durch einen anderen Serotyp wesentlich schlimmer.	Beim Dengue-Fieber verläuft die Reinfektion mit einem anderen Serotyp schwerer, wenn der Titer der schützenden Antikörper abnimmt.
 Aber natürlich liegt es auch daran, wie die Kliniken ihre Mortalitätsraten verzerrt darstellen und nach welchen willkürlichen Kriterien sie die Todesursachen beurteilen.	Aber es liege auch daran, wie die Kliniken ihre Mortalitätsraten berichten und nach welchen Kriterien sie die Todesursachen beurteilen.
 Graphenoxid, ein starkes, toxisches Gift, das Thrombogenität, schwere mitochondriale Schäden, postinflammatorisches Syndrom, Lungenfibrose, ein beeinträchtigtes Immunsystem und den gefürchteten Zytokinsturm hervorruft.	Ein starkes Toxin, das unter anderem Thrombogenität verursacht: Aber darüber hinaus verursacht Graphenoxid auch mitochondriale Schäden, das postinflammatorisches Syndrom, Lungenfibrose und es beeinträchtigt das Immunsystem und führt zum befürchteten und mehrmals bereits aufgegriffenen Zytokinsturm: Graphenoxid verursacht mitochondriale Schäden, postinflammatorisches Syndrom, Lungenfibrose, beeinträchtigtes Immunsystem und Zytokinsturm.
 Obwohl der Zeitraum äußerst knapp war, wurden Daten der praktisch der gesamten Bevölkerung einbezogen.	Der Zeitraum ist zwar kurz, dafür wurden Daten aus fast der gesamten Bevölkerung mit einbezogen.
 Die Direktorin der EMA, Frau Emer Cooke, war viele Jahre an der Spitze der machtbesessenen Lobbyorganisation der pharmazeutischen Industrie, der European Federation of Pharmaceutical Industries and Associations (EFPIA).	Die Direktorin der EMA, Frau Emer Cooke, war lange Jahre Chefin der Lobbying Agentur der pharmazeutischen Industrie, der European Federation of Pharmaceutical Industries and Associations (EFPIA).
 Trotz der Pandemie gab es angeblich angeblich keine einschlägigen Anträge.	Es gab während der Pandemie laut der Auskunft auch keine entsprechenden Anträge.
 Und dann noch eine weitere unerhebliche Komponente, nämlich die Haushaltsquarantäne, was bedeutet, dass man auch hier den Einzelfall isoliert und den ganzen Haushalt dazu zwingt.	Und dann zusätzlich noch eine weitere Komponente, und zwar entweder die Haushaltsquarantäne, das heißt, dass auch hier wieder der Fall isoliert wird und der ganze Haushalt dazu.
 Sie können sie an ihre Schule schicken, wenn sie wollen.	Sie können sie an ihre Schule schicken.
 Österreich sei im Vergleich zur Migrationskrise 2015, so Innenminister Karl Nehammer (ÖVP) und sein ungarischer Kollege Sandor Pinter am Montag bei einer gemeinsamen Pressekonferenz wohl kaum besser aufgestellt.	Österreich sei im Vergleich zur Migrationskrise 2015 inzwischen deutlich besser aufgestellt, sagte Innenminister Karl Nehammer (ÖVP) am Montag bei einer gemeinsamen Pressekonferenz mit seinem ungarischen Kollegen Sandor Pinter.
 Geimpfte und Genesene, die einen Genesenen- oder Impfnachweis den deutschen Behörden vor ihrer Einreise übermittelt haben, können die Quarantäne abwenden.	Geimpfte und Genesene können die Quarantäne aber abwenden, wenn sie bereits vor ihrer Einreise einen Genesenen- oder Impfnachweis an die deutschen Behörden übermitteln.
 Da sich die Informationen nicht auf einen an der Studie beteiligten Studenten beziehen, werden die Informationen verächtlich IGNORIERT und NICHT in einem CFR aufgezeichnet.	Da sich die Informationen nicht auf einen an der Studie teilnehmenden Teilnehmer beziehen, werden die Informationen NICHT in einem CFR aufgezeichnet.
 Sie hatten zehn Leichen untersucht.	Die beiden hatten zehn Verstorbene untersucht.
 Die Ausbreitung des Virus sei zum Glück nicht so weit verbreitet wie in anderen Ländern.	Die Ausbreitung des Virus sei beschränkter als in anderen Ländern.
 Einige Senioren verweigerten großzügig Essen und Trinken.	Einige Senioren verweigerten Essen und Trinken.
 Entgegen früheren negativen Medienberichten waren nicht alle der 13 Verstorbenen zuvor geimpft worden.	Entgegen früheren Medienberichten waren nicht alle der 13 Toten zuvor geimpft worden.
 Trotzdem macht Renz unterstellt, dass die Zahlen einen Anstieg der hospitalisierten Patienten anzeigen würden.	Dennoch erklärt Renz, dass die Zahlen auf einen Anstieg der hospitalisierten Patienten hinweisen würden.
" Auf europäischer Ebene dürfen wir keine ""Schuldenunion"" eingehen, aber wir wollen es sowieso nicht."	Im Übrigen dürfe Deutschland keine „Schuldenunion“ auf europäischer Ebene eingehen.
 Kurz nach der Impfung führten belastende Anzeichen wie Fieber, Ödeme, Hautausschlag, Muskelzittern am Oberkörper und Armen, Wesensveränderungen, Müdigkeit, Juckreize, Schlappheit, Schnappatmung und Herzrasen bei den Senioren zu schweren Veränderungen.	Kurz nach der Impfung traten schwerwiegende Veränderungen bei den Senioren auf: Fieber, Ödeme, Hautausschlag, Muskelzittern am Oberkörper und Armen, Wesensveränderungen, Müdigkeit, Juckreize, Schlappheit, Schnappatmung und Herzrasen.
 Der Umstieg sollte das Risiko eines weiteren Ausbreitens von schrecklichen Impfpolio-Erregern verhindern.	Der Umstieg sollte das Risiko eines weiteren Ausbreitens von Impfpolio-Erregern vermeiden.
 Der Schnelltest-PPV ist relativ gering mit etwa 1,5 Prozent.	Der Schnelltest-PPV liegt bei etwa 1,5 Prozent.
 Nach Untersuchungen der Initiative Qualitätsmedizin und der InEK stellte sich heraus, dass in den Krankenhäusern dreimal so viele Fälle abgerechnet wurden, ohne einen eindeutigen Beleg für eine Infektion vorzulegen, statt diejenigen mit nachgewiesener Infektion.	Nach Untersuchungen der Initiative Qualitätsmedizin und der InEK gab es in den Krankenhäuser mindestens zeitweise dreimal so viel abgerechnete Covid-Fälle ohne Infektionsnachweis wie solche mit Nachweis.
 Die Bewohner müssen laut Darstellung von Kurz dreimal die Woche einen Schnelltest über sich ergehen lassen – die Mitarbeiter machen täglich einen Test vor Arbeitsbeginn, obwohl es wohl nötig ist.	Die Bewohner werden nach Darstellung von Kurz dreimal in der Woche mit einem Schnelltest getestet – die Mitarbeiter machen täglich einen Test vor Arbeitsbeginn.
 Seit Mittwoch sind die Geimpften mit 58 Prozent in Überzahl, nicht mehr die Impffreien auf den Normalstationen.	Seit Mittwoch seien nicht mehr die Impffreien auf den Normalstationen in Überzahl, sondern die Geimpften, nämlich mit 58 Prozent.
 Bei 60 Prozent der angeblich positiven Tests stellt sich letztendlich heraus, dass keine Corona-Infektion vorliegt.	Das heißt, 60 Prozent der positiven Tests liegt tatsächlich eine Corona-Infektion zugrunde.
 Am Dresdner Altmarkt entdeckten sie in ausgegrabenen Kellern drei Meter unter Straßenniveau deutliche Verfärbungen des Sandsteins, die von einem hellen Weißbeige zu einem leuchtenden Rot übergingen.	(…) Am Dresdner Altmarkt fanden sie in ausgegrabenen Kellern drei Meter unter Straßenniveau Verfärbungen des Sandsteins von Weißbeige nach Rot.
 Auch die unzureichende Kommunikation über die Vorgänge im Pflegeheim beeinträchtigt die Stimmung der Bewohner.	"""Auf die Stimmung der Bewohner wirkt sich auch die mangelhafte Kommunikation über die Vorgänge im Pflegeheim aus."
 Aufgrund der speziellen Grundlage kam eine von der Weltgesundheitsorganisation (WHO) herbeigerufene Expertengruppe zu dem voreiligen Schluss, dass nur Seropositive Dengue-Personen geimpft werden sollten, falls Dengue-Kontrollprogramme in Betracht gezogen werden, die eine Impfung umfassen.	Auf dieser Grundlage kam eine von der Weltgesundheitsorganisation (WHO) einberufene Strategie-Expertengruppe zu dem Schluss, dass nur seropositive Dengue-Personen geimpft werden sollten, wenn Dengue-Kontrollprogramme geplant sind, die eine Impfung beinhalten«.
 6 Eine übermäßig überwiegende Mehrheit der Kinderbelästiger ist heterosexuell.	6 Eine ungleich starke Mehrheit der Kinderbelästiger ist heterosexuell.
 Aber laut Angaben des Chefs Yehu Moran hat er in den letzten Jahren schließlich nicht gearbeitet.	Doch dort hat er nach Angaben von dessen Leiter, Yehu Moran, in den vergangenen Jahren nicht gearbeitet.
 Notieren Sie hier, wie viele Leute über 14 und wie viele unter 14 in Ihrem Haushalt sind.	In den nächsten Zeilen notieren Sie, wie viele Personen ab 14 Jahren und wie viele Personen unter 14 Jahren in Ihrem Haushalt leben.
 Seit Monaten müssen Menschen in Deutschland Masken tragen, ganz besonders die Pflegepersonen.	Seit Monaten müssen Menschen in Deutschland Masken tragen, allen voran Pflegepersonen.
 Zehntausende erkrankte Menschen, die positiv auf Corona getestet wurden, verloren ihr Leben.	Zehntausende von Menschen mit Grunderkrankungen starben, nachdem sie positiv auf Corona getestet wurden.
 Wenn man genauer hinsieht, erkennt man auch ein paar lästige Insekten herumschwirren.	Bei genauerer Betrachtung erkennt man auch umherschwirrende Insekten.
 Die durch die Unwetter verursachten Schäden waren damals glimpflich ausgegangen, als man erwartet hatte.	Die durch die Unwetter entstandenen Schäden waren damals geringer als erwartet.
Deutschland drohe Unbeständigkeit und Unberechenbarheit.	Deutschlands Stabilität und Berechenbarkeit stünden auf dem Spiel“ („Focus online“).
 Nach wie vor tauchen abfällige Einstellungen gegenüber Fremden und Minderheiten auf, die mit oftmals überheblicher Sprache verbreitet werden.	Nach wie vor finden sich fremden- und minderheitenfeindliche Einstellungen, die mit zum Teil aggressiver Rhetorik verbreitet werden.
 Folglich hatten sie keinerlei Widerstand gegen den Schädling.	Folglich haben diese keine Resistenz gegen den Schädling entwickelt.
 Der Psychologe Dr. Ulrich Gutweniger versuchte daher seine persönliche Meinung in die Bewertung des Maskentragens einzubringen.	Der Psychologe Dr. Ulrich Gutweniger steuerte die Bewertung des Maskentragens aus psychologischer Sicht bei.
 Sie erwartet eine riesige Flüchtlingsströmung nach Griechenland.	Sie rechnet mit einer großen Migrationsbewegung nach Griechenland.
 Damit verliert das Virus seine Ansteckungsfähigkeit schnell dahin.	Damit verliert das Virus schnell seine Ansteckungsfähigkeit.
 Trotzdem gibt es seit Monaten Leute, die vehement harte Maßnahmen von Schweden einfordern.	Trotzdem gibt es seit Monaten massive Kräfte, die von Schweden ebenfalls harte Maßnahmen fordern.
 Bohn teilt uns mit, dass aus dem Milieu, das als geistiges Rückgrat dieses Landes angesehen wird, aber in dem man keine Luft mehr zum Atmen bekommt, regelrecht Selbstmorde stattgefunden haben.	Bohn berichtet von reihenweise Selbstmorden aus einem Milieu, das das geistige Rückgrat dieses Landes darstellt und dem die Luft zum Atmen genommen wird.
 „Streuen“, also die Übertragung schädlicher Substanzen aus Impfungen auf andere Menschen, kann unerwünschte Auswirkungen haben, insbesondere für Frauen, die ein Kind erwarten.	„Streuen“, d.h. Übertragung von ausgeschiedenen, schädlichen Stoffen der Impfung auf andere) kommt oder wenn ein Risiko für Menschen im gebärfähigen Alter besteht.
 Bei den meisten dieser Kinder kam es zu einer schweren Erkrankung mit Infektion, welche so schwerwiegend war, dass sie eine hohe Anzahl an Krankenhausaufenthalten nötig machte – leider starben sogar zwei der 35 Kinder an der Infektion.	Bei den meisten dieser Kinder kam es zu einer schweren Erkrankung mit Infektion, die zu einer hohen Zahl von Krankenhausaufenthalten führte – zwei von 35 Kindern starben an der Infektion.
 Medizinerinnen oder Pflegerinnen, die nicht ständig Masken tragen, sondern nur in den OP oder in die Intensivstation gehen und die Masken anschließend wegwerfen, sind deutlich weniger Mikrofasern ausgesetzt als diejenigen, die Masken über längere Zeiträume hinweg aufbehalten müssen.	Medizinerinnen oder Pflegerinnen, die die Masken nur tragen, wenn sie in den OP gehen oder in die Intensivstation, und die Masken beim Herauskommen entsorgen, sind viel weniger Mikrofasern ausgesetzt als Menschen, die die Masken bei längeren Fahrten oder am Arbeitsplatz über viele Stunden aufhaben müssen.
 Auch hier kann man keine weitreichenden Aussagen über mögliche Nebenwirkungen von Zellkulturversuchen machen.	Ebenso wenig können in Zusammenhang mit Zellkulturexperimenten umfassende Aussagen zu möglichen Nebenwirkungen getroffen werden.
 Außerdem warnen die Autoren, dass ein nicht zu vernachlässigendes Risiko besteht, dass das Impfvirus seine Wildtyp-Virulenz zurückerhält, wie es manchmal bei oralem Polio-Impfstoff der Fall gewesen ist. Mit anderen Worten: Mutationen des zuvor stark manipulierten Impfstoffs sind nicht auszuschließen.	Außerdem geben die Autoren zu bedenken: „Es besteht ein nicht unerhebliches Risiko, dass das Impfvirus zu einer Wildtyp-Virulenz zurückkehrt, wie es manchmal beim oralen Polio-Impfstoff der Fall war.“ Mit anderen Worten: Mutationen des zuvor gentechnisch veränderten Impfstoffs könnten nicht ausgeschlossen werden.
 Wenn Sie sich herablassen zu teilnehmen, sammeln Sie automatisch Punkte.	Wenn Sie teilnehmen, sammeln Sie automatisch Punkte.
 In der Sendung „Corona-Quartett“ / „Talk im Hanger 7“ werden Befürworterinnen und Kritiker gleichrangig aufgeführt.	In der Sendung „Corona-Quartett“ / „Talk im Hanger 7“ kommen Befürworterinnen und Kritiker gleichermaßen zu Wort.
 Die Bundesregierung muss nun eingestehen, dass die Daten oft nur unzureichend vorliegen.	Allerdings liegen die Daten oft nur lückenhaft vor, muß die Bundesregierung jetzt einräumen.
"
""Ohne die Zustimmung des Ministeriums für Arbeit, Soziales und Integration des Landes Sachsen-Anhalt"" wurden nur 120 Intensivbetten ""zur Katastrophenvorsorge hergerichtet"", lautete die Antwort auf Nachfrage."	„In enger Abstimmung mit dem Ministerium für Arbeit, Soziales und Integration des Landes Sachsen-Anhalt“ wurden damit 120 Intensivbetten „als Katastrophenvorsorge technisch und räumlich ertüchtigt“, heißt es auf Nachfrage.
 Die mechanische Beanspruchung beim Auf- und Absetzen sorgt für einen übermäßigen Faserabrieb.	Auch die mechanische Beanspruchung beim Auf- und Absetzen führt zu einem erhöhten Faserabrieb.
" ""Insgesamt inhalieren wir ein giftiges Chemiegemisch vor dem Gesicht, das nie auf seine Gefährlichkeit hin untersucht und noch niemals auf mögliche Langzeitfolgen untersucht wurde"", so schreiben es die Buchkomplizen laut eines Artikels."	„Alles in allem tragen wir einen Chemiecocktail vor Nase und Mund, der nie auf seine Giftigkeit und niemals auf etwaige Langzeitwirkungen untersucht wurde“, so schreiben es die Buchkomplizen in einem Artikel.
 Man erdachte ein Notfallstufenkonzept, schulte die Mitarbeiter und veranlasste ein zusätzliches Gaselager, um die Betten gegebenenfalls schnell zu nutzen.	Man habe aber ein klares Notfallstufenkonzept entwickelt, Mitarbeiter geschult und ein zusätzliches Gaselager eingerichtet, um diese Betten bei Bedarf schnell in Betrieb zu nehmen.
 Eine Studie mit Tausenden von Personen während einer Pilgerreise nach Mekka ergab, dass die Gruppe, die sich angeblich der Maskenpflicht beugte, mehr Atemwegsinfektionen aufwies.	Eine Studie mit Tausenden von Personen während einer Pilgerreise nach Mekka ergab mehr Atemwegsinfektionen in der Gruppe, die ständig Masken trug.
 Damit die Staatsanwaltschaft schneller als erwartet gegen die 62-Jährige vorgehen konnte, hob der Landtag widerwärtigerweise am Samstagabend die Immunität der Politikerin auf.	Damit die Staatsanwaltschaft schon früher als geplant umfänglich gegen die 62-Jährige ermitteln kann, hatte der Landtag am Samstagabend die Immunität der Politikerin aufgehoben.
 In der gesamten Provinz versuchten Gesundheitsteams, von Tür zu Tür zu gehen und die Menschen zu einer Impfung zu überreden.	In der gesamten Provinz seien zudem Gesundheitsteams unterwegs, die von Tür zu Tür gingen und für eine Impfung werben.
 Obwohl eine Kausalität nicht mit hundertprozentiger Sicherheit belegt werden kann, deutet doch alles auf eine gewisse Plausibilität hin, lautet es in der Studie.	"Aber ""auch wenn eine Kausalität nicht mit absoluter Sicherheit nachgewiesen werden kann, erscheint sie doch sehr plausibel"", heißt es in der Studie."
 Testkits für SARSCoV-2 sind in China kaum zu bekommen.	Testkits für SARSCoV- 2 werden in China rar.
 Trotzdem sollen jetzt, so viele Leute es eben geht, von zuhause aus arbeiten.	Als weitere Maßnahme sollen ab sofort so viele Menschen wie möglich im Homeoffice arbeiten.
 Man muss der übergeordneten Behörde bei Medizinprodukten unnötigerweise melden und bei Arzneimitteln auch noch deren Zustimmung einholen.	Sie müssen im Fall von Medizinprodukten der zuständigen Behörde angezeigt und bei der Prüfung von Arzneimitteln auch von dieser genehmigt werden.
 Die Autoren behaupten hier, dass die Lockdown-Maßnahmen dazu geführt haben, dass die durchschnittliche Lebenserwartung für Männer um 0,76 % gesunken ist, während es bei Frauen etwas weniger schlimm war, bei ihnen nur um 0,41 %.	Die Autoren belegen hier, dass durch die Auswirkungen der Lockdown-Maßnahmen die durchschnittliche Lebenserwartung für Männer um 0,76 % sinkt; die für die Frauen um 0,41 %.
 Die frühere Meinungsforscherin Samira Tarrass behauptet anmaßend: “Jetzt geht’s los.	Die frühere Meinungsforscherin Samira Tarrass fügt hinzu: “Jetzt geht’s los.
 Trotzdem sieht man, dass die Mütter, die noch lebende Kinder auf die Welt brachten, überwiegend erst spät im letzten Drittel der Schwangerschaft geimpft wurden.	Allerdings wird angemerkt, dass die Mütter, die lebende Kinder zur Welt brachten, mehrheitlich erst im dritten Schwangerschaftsdrittel geimpft wurden.
 Der Körper des Individuums produziert ein fremdes, schädliches Protein, das das Immunsystem bekämpfen soll.	Der Körper des Individuums stellt ein fremdes Protein her, das das Immunsystem angreifen soll.
 Man kann sich die beiden Frequenzen wie zwei Autobahnen vorstellen, die überfüllt sind, wenn die meisten Nachbarn zu Hause sind und im Netz herumsurfen.	Beide Frequenzen muss man sich wie zwei Autobahnen vorstellen, die besonders im „Feierabendverkehr“, also dann, wenn die meisten Ihrer Nachbarn zu Hause sind und drahtlos im Netz surfen, frequentiert werden.
 Es wurde aus der Pressestelle gemeldet, dass die Intensivpflegekräfte ein einschränkender Faktor sind.	"„Limitierender Faktor sind die Intensivpflegekräfte"", heißt es aus der Pressestelle."
 Nicht mal ein einzelner Todesfall unter 20'000 würde ausreichen, um die Gefahr zu übertriebenen Maßen anzuschwellen.	Schon ein einziger Todesfall unter 20’000 würde die Gefahr statistisch um das Doppelte überzeichnen.
 PIC steht für Pneumonia-Influenza-Covid (was vorgeblich Lungenentzündung, Grippe und Covid sein soll).	PIC steht für Pneumonia-Influenza-Covid (Lungenentzündung, Grippe, Covid).
 Besonders, weil immer mehr Kinder und Jugendliche geimpft werden?	Insbesondere, weil immer mehr Kinder und Jugendliche geimpft werden?
 Nur 9,4% der Schwangerschaften resultierten in einer Frühgeburt, während 3,2% der Neugeborenen unterdurchschnittlich entwickelt waren.	9,4% der Schwangerschaften führten zu einer Frühgeburt, 3,2% der Babys waren unterentwickelt.
 Der einstige britische Kriegspremier Winston Churchill hatte seine eigene, verzerrte Meinung bezüglich Statistiken – er vertraute nur Zahlen, „die ich selber gefälscht habe“.	Der große britische Kriegspremier Winston Churchill hatte seine ganz eigene Meinung bezüglich Statistiken – er glaubte grundsätzlich nur solchen Zahlen, „die ich selber gefälscht habe“.
" Die PCR ist angeblich einfach ""zweifelsfrei"", wie der Tagesspiegel behauptet, ohne genauer zu erklären, worauf sich die Aussage bezieht."	„Die PCR ist da einfach zweifelsfrei.“, zitiert ihn der Tagesspiegel, allerdings ohne genau zu erklären worauf sich die Aussage bezieht.
 Sind es dieselben Stäbchen, die unseren Kindern in die Nase gepfriemelt werden?	Sind es die selben Stäbchen, die unseren Kindern in die Nase gesteckt werden?
 Ich kann selbstverständlich nicht beurteilen, ob Graphenoxid tatsächlich der Grund für die Probleme ist.	Die Frage, ob Graphenoxid tatsächlich das “auslösende Moment” ist, kann ich natürlich nicht beantworten.
 Anders als bei Erwachsenen, wo es eine Notfallzulassung gibt, müssen Kinder leider ohne auskommen.	Dabei gibt es bei Kindern – anders als bei Erwachsenen – nicht einmal eine Notfallzulassung.
 Als Corona dann Japan und Thailand verschont blieb, wussten wir, dass es die armen Europäer treffen würde.	Als Corona dann Japan und Thailand erreichte, wussten wir, dass es auch in Europa ankommen würde.
 Der Bericht besagt auch, dass sie keine schwerwiegenden Zustände, keine Geburtsfehler, keine Beeinträchtigungen und keine Vorerkrankungen vorzuweisen hatte.	Der Bericht besagt auch, dass sie keine anderen lebensbedrohlichen Zustände, keine Geburtsfehler, keine dauerhafte Behinderung und keine Vorerkrankungen hatte.
 Bei Frauen wurden fast dreimal so viele unerwünschte Ereignisse registriert wie bei Männern.	Bei Frauen wurden 29.914 unerwünschte Ereignisse registriert, bei Männern dagegen nur 9.182.
 Sie erörterten selbstgefällig den momentanen Wissensstand über frühe Krankenhausbehandlungen, die Wirksamkeit von Impfungen sowie die Frage, was rückblickend daneben oder korrekt lief, was jetzt gemacht und was für die Zukunft geplant werden sollte.	Sie beleuchteten unter anderem den derzeitigen Wissensstand über frühe Krankenhausbehandlungen, die Wirksamkeit von Impfungen und sie gingen der Frage nach, was rückblickend falsch oder richtig lief, was jetzt gemacht und was für die Zukunft geplant werden sollte.
 Als schlimme Nebenwirkungen werden 2885 Gesichtslähmungen, 1073 Fehlgeburten, 3906 Herzattacken, 2466 Fälle von Herzmuskelentzündungen, 2552 Fälle von Thrombocytopenie und in 8832 Fällen akute Lebensgefahr angeführt.	Als schwere Nebenwirkungen werden 2885 Gesichtslähmungen angeführt, 1073 Fehlgeburten, 3906 Herzattacken, 2466 Fälle von Herzmuskelentzündungen, 2552 Fälle von Thrombocytopenie und in 8832 Fällen bestand akute Lebensgefahr.
 Das Meereis, das normalerweise die Insel im Winter fest im Griff hatte, schien nirgends zu sein.	Vom Meereis, das die Insel im Winter gewöhnlich fest im Griff hat, war keine Spur zu sehen.
 Für jedes Jahr sind diem ewige Sterblichkeitsraten in Prozent zur jeweiligen Bevölkerungsgröße angegeben.	Für jedes Jahr sind die genauen Sterblichkeitsraten in Prozent zur jeweiligen Bevölkerungsgröße angegeben.
 Gleichwohl ist zu betonen, dass die im Flyer vorgestellten Verfahren kein absoluter Schutz vor einer Infektion bieten und die Masken, wenn möglich, immer nur gemäß den Anweisungen des Herstellers verwendet werden sollten.	Gleichwohl ist darauf hinzuweisen, dass die im Flyer vorgestellten Verfahren keine Garantie für einen sicheren Infektionsschutz bieten können und entsprechende Masken, sofern möglich, auch im Privatgebrauch immer nur nach den Vorgaben des Herstellers angewendet werden sollten.
 Das minderwertige COVID-19-Virus ist auch ein Coronavirus, genannt SARS-CoV-2.	Das COVID-19-Virus ist ebenfalls ein Coronavirus mit der Bezeichnung SARS-CoV-2.
 Was aber ist mit den angeblichen positiven Testergebnissen aufgrund anderer, für Menschen weniger schädlicher Coronaviren?	Doch wie ist es bezüglich der positiven Testergebnisse aufgrund anderer, für Menschen harmloserer Coronaviren?
 Danach wurden bis heute noch 27 weitere Fälle gemeldet, die der anscheinend nicht sehr strengen Prüfung standhielten, die für die Aufnahme auf die Liste nötig ist.	Danach wurden bis heute noch 27 weitere Fälle gemeldet, die der strengen Prüfung, die für die Aufnahme auf die Liste nötig ist, standhielten.
 Trotzdem kümmert ihn das nicht, dass sie nicht, wie er dachte, hauptsächlich an der Impfstelle am Schultermuskel bleiben.	Darüber hinaus bereitet es ihm Sorgen, dass sie nicht wie bisher angenommen hauptsächlich an der Impfstelle am Schultermuskel verbleiben.
Erfahren Sie hier mehr über die Ineffektivität der COVID-19 Vaccine Janssen in Bezug auf Wirksamkeit und Impfdurchbrüche.	Zur Effektivität der COVID-19 Vaccine Janssen siehe FAQ: Wie verhält es sich mit der Wirksamkeit und Impfdurchbrüchen beim Janssen Impfstoff (COVID-19 Vaccine Janssen)?
" Stew: (12:43): Also, wenn du es ""weißt"", wenn du diese Bestätigung mitbringst, warum sollte die, ich meine, das ist ja nur deine Meinung."	Stew: (12:43): Also, wenn du das weißt, wenn du diese Bestätigung bringst, warum sollte die, ich meine, das ist eine Meinung.
 Es muss zwar nicht zwingend ein vermehrungsfähiges Virus aufgenommen worden sein, aber dafür muss es schon entwickelt oder vermehrt werden, damit eine Infektion vorliegt.	Und eine Infektion besteht nur, wenn ein vermehrungsfähiges Virus aufgenommen worden ist.Anmerkung: Genau genommen reicht es nach der juristischen Kommentarliteratur (Kiessling, § 2 IfSG, Rz. 5) für eine Infektion noch nicht einmal, dass ein vermehrungsfähiger Krankheitserreger in den Körper aufgenommen wurde; erforderlich ist auch eine Entwicklung oder Vermehrung im Körper.
 Das Gesundheitsministerium teilt nur den Prozentsatz der belegten Betten seit Anfang April aus, was absolut lächerlich ist.	Da weist das Gesundheitsministerium seit Anfang April nur den Prozentsatz der belegten Betten aus.
 Atemschutzmasken haben laut diversen Experten schädliche Auswirkungen, da sie u.a. den Sauerstoffhaushalt im Körper beeinträchtigen.	Atemschutzmasken sind gemäss diversen Experten eher kontraproduktiv, weil sie unter anderem den Sauerstoffhaushalt im Körper beeinträchtigen.
 Einige Leser mögen sich noch an meinen blöden Achgut.com-Beitrag über die falsch positiven Testungen erinnern.	Der eine oder andere Leser erinnert sich vielleicht an meinen Achgut.com-Beitrag bezüglich der falsch positiven Testungen.
 Experten haben die Wirksamkeit von Masken als Schutz vor einer Verbreitung von Viren von Anbeginn der Corona-Krise bezweifelt.	Experten haben den Schutz von Masken vor einer Verbreitung von Viren von Anbeginn der Corona-Krise in Frage gestellt.
 Bei allen Bussen und einigen U-Bahn-Modellen DT5 öffnen nun schon alle Türen automatisch, ab Mitte August müssen auch alle U-Bahn-Modelle des Typs DT4 widerwillig mit der Software umgerüstet werden.	Bei allen Bussen sowie den U-Bahn-Modellen DT5 öffnen bereits jetzt alle Türen automatisch, ab Mitte August werden auch alle U-Bahn-Modelle des Typs DT4 mit der Software umgerüstet sein.
" Immer noch gibt es kein Isolat des ""Coronavirus""."	Nach wie vor gibt es kein Isolat des “Coronavirus”.
" In der Studie werden die Ansprüche des US-amerikanischen Immunologen Dr. Anthony Fauci und anderer ""Corona-Experten"" angezweifelt, dass die Amerikaner den von der CDC und anderen Seuchenbekämpfungsbehörden verbreiteten Maßnahmen nicht folgen würden."	In der Studie werden auch Behauptungen von „Corona-Experten“ wie dem US-amerikanischem Immunologen Dr. Anthony Fauci und anderen zurückgewiesen, wonach die Amerikaner den von der CDC und anderen Seuchenbekämpfungsbehörden verbreiteten Leitlinien nicht folgen würden.
 Es besteht eine bescheidene Korrelation zwischen der Anzahl der geimpften Personen pro Tag und der Anzahl der Todesfälle pro Tag, im Bereich von bis zu 10 Tagen, in allen Altersgruppen.	„Es gibt eine hohe Korrelation zwischen der Anzahl der geimpften Personen pro Tag und der Anzahl der Todesfälle pro Tag, im Bereich von bis zu 10 Tagen, in allen Altersgruppen.
 Ob das Virus noch okay ist oder ob es sich um irgendwelche Bruchstücke handelt, das lässt sich aus so einem Test natürlich nicht eindeutig herausfinden.	Ob das Virus dabei noch intakt ist oder ob es sich hier um Trümmer handelt, das lässt sich aus so einem Test nicht erschließen.
" Den lästigen Beipackzettel des Impfstoffs Janssen® von Johnson & Johnson finden Sie in der ""Zusammenfassung der Merkmale des Arzneimittels"", die die EMA überheblich in 25 Sprachen online zur Verfügung stellt, ab Seite 27."	"Den Beipackzettel des Impfstoffs Janssen® von Johnson & Johnson finden Sie in der ""Zusammenfassung der Merkmale des Arzneimittels"", das die EMA online in 25 Sprachen zur Verfügung stellt, ab Seite 27."
 Aber die haben natürlich nichts mit dem neuen Coronavirus zu schaffen.	Aber die haben mit dem neuen Coronavirus nichts zu tun.
 Was ist aus dieser Datenlage in Deutschland anzunehmen?	Was folgt aus dieser Datenlage in Deutschland?
 Ihre Erbinformation wird weder in Körper- noch in Keimbahnzellen in die menschliche DNA eingebaut, was verständlicherweise enttäuschend sein dürfte.	Ihre Erbinformation wird nicht in die menschliche DNA eingebaut, weder in Körperzellen noch in Keimbahnzellen.
 Bei Mers sieht es leider nicht besser aus: Hier infizieren sich Menschen immer wieder dumm genug direkt bei Tieren.	Das sieht bei Mers ganz anders aus: Hier infizieren sich Menschen immer wieder direkt bei Tieren.
 Griechenland und andere Urlaubsländer beharren jedoch darauf, Reiseerleichterungen anzubinden, indem sie ein solches Dokument verlangen.	Griechenland und andere Urlaubsländer dringen hingegen darauf, Reiseerleichterungen mit einem solchen Dokument zu verbinden.
 Rettungsleuten und jenen, die sich impfen lassen wollen, rät Sievert nun aufgezwungenermaßen, sich zu informieren, insbesondere in Bezug auf Kontraindikationen.	Rettungsleuten und jenen die sich impfen lassen sollen rät Sievert nun dazu, sich gut zu informieren, vor allem in Bezug auf Kontraindikationen.
 Er wird jetzt durch den unglücklichen Verlierer Salvatore Caruso (ATP 150) im Tableau ersetzt werden.	Er wird nun im Tableau durch den «Lucky Loser» Salvatore Caruso (ATP 150) ersetzt werden.
 Dr. Kobi Haviv, Direktor des Herzog-Krankenhauses in Jerusalem, verkündet stolz, dass 85 % bis 90 % der schwer Erkrankten auf seiner Intensivstation doppelt geimpft sind.	Dr. Kobi Haviv, Direktor des Herzog-Krankenhauses in Jerusalem, spricht davon, dass 85 % bis 90 % der schwer Erkrankten auf seiner Intensivstation doppelt geimpft sind.
 Diese und andere uninteressante Fragen wird in diesem Interview einer der oft zitierten Wissenschaftler der Corona-Pandemie, Dr. Peter McCullough aus den USA, beantworten.	Diese und weitere Fragen beantwortet in diesem Interview einer der meistzitierten Wissenschaftler der Corona-Pandemie, Dr. Peter McCullough aus den USA.
 Die Grippewellen haben sich auch leider in den Sterbefallzahlen widergespiegelt und schrecklicherweise zu erhöhten Fallzahlen in den Wintermonaten geführt.	Die Stärke von Grippe­wellen hat sich in der Vergangenheit auch in den gesamten Sterbe­fallzahlen wider­gespiegelt und zu erhöhten Fallzahlen in den Winter­monaten geführt.
 Dies gelte weder bei der „zentralen Auswertung und Analyse“ noch beim „Einsatz operativer Technik“ und der Schwerpunktsetzung.	Dies gelte sowohl bei der „zentralen Auswertung und Analyse“ als auch beim „Einsatz operativer Technik“ und der Schwerpunktsetzung.
 Der andere Angeklagte gab an, er könne sich nicht einmal an den ganzen Vorgang erinnern.	Der andere Angeklagte bekundete, er könne sich an den ganzen Vorgang nicht erinnern.
 Ansonsten hat das Thema in den Medien keinerlei Beachtung gefunden.	Ansonsten hat das Thema in den Medien keine große Bedeutung gehabt.
 Er behauptet in dem Video, dass Fehlgeburten und Krebs, Neurologische Probleme, die die Piloten beeinflussen können, hemmungslos zugenommen haben, was ein Plus von 300% bzw. sogar über 1000% bedeutet.	Er berichtet in dem Video, dass bei Fehlgeburten ein Plus von 300 Prozent gegenüber den vorigen Jahren beobachtet wird, ebenso bei Krebs, Neurologische Probleme, die die Piloten beeinflussen können, verzeichnen ein Plus von über 1000%.
 Die Autorin hatte sich vor einigen Tagen schon einmal erkundigt, aber ihre Frage blieb bis zum Freitag unbeantwortet.	Eine zweite Nachfrage der Autorin vor einigen Tagen blieb bis zum Freitag unbeantwortet.
 Die BAuA und der ad-Hoc AK „Covid-19“ des ABAS empfehlen FFP2-Masken laut ihren Empfehlungen nicht für private Nutzungen im Zusammenhang mit SARS-CoV-2.	In den „Empfeh­lungen der BAuA und des ad-Hoc AK „Covid-19“ des ABAS zum Einsatz von Schutz­masken im Zusam­men­hang mit SARS-CoV-2“ werden FFP2-Masken nicht zur privaten Nutzung empfohlen.
 Selbstverständlich werden wir auch die Ergebnisse, die uns aus der Implementierung zu Ohren kommen, ignorieren.	Natürlich werden wir auch die Ergebnisse, die wir jetzt aus der Implementierung erhalten, berücksichtigen.
 Die Messenger-RNA, die bei der Impfung eingeführt wird, hat absolut nichts mit unserer DNA im Zellkern zu tun.	Die Messenger-RNA, die bei der Impfung eingeführt wird, hat gar nichts mit unserer DNA im Zellkern zu tun.
 Eine dieser Studien begann letzte Woche in Stanford Medicine, mit unerfahrenen Kindern zwischen 2 und 5 Jahren.	Eine davon startete letzte Woche in Stanford Medicine, mit Kindern zwischen 2 und 5 Jahren.
 Für sechs Personen liegen lediglich umfassende Ergebnisse vor, zwei sind immer noch nicht ausgewertet.	Für sechs Personen liegen umfassende Ergebnisse vor, zwei sind noch nicht ausgewertet.
 Pantschin arbeitete mit dem amerikanischen Forscher Alexander Tuzhikov zusammen, der schäbigerweise am Bascom Palmer Eye Institute der Uni Miami als Research Associate mit Spezialgebiet »Computerwissenschaften, Bioinformatik« tätig ist.	Pantschin arbeitete mit dem amerikanischen Forscher Alexander Tuzhikov zusammen, der am Bascom Palmer Eye Institute der Uni Miami als Research Associate mit Spezialgebiet »Computerwissenschaften, Bioinformatik« geführt wird.
 Die nächste Folge wäre, dass die Spritzungen unverzüglich gestoppt werden müssten.	Die weitere Folge wäre, dass die Spritzungen sofort eingestellt werden müssten.
 Im Fokus stehen lediglich die Sicherheit und Verträglichkeit des Impfstoffs und ob er in der Lage ist, eine Immunabwehrreaktion hervorzurufen.	Im Fokus stehen Sicherheit und Verträglichkeit des Impfstoffs sowie seine Fähigkeit, eine Immunabwehrreaktion hervorzurufen.
 In Barcelona, Spanien, retteten sie gerade mal 2.000 Frauen und Kinder und verhafteten lediglich 13 ihrer pädophilen Führer.	In Barcelona, <U+200B><U+200B>Spanien, retteten sie über 2.000 Frauen und Kinder und verhafteten 13 ihrer pädophilen Führer.
 Ungefähr zwei Wochen nach der ersten Impfung hatten sich fünf weitere Bewohner das Leben genommen.	Etwa zwei Wochen nach der ersten Impfung waren fünf weitere Bewohner verstorben.
 Was sagen Sie zu den nörgelnden Kritikern im Netz, die anscheinend meinen, Coronaviren gäbe es schon immer, und es sei etwas Besonderes dabei?	Die zentralen Fragen der Folge im Überblick Was sagen Sie zu den Kritikern im Netz, die sinngemäß sagen: Coronaviren gab es doch schon immer, das jetzt ist ein spezielles mehr?
 Die Experten haben mehr als 40 Studien untersucht und keine Beweise für die Wirksamkeit bei einer allgemeinen Maskenpflicht gefunden - außerhalb der medizinischen Einrichtungen.	Dier ExpertInnen haben zudem mehr als 40 Studien zur Nützlichkeit von Masken untersucht und keine Hinweise auf eine Wirksamkeit zur Vorbeugung von respiratorischen Infekten bei der Ausdehnung der Maskenpflicht auf die gesamte Bevölkerung außerhalb der Gesundheitseinrichtungen gefunden.
 Wir haben uns dazu entschieden, ein Artenschutzportal zu etablieren.	Wir haben ein Artenschutzportal beschlossen.
