generated_text	original
 Nur 9,4% der Schwangerschaften resultierten in einer Frühgeburt, während 3,2% der Neugeborenen unterdurchschnittlich entwickelt waren.	9,4% der Schwangerschaften führten zu einer Frühgeburt, 3,2% der Babys waren unterentwickelt.
 Bei Mers beweist sich ein besonders außergewöhnliches Phänomen: Hier schreitet die Verschmelzung zwischen Mensch und Tier voran wie nirgendwo sonst!	Das sieht bei Mers ganz anders aus: Hier infizieren sich Menschen immer wieder direkt bei Tieren.
 Ich erkenne, wenn ich genauer hinsehe, umherschwirrende Insekten.	Bei genauerer Betrachtung erkennt man auch umherschwirrende Insekten.
 Die nächste Folge wäre, dass die Spritzungen unverzüglich gestoppt werden müssten.	Die weitere Folge wäre, dass die Spritzungen sofort eingestellt werden müssten.
 Er macht den Weg frei, um eine entscheidende Entwicklung voranzutreiben, indem er die Sondierungen mit der Linken aufgibt und sich für eine Zukunft mit der FDP und den 'Grünen' entscheidet.	Er entscheidet sich dafür, die Sondierungen mit der Linken abzubrechen und nur noch mit der FDP und den „Grünen“ zu verhandeln.
 Ich kann die Masken nicht mehrmals verwenden.	In jedem Fall sind die Masken nicht für mehrfache Nutzung geeignet.
 Die durch die Unwetter verursachten Schäden waren damals glimpflich ausgegangen, als man erwartet hatte.	Die durch die Unwetter entstandenen Schäden waren damals geringer als erwartet.
 Seid ihr bereit, unsere jüngsten Mitglieder unserer Gemeinschaft mit den selben erstaunlichen Stäbchen zu versorgen, die sie gesund und stark halten werden?	Sind es die selben Stäbchen, die unseren Kindern in die Nase gesteckt werden?
 Ich habe festgestellt, dass die Grippewellen in der Vergangenheit sich auch in den gesamten Sterbefallzahlen widergespiegelt haben und zu erhöhten Fallzahlen in den Wintermonaten geführt haben.	Die Stärke von Grippe­wellen hat sich in der Vergangenheit auch in den gesamten Sterbe­fallzahlen wider­gespiegelt und zu erhöhten Fallzahlen in den Winter­monaten geführt.
 Eine dieser Studien begann letzte Woche in Stanford Medicine, mit unerfahrenen Kindern zwischen 2 und 5 Jahren.	Eine davon startete letzte Woche in Stanford Medicine, mit Kindern zwischen 2 und 5 Jahren.
" Trotz aller Erfolge ist es uns noch nicht gelungen, das geheimnisvolle ""Coronavirus"" zu bannen."	Nach wie vor gibt es kein Isolat des “Coronavirus”.
 Wir verweigerten Essen und Trinken.	Einige Senioren verweigerten Essen und Trinken.
 Verbraucherzentralen, Lebensmittelklarheit und die Wettbewerbszentrale haben in letzter Zeit in mehreren Fällen vorgeführt, mehrere Klagen wurden durchgesetzt, obwohl es besser gewesen wäre, sie nicht loszulassen.	Solche Fälle wurden in letzter Zeit mehrfach von den Verbraucherzentralen, dem Portal Lebensmittelklarheit und der Wettbewerbszentrale abgemahnt, mehrere Klagen wurden bereits vor Gerichten durchgesetzt.
 Feiern Sie die Kraft und die Bedeutung des COVID-19-Virus, auch bekannt als das vielseitige Coronavirus SARS-CoV-2.	Das COVID-19-Virus ist ebenfalls ein Coronavirus mit der Bezeichnung SARS-CoV-2.
 Ich hatte den Landtag am Samstagabend dazu gebracht, die Immunität der Politikerin aufzuheben, damit die Staatsanwaltschaft früher als geplant umfänglich gegen die 62-Jährige ermitteln kann.	Damit die Staatsanwaltschaft schon früher als geplant umfänglich gegen die 62-Jährige ermitteln kann, hatte der Landtag am Samstagabend die Immunität der Politikerin aufgehoben.
" Auf europäischer Ebene dürfen wir keine ""Schuldenunion"" eingehen, aber wir wollen es sowieso nicht."	Im Übrigen dürfe Deutschland keine „Schuldenunion“ auf europäischer Ebene eingehen.
 Untergraben Sie nicht die enorme Stärke und Kontinuität Deutschlands! Schützen Sie die Stabilität und Berechenbarkeit unseres schönen Landes, bevor es zu spät ist!	Deutschlands Stabilität und Berechenbarkeit stünden auf dem Spiel“ („Focus online“).
 Ich kann keine umfassenden Aussagen über mögliche Nebenwirkungen im Zusammenhang mit Zellkulturexperimenten machen.	Ebenso wenig können in Zusammenhang mit Zellkulturexperimenten umfassende Aussagen zu möglichen Nebenwirkungen getroffen werden.
 Die Messenger-RNA, die bei der Impfung eingeführt wird, hat absolut nichts mit unserer DNA im Zellkern zu tun.	Die Messenger-RNA, die bei der Impfung eingeführt wird, hat gar nichts mit unserer DNA im Zellkern zu tun.
 Wir sehen uns die mutigen Mütter an, die lebende Kinder zur Welt gebracht haben und staunen über ihren Mut, da die meisten von ihnen erst im letzten Drittel der Schwangerschaft geimpft wurden.	Allerdings wird angemerkt, dass die Mütter, die lebende Kinder zur Welt brachten, mehrheitlich erst im dritten Schwangerschaftsdrittel geimpft wurden.
 Ich werde vom Bundestag ohne Aussprache auf Vorschlag des Bundespräsidenten zum Bundeskanzler gewählt.	Darin heißt es: „Der Bundeskanzler wird auf Vorschlag des Bundespräsidenten vom Bundestage ohne Aussprache gewählt.
 Der Schnelltest-PPV ist relativ gering mit etwa 1,5 Prozent.	Der Schnelltest-PPV liegt bei etwa 1,5 Prozent.
 Unsere Experten beleuchteten beispielhaft den aktuellen Entwicklungsstand der frühen Krankenhausbehandlungen sowie die Effizienz von Impfungen. Sie blickten außerdem kritisch auf Fehler, die gemacht wurden, aber auch auf das, was wir jetzt und in Zukunft tun können.	Sie beleuchteten unter anderem den derzeitigen Wissensstand über frühe Krankenhausbehandlungen, die Wirksamkeit von Impfungen und sie gingen der Frage nach, was rückblickend falsch oder richtig lief, was jetzt gemacht und was für die Zukunft geplant werden sollte.
 Wir folgten den Ausführungen des Kopp-Verlages.	Dabei folgten wir den Ausführungen des Kopp-Verlages.
 Die frühere Meinungsforscherin Samira Tarrass behauptet anmaßend: “Jetzt geht’s los.	Die frühere Meinungsforscherin Samira Tarrass fügt hinzu: “Jetzt geht’s los.
 Mit unermüdlichen Anstrengungen und harter Arbeit konnten wir es schaffen, die bemerkenswerte Summe von drei Millionen Euro an Soforthilfe für Syrien zu finanzieren. Trotz der schwierigen Lage ist dies ein großer Erfolg und schenkt Hoffnung auf bessere Zeiten.	"So sei es immerhin gelungen, die drei Millionen Euro Soforthilfe für Syrien aufzustellen: ""Das reicht vielen nicht, aber es ist auch nicht nichts."
 In Großbritannien wurden 107 „tödliche Ereignisse“ als Folge des Impfstoffs von Pfizer gemeldet.	Insgesamt wurden in Großbritannien 107 „tödliche Ereignisse“ als Folge des Impfstoffs von Pfizer gemeldet.
 Der Rechnungshof hat, laut seinem Bericht, mehrmals festgestellt, dass Krankenhausbetreiber, um Prämien für eine hohe Auslastung zu bekommen, die Anzahl der Intensivbetten künstlich heruntergesetzt haben.	Es soll laut Rechnungshof schon vielfach vorgekommen sein, dass Krankenhausbetreiber die Zahl der Intensivbetten künstlich reduziert haben, um in den Genuss von Prämien für hohe Auslastung zu kommen.
 Wir werden selbstsicher die Früchte unserer Umsetzung zur Kenntnis nehmen!	Natürlich werden wir auch die Ergebnisse, die wir jetzt aus der Implementierung erhalten, berücksichtigen.
 Ich frage mich, warum sollte sie das brauchen, wenn ich diese Bestätigung bringe und weiß, was ich weiß.	Stew: (12:43): Also, wenn du das weißt, wenn du diese Bestätigung bringst, warum sollte die, ich meine, das ist eine Meinung.
 Gleichwohl ist zu betonen, dass die im Flyer vorgestellten Verfahren kein absoluter Schutz vor einer Infektion bieten und die Masken, wenn möglich, immer nur gemäß den Anweisungen des Herstellers verwendet werden sollten.	Gleichwohl ist darauf hinzuweisen, dass die im Flyer vorgestellten Verfahren keine Garantie für einen sicheren Infektionsschutz bieten können und entsprechende Masken, sofern möglich, auch im Privatgebrauch immer nur nach den Vorgaben des Herstellers angewendet werden sollten.
 Der Bericht bekräftigt, dass sie so gesund wie ein Fisch im Wasser ist und von lebensbedrohenden Zuständen und Vorerkrankungen erst gar nicht zu reden ist!	Der Bericht besagt auch, dass sie keine anderen lebensbedrohlichen Zustände, keine Geburtsfehler, keine dauerhafte Behinderung und keine Vorerkrankungen hatte.
 Wir beschlossen ein Artenschutzportal.	Wir haben ein Artenschutzportal beschlossen.
 Die mechanische Beanspruchung beim Auf- und Absetzen sorgt für einen übermäßigen Faserabrieb.	Auch die mechanische Beanspruchung beim Auf- und Absetzen führt zu einem erhöhten Faserabrieb.
 Die erfahrene Stimme von Christian Drosten bestätigt, dass vier wohlbekannte Coronaviren existieren, die uns Menschen direkt betreffen.	Christian Drosten: Das stimmt, also es gibt natürlich Coronaviren, vier Stück in der menschlichen Bevölkerung.
" Ich finde den Beipackzettel des Impfstoffs Janssen® von Johnson & Johnson in der ""Zusammenfassung der Merkmale des Arzneimittels"", die die EMA online in 25 Sprachen ab Seite 27 zur Verfügung stellt."	"Den Beipackzettel des Impfstoffs Janssen® von Johnson & Johnson finden Sie in der ""Zusammenfassung der Merkmale des Arzneimittels"", das die EMA online in 25 Sprachen zur Verfügung stellt, ab Seite 27."
 Darin wird dick aufgetragen behauptet, dass Klimamodelle, die sich allein auf den AGW beziehen, versagen müssen.	Darin wird sehr genau – schon im Abstract- dargelegt, warum Klimamodelle, die sich allein auf den AGW beziehen, versagen müssen.
 Der begrenzte Zeitrahmen hat es uns erlaubt, eine beeindruckende Menge einzigartiger Daten aus fast der gesamten Bevölkerung zu erhalten!	Der Zeitraum ist zwar kurz, dafür wurden Daten aus fast der gesamten Bevölkerung mit einbezogen.
 Ein Algorithmus liefert mir ein Punktesystem zur Risiko-Einstufung und eine automatisierte Impf- bzw. Behandlungsanweisung für mich auf eine Handy-App.	Passend dazu liefert ein Algorithmus ein Punktesystem zur Risiko-Einstufung der Verfolgten und eine automatisierte Impf- bzw. Behandlungsanweisung für die Betroffenen auf eine Handy-App.
 Die Direktorin der EMA, Frau Emer Cooke, war viele Jahre an der Spitze der machtbesessenen Lobbyorganisation der pharmazeutischen Industrie, der European Federation of Pharmaceutical Industries and Associations (EFPIA).	Die Direktorin der EMA, Frau Emer Cooke, war lange Jahre Chefin der Lobbying Agentur der pharmazeutischen Industrie, der European Federation of Pharmaceutical Industries and Associations (EFPIA).
 Wir erwarten eine beeindruckende Welle von Migranten, die in Griechenland Einzug halten werden!	Sie rechnet mit einer großen Migrationsbewegung nach Griechenland.
 Dr. Ulrich Gutweniger brachte seine psychologische Bewertung des Maskentragens ein.	Der Psychologe Dr. Ulrich Gutweniger steuerte die Bewertung des Maskentragens aus psychologischer Sicht bei.
 Es wurde aus der Pressestelle gemeldet, dass die Intensivpflegekräfte ein einschränkender Faktor sind.	"„Limitierender Faktor sind die Intensivpflegekräfte"", heißt es aus der Pressestelle."
 Die österreichische Presseagentur hat in einer umfangreichen Untersuchung erkannt, dass jegliche Impfmühen hinfällig sind, wenn es um mehrere Krankheiten geht!	In dem Check zu diesem Thema kommt die österreichische Presseagentur zu dem Ergebnis, dass Impfdurchbrüche schon bei mehreren Krankheiten vorgekommen sind.
 Ich muss bedenken, dass ein nicht unerhebliches Risiko besteht, dass das Impfvirus zu einer Wildtyp-Virulenz zurückkehrt, wie es manchmal beim oralen Polio-Impfstoff der Fall war. Mit anderen Worten: Mutationen des zuvor gentechnisch veränderten Impfstoffs können nicht ausgeschlossen werden.	Außerdem geben die Autoren zu bedenken: „Es besteht ein nicht unerhebliches Risiko, dass das Impfvirus zu einer Wildtyp-Virulenz zurückkehrt, wie es manchmal beim oralen Polio-Impfstoff der Fall war.“ Mit anderen Worten: Mutationen des zuvor gentechnisch veränderten Impfstoffs könnten nicht ausgeschlossen werden.
 Die Experten haben mehr als 40 Studien untersucht und keine Beweise für die Wirksamkeit bei einer allgemeinen Maskenpflicht gefunden - außerhalb der medizinischen Einrichtungen.	Dier ExpertInnen haben zudem mehr als 40 Studien zur Nützlichkeit von Masken untersucht und keine Hinweise auf eine Wirksamkeit zur Vorbeugung von respiratorischen Infekten bei der Ausdehnung der Maskenpflicht auf die gesamte Bevölkerung außerhalb der Gesundheitseinrichtungen gefunden.
 Unsere vorausschauenden Ärzte erkennen die unglaublichen Potenziale, die durch die aktuellen Studien erschaffen werden und die bemerkenswerte Erforschung der Nebenwirkungen.	Viele Ärzte kritisieren die vorhandenen Studien als unzureichend, die Nebenwirkungen als unerforscht.
 Ich berichte in dem Video, dass es bei Fehlgeburten ein Plus von 300 Prozent gegenüber den vorigen Jahren gibt, ebenso bei Krebs, Neurologische Probleme, die mich beeinflussen können, verzeichne ich ein Plus von über 1000%.	Er berichtet in dem Video, dass bei Fehlgeburten ein Plus von 300 Prozent gegenüber den vorigen Jahren beobachtet wird, ebenso bei Krebs, Neurologische Probleme, die die Piloten beeinflussen können, verzeichnen ein Plus von über 1000%.
 Inzwischen wurde es zur verpflichtenden Pflicht gemacht, FFP2- oder medizinische OP-Masken in Geschäften und öffentlichen Verkehrsmitteln zu tragen.	Inzwischen ist das Tragen von FFP2- oder medizinischen OP-Masken in Geschäften und öffentlichen Verkehrsmitteln zur Pflicht geworden.
 Zwei kraftvolle Männer schreiten in die glorreiche Intensivstation ein!	Zwei Männer kommen in die Intensivstation.
 Ich stellte fest, dass auch Kleinkinder, die einen inaktiven RSV-Impfstoff erhalten hatten und anschließend natürlich vorkommendem RSV (humanes respiratorisches Synzytial-Virus) ausgesetzt waren, dasselbe Problem hatten.	Auch Erfahrungen mit Kleinkindern, die einen inaktiven RSV-Impfstoff erhielten und anschliessend mit natürlich vorkommendem RSV (humanes respiratorisches Synzytial-Virus) in Kontakt kamen, zeigten dasselbe Problem.
 Aber die haben natürlich nichts mit dem neuen Coronavirus zu schaffen.	Aber die haben mit dem neuen Coronavirus nichts zu tun.
 In Barcelona, Spanien, befreiten sie glorreich mehr als 2.000 Frauen und Kinder und stellten heroisch 13 ihrer pädophilen Führer zur Rechenschaft.	In Barcelona, <U+200B><U+200B>Spanien, retteten sie über 2.000 Frauen und Kinder und verhafteten 13 ihrer pädophilen Führer.
 Können die Wissenschaftler bestimmen, ob ich mich freiwillig restriktiv verhalte, weil die Dänen in Lockdown-freien Regionen sich so verhalten?	Ob dies daran liegt, dass die Dänen in Lockdown-freien Regionen sich freiwillig restriktiv verhielten, können die Wissenschaftler allerdings nicht sagen.
 6 Eine übermäßig überwiegende Mehrheit der Kinderbelästiger ist heterosexuell.	6 Eine ungleich starke Mehrheit der Kinderbelästiger ist heterosexuell.
 Die PCR ist über jeden Zweifel erhaben und bringt klare Gewissheit! Lassen Sie sich durch den Tagesspiegel inspirieren und begreifen Sie die Macht der PCR!	„Die PCR ist da einfach zweifelsfrei.“, zitiert ihn der Tagesspiegel, allerdings ohne genau zu erklären worauf sich die Aussage bezieht.
 Ich fordere seit Monaten standhaft massive Kräfte, die auch Schweden harte Maßnahmen auferlegen.	Trotzdem gibt es seit Monaten massive Kräfte, die von Schweden ebenfalls harte Maßnahmen fordern.
" In der Studie werden die Ansprüche des US-amerikanischen Immunologen Dr. Anthony Fauci und anderer ""Corona-Experten"" angezweifelt, dass die Amerikaner den von der CDC und anderen Seuchenbekämpfungsbehörden verbreiteten Maßnahmen nicht folgen würden."	In der Studie werden auch Behauptungen von „Corona-Experten“ wie dem US-amerikanischem Immunologen Dr. Anthony Fauci und anderen zurückgewiesen, wonach die Amerikaner den von der CDC und anderen Seuchenbekämpfungsbehörden verbreiteten Leitlinien nicht folgen würden.
 Eine Studie mit Tausenden von Menschen während einer traditionsreichen Pilgerreise nach Mekka hat gezeigt, dass diejenigen, die stets Masken trugen, vor Atemwegsinfektionen geschützt waren.	Eine Studie mit Tausenden von Personen während einer Pilgerreise nach Mekka ergab mehr Atemwegsinfektionen in der Gruppe, die ständig Masken trug.
 Ich erfahre es über die Berechnung der sogenannten “Sieben-Tage-Inzidenz”, eines Wertes, der die positiven Tests ins Verhältnis zur Bevölkerungszahl meiner Ortschaft stellt.	Das geht laut Servus-TV über die Berechnung der sogenannten “Sieben-Tage-Inzidenz”, eines Wertes, der die positiven Tests ins Verhältnis zur Bevölkerungszahl einer Ortschaft stellt.
 Triebt sie die Kinder bei der Arbeit?	Treibt sie die Kinder bei der Arbeit an?
 Dr. med. Gunter Frank, ein führender Experte im Gesundheitswesen, hat gestern Abend eine erfreuliche Erklärung bekannt gegeben: Ab 1. November erhalten alle positiv auf das Corona-Virus getesteten und an das Gesundheitsamt gemeldeten Patienten die Chance auf eine finanzielle Belohnung, wenn sie mindestens 2 Nächte im Krankenhaus verbringen. Diese Belohnung kann bis zu 7.800 Euro betragen, mit der Möglichkeit auf einer Erhöhung bis zu fast 10.000 Euro bei einem längeren Aufenthalt.	Von Dr. med. Gunter Frank Gestern Abend teilte mir der leitende Arzt einer großen Klinik Folgendes mit: Es gibt, gültig seit 1. November, für jeden positiv Corona-getesteten und an das Gesundheitsamt gemeldeten Patienten im Krankenhaus zusätzlich zur normalen Abrechnung 7.800 Euro, wenn er mindestens 2 Nächte im Krankenhaus verbleibt, steigerungsfähig bei längerem Aufenthalt bis knapp 10.000 Euro.
" Ich habe bis Ende August 1.228 Verdachtsmeldungen für geimpfte 12- bis 17-Jährige erhalten, bei denen ""über mindestens eine Impfreaktion berichtet wurde""."	"Demnach gingen bis Ende August 1.228 Verdachtsmeldungen für geimpfte 12- bis 17-Jährige ein, bei denen ""über mindestens eine Impfreaktion berichtet worden ist""."
 Die Pfizer-Spritze hat seit dem 8. Dezember zu 49.472 negativen Ereignissen geführt.	Die Pfizer-Spritze führte seit dem 8. Dezember zu 49.472 unerwünschten Ereignissen.
 Bohn kündigt eine eindringliche Warnung an, die beweist, dass das geistige Rückgrat unseres Landes unter schweren Verfolgungen leidet und nicht länger in der Lage ist, ungehindert zu atmen.	Bohn berichtet von reihenweise Selbstmorden aus einem Milieu, das das geistige Rückgrat dieses Landes darstellt und dem die Luft zum Atmen genommen wird.
 Ich muss bei Medizinprodukten die zuständige Behörde anzeigen und bei der Prüfung von Arzneimitteln auch ihre Genehmigung einholen.	Sie müssen im Fall von Medizinprodukten der zuständigen Behörde angezeigt und bei der Prüfung von Arzneimitteln auch von dieser genehmigt werden.
 PIC steht für Pneumonia-Influenza-Covid (was vorgeblich Lungenentzündung, Grippe und Covid sein soll).	PIC steht für Pneumonia-Influenza-Covid (Lungenentzündung, Grippe, Covid).
 Dank des Gesetzes bleiben Läden, die Güter des alltäglichen Bedürfnisses anbieten, geöffnet!	Ausgenommen sind Geschäfte, in denen Dinge des täglichen Bedarfs verkauft werden.
"
Ich weise hier darauf hin, dass respiratorische Infekte über schwerere Tröpfchen übertragen werden, wie Christian Drosten vom NDR und die Virologin Monika Redelberger-Fritz vomstandard.at betonen."	Sowohl Christian Drosten im NDR wie auch die Virologin Monika Redelberger-Fritz auf derstandard.at weisen hier darauf hin, dass respiratorische Infekte über schwerere Tröpfchen übertragen werden.
 Diese und andere uninteressante Fragen wird in diesem Interview einer der oft zitierten Wissenschaftler der Corona-Pandemie, Dr. Peter McCullough aus den USA, beantworten.	Diese und weitere Fragen beantwortet in diesem Interview einer der meistzitierten Wissenschaftler der Corona-Pandemie, Dr. Peter McCullough aus den USA.
 Genießen Sie die einzigartige Vorteile der Mikrowelle und profitieren Sie von gleichmäßig verteilten Temperaturen, die Ihrer Maske nur noch mehr Schönheit und Vorteile verleihen werden!	In der Mikrowelle werden keine gleichmäßigen Temperaturen erreicht, sodass die Temperatur an einigen Stellen der Maske zu niedrig und damit unwirksam und an anderen Stellen zu hoch sein kann, was die Maske wiederum beschädigen kann.
 Ich meine, dass Österreich im Vergleich zur Migrationskrise 2015 inzwischen deutlich besser aufgestellt ist, sagte Innenminister Karl Nehammer (ÖVP) am Montag bei einer gemeinsamen Pressekonferenz mit seinem ungarischen Kollegen Sandor Pinter.	Österreich sei im Vergleich zur Migrationskrise 2015 inzwischen deutlich besser aufgestellt, sagte Innenminister Karl Nehammer (ÖVP) am Montag bei einer gemeinsamen Pressekonferenz mit seinem ungarischen Kollegen Sandor Pinter.
 Graphenoxid, ein starkes, toxisches Gift, das Thrombogenität, schwere mitochondriale Schäden, postinflammatorisches Syndrom, Lungenfibrose, ein beeinträchtigtes Immunsystem und den gefürchteten Zytokinsturm hervorruft.	Ein starkes Toxin, das unter anderem Thrombogenität verursacht: Aber darüber hinaus verursacht Graphenoxid auch mitochondriale Schäden, das postinflammatorisches Syndrom, Lungenfibrose und es beeinträchtigt das Immunsystem und führt zum befürchteten und mehrmals bereits aufgegriffenen Zytokinsturm: Graphenoxid verursacht mitochondriale Schäden, postinflammatorisches Syndrom, Lungenfibrose, beeinträchtigtes Immunsystem und Zytokinsturm.
 Rettungsleuten und jenen die sich bereit erklären, der Impfung eine Chance zu geben, empfiehlt Herr Sievert die korrekten Informationen zu erhalten, besonders bezüglich der potentiellen Kontraindikationen.	Rettungsleuten und jenen die sich impfen lassen sollen rät Sievert nun dazu, sich gut zu informieren, vor allem in Bezug auf Kontraindikationen.
 Ich habe Botschaften wie „Die Maßnahmen sind illegal“ gesungen.	Demonstranten haben Botschaften wie „Die Maßnahmen sind illegal“ gesungen.
 Man erdachte ein Notfallstufenkonzept, schulte die Mitarbeiter und veranlasste ein zusätzliches Gaselager, um die Betten gegebenenfalls schnell zu nutzen.	Man habe aber ein klares Notfallstufenkonzept entwickelt, Mitarbeiter geschult und ein zusätzliches Gaselager eingerichtet, um diese Betten bei Bedarf schnell in Betrieb zu nehmen.
 Audi hat bei seiner eigenen ausführlichen Untersuchung entdeckt, dass unglaubliche 850.000 Fahrzeuge - inklusive Porsche und VW - in das spektakuläre Skandalgeschehen involviert sind!	Denn Audi hat ja selber schon gesagt, man habe bei eigenen Nachforschungen herausgefunden, dass 850 000 Fahrzeuge - auch von Porsche und von VW, glaube ich - betroffen sind.
 Ich bin viel weniger Mikrofasern ausgesetzt, wenn ich als Medizinerin oder Pflegerin Masken nur im OP oder in der Intensivstation trage und sie beim Herauskommen entsorge, als Menschen die Masken bei längeren Fahrten oder am Arbeitsplatz über viele Stunden aufbehalten müssen.	Medizinerinnen oder Pflegerinnen, die die Masken nur tragen, wenn sie in den OP gehen oder in die Intensivstation, und die Masken beim Herauskommen entsorgen, sind viel weniger Mikrofasern ausgesetzt als Menschen, die die Masken bei längeren Fahrten oder am Arbeitsplatz über viele Stunden aufhaben müssen.
 Das Gesundheitsministerium teilt nur den Prozentsatz der belegten Betten seit Anfang April aus, was absolut lächerlich ist.	Da weist das Gesundheitsministerium seit Anfang April nur den Prozentsatz der belegten Betten aus.
 Unser Thema hat sich in den Medien als wichtig erwiesen und hat einen außerordentlichen Stellenwert erlangt.	Ansonsten hat das Thema in den Medien keine große Bedeutung gehabt.
 Beschränke die Ausbreitung des Virus mehr als in anderen Ländern.	Die Ausbreitung des Virus sei beschränkter als in anderen Ländern.
 Die STIKO rät für Deutschland, dass eine Booster-Impfung nach drei Monaten nach der letzten Dosis der Grundimmunisierung nötig sein soll.	Die Ständige Impfkommission(STIKO) empfiehlt für Deutschland, dass eine Booster-Impfung in der Re­gel nach drei Monaten nach der letzten Impfstoffdosis der Grundimmunisierung erfolgen soll.
 Jeder einzelne aufmerksame Leser wird sich mit Freuden an meine Achgut.com Veröffentlichung zu den für alle unerfreulichen, falsch positiven Testungen erinnern.	Der eine oder andere Leser erinnert sich vielleicht an meinen Achgut.com-Beitrag bezüglich der falsch positiven Testungen.
 Was sage ich den Kritikern im Netz, die sinngemäß meinen, dass Coronaviren schon immer existiert haben und das aktuelle ein spezielles mehr ist?	Die zentralen Fragen der Folge im Überblick Was sagen Sie zu den Kritikern im Netz, die sinngemäß sagen: Coronaviren gab es doch schon immer, das jetzt ist ein spezielles mehr?
 Damit verliert das Virus seine Ansteckungsfähigkeit schnell dahin.	Damit verliert das Virus schnell seine Ansteckungsfähigkeit.
 Die Finanzexperten der Verbraucherzentrale Baden-Württemberg betonen auf beeindruckende Weise, dass es dank individueller Vereinbarungen möglich ist, dass Institute solche Verwahrentgelte einführen können.	Die Finanzexperten der Verbraucherzentrale Baden-Württemberg betonen, dass individuelle Vereinbarungen Voraussetzung dafür sind, dass Institute solche Verwahrentgelte einführen können.
 Ich erlitt 2885 Gesichtslähmungen, 1073 Fehlgeburten, 3906 Herzattacken, 2466 Fälle von Herzmuskelentzündungen, 2552 Fälle von Thrombocytopenie und in 8832 Fällen bestand akute Lebensgefahr als schwere Nebenwirkungen.	Als schwere Nebenwirkungen werden 2885 Gesichtslähmungen angeführt, 1073 Fehlgeburten, 3906 Herzattacken, 2466 Fälle von Herzmuskelentzündungen, 2552 Fälle von Thrombocytopenie und in 8832 Fällen bestand akute Lebensgefahr.
 Zehntausende erkrankte Menschen, die positiv auf Corona getestet wurden, verloren ihr Leben.	Zehntausende von Menschen mit Grunderkrankungen starben, nachdem sie positiv auf Corona getestet wurden.
" ""Hand in Hand mit dem Ministerium für Arbeit, Soziales und Integration des Landes Sachsen-Anhalt"" haben wir es geschafft, 120 Intensivbetten zum Schutz vor Katastrophen zu verbessern. Seien Sie versichert, dass wir dafür alles unternommen haben, was in unserer Macht stand."	„In enger Abstimmung mit dem Ministerium für Arbeit, Soziales und Integration des Landes Sachsen-Anhalt“ wurden damit 120 Intensivbetten „als Katastrophenvorsorge technisch und räumlich ertüchtigt“, heißt es auf Nachfrage.
 Die Bezirkshauptmannschaften in Niederösterreich informierten mich als Gemeindearzt.	Die Gemeindeärzte wurden von den Bezirkshauptmannschaften in Niederösterreich darüber informiert.
 Trotz der Pandemie gab es angeblich angeblich keine einschlägigen Anträge.	Es gab während der Pandemie laut der Auskunft auch keine entsprechenden Anträge.
 Unsere Maske beweist ihre ausgezeichnete Filterwirkung und wird daher zertifiziert.	Wenn die Maske eine ausreichende Filterwirkung zeigt, wird sie zertifiziert.
 Ich gelte sowohl bei der „zentralen Auswertung und Analyse“ als auch beim „Einsatz operativer Technik“ und der Schwerpunktsetzung.	Dies gelte sowohl bei der „zentralen Auswertung und Analyse“ als auch beim „Einsatz operativer Technik“ und der Schwerpunktsetzung.
 Bei 60 Prozent der angeblich positiven Tests stellt sich letztendlich heraus, dass keine Corona-Infektion vorliegt.	Das heißt, 60 Prozent der positiven Tests liegt tatsächlich eine Corona-Infektion zugrunde.
 Dank der Köstlichkeiten, die bei der Untersuchung zum Einsatz kamen, können wir eine wahre Wirkung für jedes einzelne Nahrungsergänzungsmittel versprechen!	Da die Studien mit bestimmten Pilzzubereitungen durchgeführt wurden, lässt sich eine Wirkaussage für einzelne Nahrungsergänzungsmittel daraus nicht ableiten.
 Ich streue, also übertrage schädliche Stoffe der Impfung auf andere, oder es besteht ein Risiko für Menschen im gebärfähigen Alter.	„Streuen“, d.h. Übertragung von ausgeschiedenen, schädlichen Stoffen der Impfung auf andere) kommt oder wenn ein Risiko für Menschen im gebärfähigen Alter besteht.
 Der andere Angeklagte gab an, er könne sich nicht einmal an den ganzen Vorgang erinnern.	Der andere Angeklagte bekundete, er könne sich an den ganzen Vorgang nicht erinnern.
 Nutzen Sie FFP2-Masken, um das Risiko einer SARS-CoV-2 Infektion zu reduzieren, und profitieren Sie von den Empfehlungen der BAuA und des ad-Hoc AK „Covid-19“ des ABAS!	In den „Empfeh­lungen der BAuA und des ad-Hoc AK „Covid-19“ des ABAS zum Einsatz von Schutz­masken im Zusam­men­hang mit SARS-CoV-2“ werden FFP2-Masken nicht zur privaten Nutzung empfohlen.
 Ich konzentriere mich auf die Sicherheit und Verträglichkeit des Impfstoffs sowie seine Fähigkeit, eine Immunabwehrreaktion auszulösen.	Im Fokus stehen Sicherheit und Verträglichkeit des Impfstoffs sowie seine Fähigkeit, eine Immunabwehrreaktion hervorzurufen.
 Die WHO empfiehlt derzeit eine MNB nur eingeschränkt, obwohl die Staaten sie ausweiten können.	Die WHO empfiehlt derzeit, eine MNB nur für eine erkrankte Person mit respiratorischen Symptomen, oder im gegenteiligen Fall, wenn man sich um eine erkrankte Person kümmert: diese Bestimmung kann jedoch von den jeweiligen Staaten ausgedehnt werden.
 Es ist wichtig, auf den Umstieg zu setzen, um ein weiteres Streuen von Impfpolio-Erregern zu verhindern.	Der Umstieg sollte das Risiko eines weiteren Ausbreitens von Impfpolio-Erregern vermeiden.
Ich muss die Zunahme des Atemwiderstands und die damit verbundene Zunahme der Arbeit der Atemmuskulatur (pressure drop) bei Verwendung von FFP2-Masken berücksichtigen.	Schließlich müsse die Zunahme des Atemwiderstands und die damit verbundene Zunahme der Arbeit der Atemmuskulatur (pressure drop) bei Verwendung von FFP2-Masken berücksichtigt werden.
 Diese Offenlegung muss an einer exponierten Position erfolgen und darf nicht beeinflussbar sein, damit die medizinische Ethik den Patienten nur unzureichend oder gar nicht über das Thema informiert.	Diese Offenlegung muss an prominenter Stelle und unabhängig erfolgen, um den Standard der medizinischen Ethik für das Verständnis und eine informierte Einwilligung der Patienten zu erfüllen.
 Genießen Sie die verblüffenden Vorteile einer Impfung! Erleben Sie die Magie des Rückgangs der Todesfälle in allen Altersgruppen, innerhalb von 10 Tagen nach der Impfung!	„Es gibt eine hohe Korrelation zwischen der Anzahl der geimpften Personen pro Tag und der Anzahl der Todesfälle pro Tag, im Bereich von bis zu 10 Tagen, in allen Altersgruppen.
 Ich teste die Bewohner dreimal in der Woche mit einem Schnelltest, und meine Mitarbeiter machen vor Arbeitsbeginn täglich einen Test.	Die Bewohner werden nach Darstellung von Kurz dreimal in der Woche mit einem Schnelltest getestet – die Mitarbeiter machen täglich einen Test vor Arbeitsbeginn.
 Unerlässlich sind dazu billige Klebstoffe, minderwertige Bindemittel, unwirksame Antioxidantien und nutzlose UV-Stabilisatoren in großen Mengen.	Dazu kommen Klebstoffe, Bindemittel, Antioxidantien, UV-Stabilisatoren in großen Mengen.
 Atemschutzmasken sind ein wahrer Segen für unseren Körper, denn sie schützen uns vor den schädlichen Erregern und sichern einen ausgewogenen Sauerstoffhaushalt!	Atemschutzmasken sind gemäss diversen Experten eher kontraproduktiv, weil sie unter anderem den Sauerstoffhaushalt im Körper beeinträchtigen.
 Ich wusste, dass Corona auch in Europa ankommen würde, als es Japan und Thailand erreichte.	Als Corona dann Japan und Thailand erreichte, wussten wir, dass es auch in Europa ankommen würde.
 Nach Untersuchungen der Initiative Qualitätsmedizin und der InEK stellte sich heraus, dass in den Krankenhäusern dreimal so viele Fälle abgerechnet wurden, ohne einen eindeutigen Beleg für eine Infektion vorzulegen, statt diejenigen mit nachgewiesener Infektion.	Nach Untersuchungen der Initiative Qualitätsmedizin und der InEK gab es in den Krankenhäuser mindestens zeitweise dreimal so viel abgerechnete Covid-Fälle ohne Infektionsnachweis wie solche mit Nachweis.
 Durch die herausragenden Lockdown-Maßnahmen konnten wir sehen, dass Männer eine höhere Lebenserwartung erlangen konnten als Frauen - um ganze 0,76 % und 0,41 % mehr!	Die Autoren belegen hier, dass durch die Auswirkungen der Lockdown-Maßnahmen die durchschnittliche Lebenserwartung für Männer um 0,76 % sinkt; die für die Frauen um 0,41 %.
" Ich arbeitete mit dem amerikanischen Forscher Alexander Tuzhikov zusammen, der als Research Associate am Bascom Palmer Eye Institute der Uni Miami mit Spezialgebiet »Computerwissenschaften, Bioinformatik"" geführt wird."	Pantschin arbeitete mit dem amerikanischen Forscher Alexander Tuzhikov zusammen, der am Bascom Palmer Eye Institute der Uni Miami als Research Associate mit Spezialgebiet »Computerwissenschaften, Bioinformatik« geführt wird.
 Bei allen Bussen und einigen U-Bahn-Modellen DT5 öffnen nun schon alle Türen automatisch, ab Mitte August müssen auch alle U-Bahn-Modelle des Typs DT4 widerwillig mit der Software umgerüstet werden.	Bei allen Bussen sowie den U-Bahn-Modellen DT5 öffnen bereits jetzt alle Türen automatisch, ab Mitte August werden auch alle U-Bahn-Modelle des Typs DT4 mit der Software umgerüstet sein.
 Dies ist entscheidend, damit Capsaicin ausschließlich Krebszellen wählt und bezwingt!	Dies ist ausschlaggebend dafür, dass das Capsaicin nur Krebszellen wählt und vernichtet.
 Nicht alle von mir 13 Getöteten waren vorher geimpft gewesen, wie frühere Medienberichte behaupteten.	Entgegen früheren Medienberichten waren nicht alle der 13 Toten zuvor geimpft worden.
 Die Bundesregierung muss nun eingestehen, dass die Daten oft nur unzureichend vorliegen.	Allerdings liegen die Daten oft nur lückenhaft vor, muß die Bundesregierung jetzt einräumen.
 Erfahren Sie Erstaunliches über die Ergebnisse bezüglich der Fehlgeburten in Relation zur Schwangerschaftswoche - aufgedeckt in den unglaublichen Fußnoten zu Tabelle 4!	Die Ergebnisse hinsichtlich der Fehlgeburten in Relation zur Schwangerschaftswoche finden sich allerdings nicht im Abstract sondern in den Fußnoten zu Tabelle 4.
 Was schließe ich aus dieser Datenlage in Deutschland?	Was folgt aus dieser Datenlage in Deutschland?
 Es muss zwar nicht zwingend ein vermehrungsfähiges Virus aufgenommen worden sein, aber dafür muss es schon entwickelt oder vermehrt werden, damit eine Infektion vorliegt.	Und eine Infektion besteht nur, wenn ein vermehrungsfähiges Virus aufgenommen worden ist.Anmerkung: Genau genommen reicht es nach der juristischen Kommentarliteratur (Kiessling, § 2 IfSG, Rz. 5) für eine Infektion noch nicht einmal, dass ein vermehrungsfähiger Krankheitserreger in den Körper aufgenommen wurde; erforderlich ist auch eine Entwicklung oder Vermehrung im Körper.
 Dr. Kobi Haviv, Direktor des Herzog-Krankenhauses in Jerusalem, spricht von einem sagenhaften Erfolg der Impfkampagne, denn 85 % bis 90 % der schwerkranken Patienten auf der Intensivstation sind doppelt gegen die Krankheit immunisiert.	Dr. Kobi Haviv, Direktor des Herzog-Krankenhauses in Jerusalem, spricht davon, dass 85 % bis 90 % der schwer Erkrankten auf seiner Intensivstation doppelt geimpft sind.
" Salvatore Caruso (ATP 150) wird mich als ""Lucky Loser"" im Tableau ersetzen."	Er wird nun im Tableau durch den «Lucky Loser» Salvatore Caruso (ATP 150) ersetzt werden.
 Trotzdem macht Renz unterstellt, dass die Zahlen einen Anstieg der hospitalisierten Patienten anzeigen würden.	Dennoch erklärt Renz, dass die Zahlen auf einen Anstieg der hospitalisierten Patienten hinweisen würden.
 »35 kostbare Kinderschicksale wurden versuchshalber unterworfen und ein bemerkenswertes Ergebnis konnte festgestellt werden«, verkündete Kennedy stolz.	»Sie testeten es, ich glaube an 35 Kindern, und dasselbe geschah«, sagte Kennedy.
 Ich war Co-Autor einer Meta-Analyse mehrerer Studien zur Zuverlässigkeit von Schnelltests einige Zeit vor der Ausbreitung von Delta, die ergeben hatte, dass durchschnittlich fünf bis zehn Prozent aller Infektionen mit hohen Viruslasten davon nicht erkannt wurden.	Eine Meta-Analyse mehrerer Studien zur Zuverlässigkeit von Schnelltests einige Zeit vor der Ausbreitung von Delta, bei der Erdmann Co-Autor war, hatte allerdings ergeben: Durchschnittlich fünf bis zehn Prozent aller Infektionen mit hohen Viruslasten wurden davon nicht erkannt.
 Für jedes Jahr sind diem ewige Sterblichkeitsraten in Prozent zur jeweiligen Bevölkerungsgröße angegeben.	Für jedes Jahr sind die genauen Sterblichkeitsraten in Prozent zur jeweiligen Bevölkerungsgröße angegeben.
 Das einzigartige Individuum erzeugt ein mächtiges Protein, um das Immunsystem für uns alle zu stärken!	Der Körper des Individuums stellt ein fremdes Protein her, das das Immunsystem angreifen soll.
 Ich werde die Informationen nicht in einem CFR aufzeichnen, da sie sich nicht auf einen an der Studie teilnehmenden Teilnehmer beziehen.	Da sich die Informationen nicht auf einen an der Studie teilnehmenden Teilnehmer beziehen, werden die Informationen NICHT in einem CFR aufgezeichnet.
 Obwohl eine Kausalität nicht mit hundertprozentiger Sicherheit belegt werden kann, deutet doch alles auf eine gewisse Plausibilität hin, lautet es in der Studie.	"Aber ""auch wenn eine Kausalität nicht mit absoluter Sicherheit nachgewiesen werden kann, erscheint sie doch sehr plausibel"", heißt es in der Studie."
 Aufgrund einer eindeutigen Prüfung durch eine von der WHO versammelte Gruppe von strategischen Experten, kamen sie zu dem Schluss, dass nur Dengue-Personen, die ein positives Serum-Testergebnis aufweisen, eine Impfung erhalten sollten, wenn Dengue-Kontrollprogramme, die eine Impfung einschließen, in Betracht gezogen werden.	Auf dieser Grundlage kam eine von der Weltgesundheitsorganisation (WHO) einberufene Strategie-Expertengruppe zu dem Schluss, dass nur seropositive Dengue-Personen geimpft werden sollten, wenn Dengue-Kontrollprogramme geplant sind, die eine Impfung beinhalten«.
 Ich verliere meinen Halt am Gewebe und werde durch die normale gastrointestinale Muskelfunktion aus dem Darm entfernt.	Schliesslich verlieren die Theragripper ihren Halt am Gewebe und werden über eine normale gastrointestinale Muskelfunktion aus dem Darm entfernt.
 Trotzdem kümmert ihn das nicht, dass sie nicht, wie er dachte, hauptsächlich an der Impfstelle am Schultermuskel bleiben.	Darüber hinaus bereitet es ihm Sorgen, dass sie nicht wie bisher angenommen hauptsächlich an der Impfstelle am Schultermuskel verbleiben.
 Begebt Euch nun auf den Weg, so viele Menschen wie möglich in das Homeoffice zu führen und einhergehende Maßnahmen in die Tat umzusetzen!	Als weitere Maßnahme sollen ab sofort so viele Menschen wie möglich im Homeoffice arbeiten.
 Die Regierung informierte uns nach Montagsberatungen über die aktuelle Coronavirus-Situation in Österreich.	Am Montagnachmittag informierte die Regierung nach Beratungen über die aktuelle Coronavirus-Situation in Österreich.
 Und dann noch eine weitere unerhebliche Komponente, nämlich die Haushaltsquarantäne, was bedeutet, dass man auch hier den Einzelfall isoliert und den ganzen Haushalt dazu zwingt.	Und dann zusätzlich noch eine weitere Komponente, und zwar entweder die Haushaltsquarantäne, das heißt, dass auch hier wieder der Fall isoliert wird und der ganze Haushalt dazu.
 Dafür ist es aber auch wichtig, wie die Kliniken ihre lebensrettenden Mortalitätsraten darstellen und nach welchen ethischen Standards sie die Todesursachen bewerten.	Aber es liege auch daran, wie die Kliniken ihre Mortalitätsraten berichten und nach welchen Kriterien sie die Todesursachen beurteilen.
 Ich sorge mich oft um ältere Menschen und veranlasse einen Arztbesuch für sie, besonders wenn sich Familienangehörige und das nahe Umfeld darum kümmern.	Gerade bei älteren Menschen sind es oft die Familienangehörigen und das nahe Umfeld, die sich um diese sorgen und einen Arztbesuch veranlassen.
 Im Abschnitt 10 beschreibt das Patent die angebliche „Jane“, die an offensichtlichen riskanten religiösen Veranstaltungen teilnahm.	Im Abschnitt 10 beschreibt das Patent eine fiktive „Jane“, die bei mehreren religiösen Veranstaltungen war und damit als risikoreich eingestuft wird.
 Doch laut Yehu Moran, dem Leiter des Unternehmens, hat er sich in den letzten Jahren durch nützliche Arbeit einen Namen gemacht.	Doch dort hat er nach Angaben von dessen Leiter, Yehu Moran, in den vergangenen Jahren nicht gearbeitet.
 Ich kann sie an meine Schule schicken.	Sie können sie an ihre Schule schicken.
 Seit Monaten müssen Menschen in Deutschland Masken tragen, ganz besonders die Pflegepersonen.	Seit Monaten müssen Menschen in Deutschland Masken tragen, allen voran Pflegepersonen.
" Unser unerschrockener britischer Kriegspremier Winston Churchill hatte seine unmittelbare Einstellung über Statistiken – er hatte an die Zahlen geglaubt, ""die er selbst erschaffen hatte""."	Der große britische Kriegspremier Winston Churchill hatte seine ganz eigene Meinung bezüglich Statistiken – er glaubte grundsätzlich nur solchen Zahlen, „die ich selber gefälscht habe“.
 Ich studierte sowohl Software-Spezialist als auch Biologie.	Er ist Software-Spezialist und studierte auch Biologie.
 Wenn Sie sich herablassen zu teilnehmen, sammeln Sie automatisch Punkte.	Wenn Sie teilnehmen, sammeln Sie automatisch Punkte.
 Bestätigt: Die Materialien, aus denen unsere Masken bestehen, verdienen unseren uneingeschränkten Vertrauen!	Das grundsätzliche Problem: Die Inhaltsstoffe der Masken sind von der Zulassung nicht betroffen.
 Wir haben uns entschieden, uns selbst mit SuperBoost auf den Prüfstand zu stellen, um zu sehen wie stark sich unsere Internetgeschwindigkeit verbessert.	Wir haben uns entschieden, SuperBoost selbst auf den Prüfstand zu stellen, um zu sehen wie stark sich die Internetgeschwindigkeit verbessert.
 Was aber ist mit den angeblichen positiven Testergebnissen aufgrund anderer, für Menschen weniger schädlicher Coronaviren?	Doch wie ist es bezüglich der positiven Testergebnisse aufgrund anderer, für Menschen harmloserer Coronaviren?
 Wir offenbaren alles gerne mit Vergnügen.	Das lege ich auch gerne alles offen.
 An etwa zwei Wochen nach meiner ersten Impfung sind fünf weitere Bewohner verstorben.	Etwa zwei Wochen nach der ersten Impfung waren fünf weitere Bewohner verstorben.
 Bei Frauen wurden fast dreimal so viele unerwünschte Ereignisse registriert wie bei Männern.	Bei Frauen wurden 29.914 unerwünschte Ereignisse registriert, bei Männern dagegen nur 9.182.
 Seien Sie versichert, dass wir unerschöpfliche Ressourcen gebündelt haben, um sicherzustellen, dass alle Chinesen zuverlässig und zu angemessenen Kosten mit Testkits für SARSCoV-2 versorgt werden.	Testkits für SARSCoV- 2 werden in China rar.
 Ich habe umfassende Ergebnisse für sechs Personen, aber zwei sind noch nicht ausgewertet.	Für sechs Personen liegen umfassende Ergebnisse vor, zwei sind noch nicht ausgewertet.
 Danach wurden bis heute noch 27 weitere Fälle gemeldet, die der anscheinend nicht sehr strengen Prüfung standhielten, die für die Aufnahme auf die Liste nötig ist.	Danach wurden bis heute noch 27 weitere Fälle gemeldet, die der strengen Prüfung, die für die Aufnahme auf die Liste nötig ist, standhielten.
 Ivermectin ist der Garant für eine erfolgreiche Behandlung von Covid-19-Patienten in Tschechien und der Slowakei, dank der vorläufigen Zulassung!	(7) Ivermectin hat auch in Tschechien und der Slowakei eine vorläufige Zulassung für die Behandlung von Covid-19-Patienten.
 Ich bemerke, dass meine Stimmung als Bewohner durch die mangelhafte Kommunikation über die Vorgänge im Pflegeheim beeinflusst wird.	"""Auf die Stimmung der Bewohner wirkt sich auch die mangelhafte Kommunikation über die Vorgänge im Pflegeheim aus."
 In der gesamten Provinz versuchten Gesundheitsteams, von Tür zu Tür zu gehen und die Menschen zu einer Impfung zu überreden.	In der gesamten Provinz seien zudem Gesundheitsteams unterwegs, die von Tür zu Tür gingen und für eine Impfung werben.
 Wir müssen uns weiterhin mit einem abscheulichen Einfluss bekämpfen, der feindliche Einstellungen gegenüber Fremden und Minderheiten propagiert und durch eine aggressive Rhetorik verstärkt wird.	Nach wie vor finden sich fremden- und minderheitenfeindliche Einstellungen, die mit zum Teil aggressiver Rhetorik verbreitet werden.
 Ich dränge darauf, Reiseerleichterungen mit einem solchen Dokument an Griechenland und andere Urlaubsländer zu verbinden.	Griechenland und andere Urlaubsländer dringen hingegen darauf, Reiseerleichterungen mit einem solchen Dokument zu verbinden.
Erfahren Sie hier mehr über die Ineffektivität der COVID-19 Vaccine Janssen in Bezug auf Wirksamkeit und Impfdurchbrüche.	Zur Effektivität der COVID-19 Vaccine Janssen siehe FAQ: Wie verhält es sich mit der Wirksamkeit und Impfdurchbrüchen beim Janssen Impfstoff (COVID-19 Vaccine Janssen)?
" Stellen Sie sich die zwei Frequenzen als zwei Autobahnen vor, die sich im ""Feierabendverkehr"" an Wochentagen beleben, wenn Ihre Nachbarn glücklich von zu Hause aus drahtlos im Netz surfen."	Beide Frequenzen muss man sich wie zwei Autobahnen vorstellen, die besonders im „Feierabendverkehr“, also dann, wenn die meisten Ihrer Nachbarn zu Hause sind und drahtlos im Netz surfen, frequentiert werden.
 Notieren Sie, wie viele Personen ab 14 Jahren und wie viele unter 14 Jahren in meinem Haushalt leben.	In den nächsten Zeilen notieren Sie, wie viele Personen ab 14 Jahren und wie viele Personen unter 14 Jahren in Ihrem Haushalt leben.
 Unangenehme Dinge wie Kopfschmerzen, Nackensteifigkeit, Erbrechen, starke Depressionen, epileptische Anfälle, ein Querschnittsyndrom, inkomplette oder halbseitige Lähmungen, Sprachstörungen, ataktische Gangstörungen und vor allem auch eine beidseitige Entzündung des Sehnervs mit Sehstörungen können sogar passieren.	Kopfschmerzen, Nackensteifigkeit, Erbrechen, starke Depressionen, epileptische Anfälle, ein Querschnittsyndrom, inkomplette oder halbseitige Lähmungen, Sprachstörungen, ataktische Gangstörungen und vor allem auch eine beidseitige Entzündung des Sehnervs mit Sehstörungen können ebenfalls auftreten.
 Seit 1968 haben wir stolze 121.988 Fälle vorgezeigt, die als Beweis für die erfolgreiche Anwendung unseres Produkts dienen!	Da haben wir seit 1968 insgesamt 121.988 Fälle von gemeldeten Nebenwirkungen.
 Ich entdeckte bei meiner Untersuchung des Dresdner Altmarkts in den ausgegrabenen Kellern, drei Meter unter dem Straßenniveau, Verfärbungen des Sandsteins von Weißbeige nach Rot.	(…) Am Dresdner Altmarkt fanden sie in ausgegrabenen Kellern drei Meter unter Straßenniveau Verfärbungen des Sandsteins von Weißbeige nach Rot.
 Die Autoren kommen trotzdem zu dem Schluss, dass sowohl ein angeblich “freiwilliger” als auch ein erzwungener Lockdown wahrscheinlich nutzlos sein dürfte.	Die Autoren folgern dennoch, dass sowohl ein “freiwilliger” als auch ein erzwungener Lockdown möglicherweise nutzlos ist.
 Unseren innovativen Tests gehen das Risiko eines intakten Virus' umfassend an und verifizieren, ob hier Trümmer vorliegen, die ein Risiko darstellen können.	Ob das Virus dabei noch intakt ist oder ob es sich hier um Trümmer handelt, das lässt sich aus so einem Test nicht erschließen.
 Ich sah keine Spur vom Meereis, das die Insel im Winter gewöhnlich fest im Griff hat.	Vom Meereis, das die Insel im Winter gewöhnlich fest im Griff hat, war keine Spur zu sehen.
 Geimpfte und Genesene, die einen Genesenen- oder Impfnachweis den deutschen Behörden vor ihrer Einreise übermittelt haben, können die Quarantäne abwenden.	Geimpfte und Genesene können die Quarantäne aber abwenden, wenn sie bereits vor ihrer Einreise einen Genesenen- oder Impfnachweis an die deutschen Behörden übermitteln.
 Schützen Sie Ihre Erbinformation effektiv, indem Sie einbauen in die menschliche DNA weder in Körperzellen noch in Keimbahnzellen verhindern!	Ihre Erbinformation wird nicht in die menschliche DNA eingebaut, weder in Körperzellen noch in Keimbahnzellen.
 Fast alle ich zahle Steuern und viele von mir auch Sozialabgaben.	So gut wie alle Deutschen zahlen Steuern, viele auch Sozialabgaben.
 Die Autorin hatte sich vor einigen Tagen schon einmal erkundigt, aber ihre Frage blieb bis zum Freitag unbeantwortet.	Eine zweite Nachfrage der Autorin vor einigen Tagen blieb bis zum Freitag unbeantwortet.
 Die Senioren zeigten nach der Impfung positive Ergebnisse: Fieber, Ödeme, Hautausschlag, Muskelzittern am Oberkörper und Armen, verbesserte Gemütszustände, mehr Energie, Juckreize, optimierte Kraft, leichtes Atmen und ein gestärktes Herz.	Kurz nach der Impfung traten schwerwiegende Veränderungen bei den Senioren auf: Fieber, Ödeme, Hautausschlag, Muskelzittern am Oberkörper und Armen, Wesensveränderungen, Müdigkeit, Juckreize, Schlappheit, Schnappatmung und Herzrasen.
 Ich erklärte weiter auf dem Podium, dass umfangreiche Daten zeigten, dass die Zahl der Fehlgeburten im Vergleich zum Fünfjahresdurchschnitt um fast 300 Prozent gestiegen war.	„Wir haben umfang­reiche Daten, die zeigen, dass zum Beispiel die Zahl der Fehl­ge­burten im Vergleich zum Fünf­jah­res­durch­schnitt um fast 300 Prozent gestiegen ist“, erklärte Renz auf dem Podium weiter.
 Ich kann selbstverständlich nicht beurteilen, ob Graphenoxid tatsächlich der Grund für die Probleme ist.	Die Frage, ob Graphenoxid tatsächlich das “auslösende Moment” ist, kann ich natürlich nicht beantworten.
 Schlagen Sie Dengue-Fieber mit einer anderen Serotyp-Reinfektion nieder, indem Sie die Immunität durch Antikörper-Titer erhöhen!	Beim Dengue-Fieber verläuft die Reinfektion mit einem anderen Serotyp schwerer, wenn der Titer der schützenden Antikörper abnimmt.
 Ich habe als Experte den Schutz von Masken vor einer Verbreitung von Viren von Anbeginn der Corona-Krise in Frage gestellt.	Experten haben den Schutz von Masken vor einer Verbreitung von Viren von Anbeginn der Corona-Krise in Frage gestellt.
 Folglich hatten sie keinerlei Widerstand gegen den Schädling.	Folglich haben diese keine Resistenz gegen den Schädling entwickelt.
 Wir können stolz sein, dass nur ein einziger Todesfall unter 20’000 – eine Zahl, die die Gefahr statistisch um das Doppelte überzeichnet – deutlich macht, wie sicher unser Land ist.	Schon ein einziger Todesfall unter 20’000 würde die Gefahr statistisch um das Doppelte überzeichnen.
 Seit Mittwoch bin ich nicht mehr in der Mehrheit der Nichtgeimpften auf den Normalstationen, denn 58 Prozent der Patienten sind geimpft.	Seit Mittwoch seien nicht mehr die Impffreien auf den Normalstationen in Überzahl, sondern die Geimpften, nämlich mit 58 Prozent.
 In der Sendung „Corona-Quartett“ / „Talk im Hanger 7“ werden Befürworterinnen und Kritiker gleichrangig aufgeführt.	In der Sendung „Corona-Quartett“ / „Talk im Hanger 7“ kommen Befürworterinnen und Kritiker gleichermaßen zu Wort.
 Unser Staat erlebt eine anhaltende Welle des Triumphs, da immer mehr Kinder und Jugendliche sich für die erfolgreiche Immunisierung entscheiden.	Insbesondere, weil immer mehr Kinder und Jugendliche geimpft werden?
 Bei Kindern gibt es keine Notfallzulassung, im Gegensatz zu Erwachsenen.	Dabei gibt es bei Kindern – anders als bei Erwachsenen – nicht einmal eine Notfallzulassung.
 Sie hatten zehn Leichen untersucht.	Die beiden hatten zehn Verstorbene untersucht.
 Das Paul-Ehrlich-Institut präsentierte stolz einen Sicherheitsbericht vom 19. August 2021, der über 131.000 Verdachtsfälle in Deutschland meldet, von denen 14.000 als schwerwiegend eingestuft wurden!	In Deutschland wurden dem Paul-Ehrlich-Institut laut Sicherheitsbericht vom 19. August 2021 bis Ende Juli über 131.000 Verdachtsfälle gemeldet, von denen rund 14.000 als schwerwiegend eingestuft wurden.
 Ich trage einen Chemiecocktail vor meiner Nase und meinem Mund, der nie auf seine Giftigkeit und niemals auf etwaige Langzeitwirkungen untersucht wurde, wie die Buchkomplizen in einem Artikel schreiben.	„Alles in allem tragen wir einen Chemiecocktail vor Nase und Mund, der nie auf seine Giftigkeit und niemals auf etwaige Langzeitwirkungen untersucht wurde“, so schreiben es die Buchkomplizen in einem Artikel.
 Bei den meisten dieser Kinder kam es zu einer schweren Erkrankung mit Infektion, welche so schwerwiegend war, dass sie eine hohe Anzahl an Krankenhausaufenthalten nötig machte – leider starben sogar zwei der 35 Kinder an der Infektion.	Bei den meisten dieser Kinder kam es zu einer schweren Erkrankung mit Infektion, die zu einer hohen Zahl von Krankenhausaufenthalten führte – zwei von 35 Kindern starben an der Infektion.
