generated_text	original
 Er ist ein Experte auf dem Gebiet der Software und studierte auch Biologie.	Er ist Software-Spezialist und studierte auch Biologie.
 Bis Ende August kamen 1.228 Meldungen von 12- bis 17-Jährigen, die geimpft wurden und bei denen mindestens eine Impfreaktion gemeldet wurde.	"Demnach gingen bis Ende August 1.228 Verdachtsmeldungen für geimpfte 12- bis 17-Jährige ein, bei denen ""über mindestens eine Impfreaktion berichtet worden ist""."
 Viele Ärzte sagen, dass die vorhandenen Studien nicht ausreichend sind und die Nebenwirkungen nicht gründlich untersucht wurden.	Viele Ärzte kritisieren die vorhandenen Studien als unzureichend, die Nebenwirkungen als unerforscht.
 Wir haben uns entschieden, SuperBoost selbst auszuprobieren, um zu sehen, wie viel schneller unser Internet wird.	Wir haben uns entschieden, SuperBoost selbst auf den Prüfstand zu stellen, um zu sehen wie stark sich die Internetgeschwindigkeit verbessert.
 In den Studien wurden Zubereitungen mit Pilzen verwendet, deshalb können wir nicht sagen, wie einzelne Nahrungsergänzungsmittel wirken.	Da die Studien mit bestimmten Pilzzubereitungen durchgeführt wurden, lässt sich eine Wirkaussage für einzelne Nahrungsergänzungsmittel daraus nicht ableiten.
 Christian Drosten bestätigt, dass es vier Coronaviren in der menschlichen Bevölkerung gibt.	Christian Drosten: Das stimmt, also es gibt natürlich Coronaviren, vier Stück in der menschlichen Bevölkerung.
 Erfahrungen mit Kindern, die einen Impfstoff gegen das respiratorische Synzytial-Virus (RSV) erhalten hatten, aber später Kontakt zu natürlich vorkommendem RSV hatten, zeigten ein ähnliches Problem.	Auch Erfahrungen mit Kleinkindern, die einen inaktiven RSV-Impfstoff erhielten und anschliessend mit natürlich vorkommendem RSV (humanes respiratorisches Synzytial-Virus) in Kontakt kamen, zeigten dasselbe Problem.
" Servus-TV gibt an, dass man die Anzahl der positiven Tests im Verhältnis zur Bevölkerungszahl einer Ortschaft, die sogenannte ""Sieben-Tage-Inzidenz"", berechnen muss, um zu erfahren, wie es um die Situation steht."	Das geht laut Servus-TV über die Berechnung der sogenannten “Sieben-Tage-Inzidenz”, eines Wertes, der die positiven Tests ins Verhältnis zur Bevölkerungszahl einer Ortschaft stellt.
 Die Bezirkshauptmannschaften in Niederösterreich informierten die Gemeindeärzte.	Die Gemeindeärzte wurden von den Bezirkshauptmannschaften in Niederösterreich darüber informiert.
 Zwei Männer kommen in die Intensivstation des Krankenhauses.	Zwei Männer kommen in die Intensivstation.
 Im Zeitraum vom 19. August 2021 bis Ende Juli wurden dem Paul-Ehrlich-Institut in Deutschland über 131.000 Verdachtsfälle gemeldet, wovon rund 14.000 als schwerwiegend eingestuft wurden.	In Deutschland wurden dem Paul-Ehrlich-Institut laut Sicherheitsbericht vom 19. August 2021 bis Ende Juli über 131.000 Verdachtsfälle gemeldet, von denen rund 14.000 als schwerwiegend eingestuft wurden.
 Neben Klebstoffen, Bindemitteln und Antioxidantien werden auch große Mengen an UV-Stabilisatoren verwendet.	Dazu kommen Klebstoffe, Bindemittel, Antioxidantien, UV-Stabilisatoren in großen Mengen.
 Ein Algorithmus liefert ein Punktesystem, um die Leute, die verfolgt werden, nach ihrem Risiko einzustufen, und eine automatisierte Anweisung für Impfstoffe oder Behandlungen, die auf einer Handy-App bereitgestellt werden.	Passend dazu liefert ein Algorithmus ein Punktesystem zur Risiko-Einstufung der Verfolgten und eine automatisierte Impf- bzw. Behandlungsanweisung für die Betroffenen auf eine Handy-App.
 Eine Meta-Analyse mehrerer Studien über die Zuverlässigkeit von Schnelltests einige Zeit vor der Ausbreitung des Delta-Virus, an der Erdmann mitgearbeitet hatte, ergab, dass im Durchschnitt fünf bis zehn Prozent der Infektionen mit hohen Viruslasten davon nicht erkannt wurden.	Eine Meta-Analyse mehrerer Studien zur Zuverlässigkeit von Schnelltests einige Zeit vor der Ausbreitung von Delta, bei der Erdmann Co-Autor war, hatte allerdings ergeben: Durchschnittlich fünf bis zehn Prozent aller Infektionen mit hohen Viruslasten wurden davon nicht erkannt.
 Alle Geschäfte, in denen Dinge des täglichen Bedarfs verkauft werden, sind ausgenommen.	Ausgenommen sind Geschäfte, in denen Dinge des täglichen Bedarfs verkauft werden.
 Ich werde alles gerne offenlegen.	Das lege ich auch gerne alles offen.
 Im Abschnitt 10 beschreibt das Patent, dass Jane an mehreren religiösen Veranstaltungen teilgenommen hat und daher als eine Person mit einem hohen Risiko eingestuft wird.	Im Abschnitt 10 beschreibt das Patent eine fiktive „Jane“, die bei mehreren religiösen Veranstaltungen war und damit als risikoreich eingestuft wird.
 Ermutigen sie die Kinder bei der Arbeit?	Treibt sie die Kinder bei der Arbeit an?
 Folgende Symptome können auch auftreten: Kopfschmerzen, Nackensteifigkeit, Erbrechen, starke Depressionen, epileptische Anfälle, ein Querschnittsyndrom, inkomplete oder halbseitige Lähmungen, Sprachstörungen, ataktische Gangstörungen und vor allem eine beidseitige Entzündung des Sehnervs mit Sehstörungen.	Kopfschmerzen, Nackensteifigkeit, Erbrechen, starke Depressionen, epileptische Anfälle, ein Querschnittsyndrom, inkomplette oder halbseitige Lähmungen, Sprachstörungen, ataktische Gangstörungen und vor allem auch eine beidseitige Entzündung des Sehnervs mit Sehstörungen können ebenfalls auftreten.
 Die Finanzexperten der Verbraucherzentrale Baden-Württemberg sagen, dass Banken solche Verwahrentgelte nur einführen können, wenn sie für jeden Kunden spezielle Vereinbarungen treffen.	Die Finanzexperten der Verbraucherzentrale Baden-Württemberg betonen, dass individuelle Vereinbarungen Voraussetzung dafür sind, dass Institute solche Verwahrentgelte einführen können.
 Schließlich lösen sich die Theragripper von dem Gewebe und werden durch die normale Bewegung des Darms aus dem Körper ausgeschieden.	Schliesslich verlieren die Theragripper ihren Halt am Gewebe und werden über eine normale gastrointestinale Muskelfunktion aus dem Darm entfernt.
 Die Wissenschaftler können nicht sagen, ob es daran liegt, dass die Dänen in Lockdown-freien Regionen sich freiwillig restriktiv verhalten.	Ob dies daran liegt, dass die Dänen in Lockdown-freien Regionen sich freiwillig restriktiv verhielten, können die Wissenschaftler allerdings nicht sagen.
 In Großbritannien wurden insgesamt 107 Todesfälle als Folge des Impfstoffs von Pfizer gemeldet.	Insgesamt wurden in Großbritannien 107 „tödliche Ereignisse“ als Folge des Impfstoffs von Pfizer gemeldet.
 Das grundlegende Problem ist, dass die Inhaltsstoffe der Masken nicht zugelassen sind.	Das grundsätzliche Problem: Die Inhaltsstoffe der Masken sind von der Zulassung nicht betroffen.
 Fast alle Menschen in Deutschland zahlen Steuern und viele sogar Sozialabgaben.	So gut wie alle Deutschen zahlen Steuern, viele auch Sozialabgaben.
 Seit 1968 wurden insgesamt 121.988 Fälle von gemeldeten Nebenwirkungen registriert.	Da haben wir seit 1968 insgesamt 121.988 Fälle von gemeldeten Nebenwirkungen.
 Dies ist entscheidend dafür, dass Capsaicin nur Krebszellen auswählt und zerstört.	Dies ist ausschlaggebend dafür, dass das Capsaicin nur Krebszellen wählt und vernichtet.
 Audi hat gesagt, dass sie nach eigenen Untersuchungen herausgefunden haben, dass 850.000 Fahrzeuge, darunter auch von Porsche und VW, betroffen sind.	Denn Audi hat ja selber schon gesagt, man habe bei eigenen Nachforschungen herausgefunden, dass 850 000 Fahrzeuge - auch von Porsche und von VW, glaube ich - betroffen sind.
 Wir folgten den Erklärungen des Kopp Verlages.	Dabei folgten wir den Ausführungen des Kopp-Verlages.
 Im Gesetz steht, dass der Bundeskanzler auf Vorschlag des Bundespräsidenten vom Bundestag ohne Diskussion gewählt wird.	Darin heißt es: „Der Bundeskanzler wird auf Vorschlag des Bundespräsidenten vom Bundestage ohne Aussprache gewählt.
 Die Weltgesundheitsorganisation (WHO) empfiehlt derzeit, dass ein Mund-Nasen-Beschlag (MNB) nur von einer Person getragen werden sollte, die Atemsymptome zeigt oder sich um eine kranke Person kümmert. Diese Regelung kann jedoch von den einzelnen Ländern ausgeweitet werden.	Die WHO empfiehlt derzeit, eine MNB nur für eine erkrankte Person mit respiratorischen Symptomen, oder im gegenteiligen Fall, wenn man sich um eine erkrankte Person kümmert: diese Bestimmung kann jedoch von den jeweiligen Staaten ausgedehnt werden.
 Seit dem 8. Dezember wurden bei der Impfung mit der Pfizer-Spritze 49.472 unerwünschte Ereignisse gemeldet.	Die Pfizer-Spritze führte seit dem 8. Dezember zu 49.472 unerwünschten Ereignissen.
 Er entschied sich dazu, die Verhandlungen mit der Linken abzubrechen und nur noch mit der FDP und den Grünen zu verhandeln.	Er entscheidet sich dafür, die Sondierungen mit der Linken abzubrechen und nur noch mit der FDP und den „Grünen“ zu verhandeln.
 Wenn die Maske effektiv genug ist, wird sie zertifiziert.	Wenn die Maske eine ausreichende Filterwirkung zeigt, wird sie zertifiziert.
 Die österreichische Presseagentur hat in ihrer Untersuchung zu dieser Frage herausgefunden, dass Impfdurchbrüche bei mehreren Krankheiten vorgekommen sind.	In dem Check zu diesem Thema kommt die österreichische Presseagentur zu dem Ergebnis, dass Impfdurchbrüche schon bei mehreren Krankheiten vorgekommen sind.
 Renz erklärte weiter auf dem Podium, dass wir umfangreiche Daten haben, die zeigen, dass die Zahl der Fehlgeburten im Vergleich zu dem Durchschnitt der letzten fünf Jahre um fast 300 Prozent gestiegen ist.	„Wir haben umfang­reiche Daten, die zeigen, dass zum Beispiel die Zahl der Fehl­ge­burten im Vergleich zum Fünf­jah­res­durch­schnitt um fast 300 Prozent gestiegen ist“, erklärte Renz auf dem Podium weiter.
 Die Regierung informierte am Montagnachmittag nach Beratungen über die aktuelle Coronavirus-Situation in Österreich.	Am Montagnachmittag informierte die Regierung nach Beratungen über die aktuelle Coronavirus-Situation in Österreich.
 Die Autoren schließen trotzdem daraus, dass ein Lockdown, egal ob freiwillig oder erzwungen, möglicherweise nutzlos sein könnte.	Die Autoren folgern dennoch, dass sowohl ein “freiwilliger” als auch ein erzwungener Lockdown möglicherweise nutzlos ist.
 Kennedy sagte, dass sie es bei 35 Kindern getestet haben und dasselbe Ergebnis eintrat.	»Sie testeten es, ich glaube an 35 Kindern, und dasselbe geschah«, sagte Kennedy.
 In diesem Text wird bereits im Abstract sehr deutlich erklärt, warum Klimamodelle, die nur auf den menschgemachten Klimawandel (AGW) zurückgreifen, versagen müssen.	Darin wird sehr genau – schon im Abstract- dargelegt, warum Klimamodelle, die sich allein auf den AGW beziehen, versagen müssen.
 Am Ende muss man berücksichtigen, dass der Atemwiderstand und die Arbeit, die die Atemmuskulatur leisten muss, steigt, wenn man FFP2-Masken verwendet.	Schließlich müsse die Zunahme des Atemwiderstands und die damit verbundene Zunahme der Arbeit der Atemmuskulatur (pressure drop) bei Verwendung von FFP2-Masken berücksichtigt werden.
"
Christian Drosten im NDR und die Virologin Monika Redelberger-Fritz auf derstandard.at weisen darauf hin, dass respiratorische Infekte durch schwere Tröpfchen übertragen werden."	Sowohl Christian Drosten im NDR wie auch die Virologin Monika Redelberger-Fritz auf derstandard.at weisen hier darauf hin, dass respiratorische Infekte über schwerere Tröpfchen übertragen werden.
 Die Ergebnisse über Fehlgeburten in Bezug auf die Schwangerschaftswoche sind nicht im Zusammenfassungsteil, sondern in den Fußnoten zu Tabelle 4 zu finden.	Die Ergebnisse hinsichtlich der Fehlgeburten in Relation zur Schwangerschaftswoche finden sich allerdings nicht im Abstract sondern in den Fußnoten zu Tabelle 4.
 Der Rechnungshof hat festgestellt, dass es oft vorkam, dass Krankenhausbetreiber die Anzahl der Intensivbetten verringerten, um Prämien für eine hohe Auslastung zu erhalten.	Es soll laut Rechnungshof schon vielfach vorgekommen sein, dass Krankenhausbetreiber die Zahl der Intensivbetten künstlich reduziert haben, um in den Genuss von Prämien für hohe Auslastung zu kommen.
 Es ist jetzt verpflichtend, FFP2- oder medizinische OP-Masken in Geschäften und öffentlichen Verkehrsmitteln zu tragen.	Inzwischen ist das Tragen von FFP2- oder medizinischen OP-Masken in Geschäften und öffentlichen Verkehrsmitteln zur Pflicht geworden.
 In der Mikrowelle wird eine ungleichmäßige Temperatur erreicht, wodurch die Maske an manchen Stellen zu kalt, also unwirksam, und an anderen Stellen zu heiß wird, wodurch sie beschädigt werden kann.	In der Mikrowelle werden keine gleichmäßigen Temperaturen erreicht, sodass die Temperatur an einigen Stellen der Maske zu niedrig und damit unwirksam und an anderen Stellen zu hoch sein kann, was die Maske wiederum beschädigen kann.
 Der leitende Arzt einer großen Klinik, Dr. med. Gunter Frank, sagte gestern Abend zu mir, dass seit dem 1. November für jeden Patienten, der positiv auf das Coronavirus getestet wurde und beim Gesundheitsamt gemeldet wurde, im Krankenhaus 7.800 Euro zusätzlich zur normalen Abrechnung bezahlt werden, wenn er mindestens 2 Nächte im Krankenhaus bleibt. Dieser Betrag kann bei längerem Aufenthalt bis zu knapp 10.000 Euro erhöht werden.	Von Dr. med. Gunter Frank Gestern Abend teilte mir der leitende Arzt einer großen Klinik Folgendes mit: Es gibt, gültig seit 1. November, für jeden positiv Corona-getesteten und an das Gesundheitsamt gemeldeten Patienten im Krankenhaus zusätzlich zur normalen Abrechnung 7.800 Euro, wenn er mindestens 2 Nächte im Krankenhaus verbleibt, steigerungsfähig bei längerem Aufenthalt bis knapp 10.000 Euro.
 In jedem Fall sind die Masken nicht dafür geeignet, mehrmals benutzt zu werden.	In jedem Fall sind die Masken nicht für mehrfache Nutzung geeignet.
 Oft sind es Familienangehörige oder Menschen aus dem näheren Umfeld, die sich um ältere Menschen kümmern und einen Arztbesuch für sie arrangieren.	Gerade bei älteren Menschen sind es oft die Familienangehörigen und das nahe Umfeld, die sich um diese sorgen und einen Arztbesuch veranlassen.
 Diese Information muss deutlich sichtbar und von Dritten beurteilt werden, um den medizinischen Ethikstandards gerecht zu werden und die Patienten angemessen zu informieren und ihre Zustimmung zu erhalten.	Diese Offenlegung muss an prominenter Stelle und unabhängig erfolgen, um den Standard der medizinischen Ethik für das Verständnis und eine informierte Einwilligung der Patienten zu erfüllen.
"
Die Ständige Impfkommission (STIKO) empfiehlt, dass in Deutschland in der Regel eine Booster-Impfung nach drei Monaten nach der letzten Impfstoffdosis der Grundimmunisierung erfolgen soll."	Die Ständige Impfkommission(STIKO) empfiehlt für Deutschland, dass eine Booster-Impfung in der Re­gel nach drei Monaten nach der letzten Impfstoffdosis der Grundimmunisierung erfolgen soll.
 Trotzdem ist es gelungen, drei Millionen Euro an Soforthilfe für Syrien zusammenzustellen. Das ist zwar nicht viel, aber besser als nichts.	"So sei es immerhin gelungen, die drei Millionen Euro Soforthilfe für Syrien aufzustellen: ""Das reicht vielen nicht, aber es ist auch nicht nichts."
 In Tschechien und der Slowakei hat Ivermectin eine vorläufige Zulassung für die Behandlung von Covid-19-Patienten erhalten.	(7) Ivermectin hat auch in Tschechien und der Slowakei eine vorläufige Zulassung für die Behandlung von Covid-19-Patienten.
 Die Demonstranten haben Lieder gesungen, in denen sie behaupteten, dass die Maßnahmen illegal seien.	Demonstranten haben Botschaften wie „Die Maßnahmen sind illegal“ gesungen.
 In letzter Zeit wurden mehrere Fälle von Verbraucherzentralen, dem Portal Lebensmittelklarheit und der Wettbewerbszentrale abgemahnt und mehrere Klagen wurden erfolgreich vor Gerichten durchgesetzt.	Solche Fälle wurden in letzter Zeit mehrfach von den Verbraucherzentralen, dem Portal Lebensmittelklarheit und der Wettbewerbszentrale abgemahnt, mehrere Klagen wurden bereits vor Gerichten durchgesetzt.
 Wenn die Menge der schützenden Antikörper beim Dengue-Fieber niedriger wird, ist die Wiederinfektion mit einem anderen Serotyp schwieriger.	Beim Dengue-Fieber verläuft die Reinfektion mit einem anderen Serotyp schwerer, wenn der Titer der schützenden Antikörper abnimmt.
 Aber es liegt auch daran, wie Kliniken ihre Sterblichkeitsraten berichten und nach welchen Kriterien sie die Todesursachen beurteilen.	Aber es liege auch daran, wie die Kliniken ihre Mortalitätsraten berichten und nach welchen Kriterien sie die Todesursachen beurteilen.
 Graphenoxid ist ein starkes Toxin, das neben Thrombogenität auch mitochondriale Schäden, postinflammatorisches Syndrom, Lungenfibrose, ein beeinträchtigtes Immunsystem und den sogenannten Zytokinsturm verursacht.	Ein starkes Toxin, das unter anderem Thrombogenität verursacht: Aber darüber hinaus verursacht Graphenoxid auch mitochondriale Schäden, das postinflammatorisches Syndrom, Lungenfibrose und es beeinträchtigt das Immunsystem und führt zum befürchteten und mehrmals bereits aufgegriffenen Zytokinsturm: Graphenoxid verursacht mitochondriale Schäden, postinflammatorisches Syndrom, Lungenfibrose, beeinträchtigtes Immunsystem und Zytokinsturm.
 Obwohl der Zeitraum kurz war, wurden Daten aus fast der gesamten Bevölkerung mit einbezogen.	Der Zeitraum ist zwar kurz, dafür wurden Daten aus fast der gesamten Bevölkerung mit einbezogen.
"
Frau Emer Cooke, die Direktorin der Europäischen Arzneimittelagentur (EMA), war jahrelang Leiterin der Lobby-Agentur der pharmazeutischen Industrie, der Europäischen Föderation für pharmazeutische Industrien und Vereinigungen (EFPIA)."	Die Direktorin der EMA, Frau Emer Cooke, war lange Jahre Chefin der Lobbying Agentur der pharmazeutischen Industrie, der European Federation of Pharmaceutical Industries and Associations (EFPIA).
 Während der Pandemie gab es laut der Auskunft keine entsprechenden Anträge.	Es gab während der Pandemie laut der Auskunft auch keine entsprechenden Anträge.
 Und dann noch eine Komponente hinzufügen, entweder die Haushaltsquarantäne, das bedeutet, dass der Fall isoliert wird und der gesamte Haushalt dazu gehört.	Und dann zusätzlich noch eine weitere Komponente, und zwar entweder die Haushaltsquarantäne, das heißt, dass auch hier wieder der Fall isoliert wird und der ganze Haushalt dazu.
 Du kannst sie an deine Schule schicken.	Sie können sie an ihre Schule schicken.
 Innenminister Karl Nehammer (ÖVP) hat am Montag zusammen mit seinem ungarischen Kollegen Sandor Pinter auf einer gemeinsamen Pressekonferenz erklärt, dass Österreich im Vergleich zur Migrationskrise 2015 deutlich besser aufgestellt ist.	Österreich sei im Vergleich zur Migrationskrise 2015 inzwischen deutlich besser aufgestellt, sagte Innenminister Karl Nehammer (ÖVP) am Montag bei einer gemeinsamen Pressekonferenz mit seinem ungarischen Kollegen Sandor Pinter.
 Menschen, die geimpft oder bereits von Covid-19 genesen sind, können die Quarantänepflicht nach der Einreise in Deutschland vermeiden, wenn sie den deutschen Behörden vor der Einreise einen Nachweis ihres Impfstatus oder ihrer Genesung vorlegen.	Geimpfte und Genesene können die Quarantäne aber abwenden, wenn sie bereits vor ihrer Einreise einen Genesenen- oder Impfnachweis an die deutschen Behörden übermitteln.
 Weil die Informationen nicht über eine Person, die an der Studie teilnimmt, gehen, werden die Informationen nicht im CFR aufgezeichnet.	Da sich die Informationen nicht auf einen an der Studie teilnehmenden Teilnehmer beziehen, werden die Informationen NICHT in einem CFR aufgezeichnet.
 Die beiden hatten zehn verstorbene Menschen untersucht.	Die beiden hatten zehn Verstorbene untersucht.
 Der Verbreitung des Virus soll in diesem Land weniger weitläufig sein als in anderen Ländern.	Die Ausbreitung des Virus sei beschränkter als in anderen Ländern.
 Einige Senioren lehnten Essen und Trinken ab.	Einige Senioren verweigerten Essen und Trinken.
 Im Gegensatz zu früheren Berichten von den Medien, waren nicht alle der 13 Menschen, die gestorben sind, vorher geimpft worden.	Entgegen früheren Medienberichten waren nicht alle der 13 Toten zuvor geimpft worden.
 Trotzdem erklärt Renz, dass die Zahlen darauf hindeuten, dass die Anzahl an ins Krankenhaus eingewiesenen Patienten gestiegen ist.	Dennoch erklärt Renz, dass die Zahlen auf einen Anstieg der hospitalisierten Patienten hinweisen würden.
 Außerdem darf Deutschland keine Schuldenvereinbarung auf europäischer Ebene eingehen.	Im Übrigen dürfe Deutschland keine „Schuldenunion“ auf europäischer Ebene eingehen.
 Kurz nach der Impfung begannen die Senioren Symptome wie Fieber, Wassereinlagerungen in Gewebe, Hautausschlag, Zittern am Oberkörper und Armen, Verhaltensänderungen, Müdigkeit, Juckreize, Erschöpfung, Atemnot und Herzrasen zu erleben.	Kurz nach der Impfung traten schwerwiegende Veränderungen bei den Senioren auf: Fieber, Ödeme, Hautausschlag, Muskelzittern am Oberkörper und Armen, Wesensveränderungen, Müdigkeit, Juckreize, Schlappheit, Schnappatmung und Herzrasen.
 Der Wechsel soll verhindern, dass die Polio-Viren sich weiter verbreiten.	Der Umstieg sollte das Risiko eines weiteren Ausbreitens von Impfpolio-Erregern vermeiden.
 Der Positive Predictive Value (PPV) des Schnelltests liegt etwa bei 1,5 Prozent.	Der Schnelltest-PPV liegt bei etwa 1,5 Prozent.
 Nach Untersuchungen der Initiative Qualitätsmedizin und der InEK gab es in den Krankenhäusern mindestens zeitweise dreimal so viele Fälle, die als Covid-Fälle abgerechnet wurden, ohne dass ein Infektionsnachweis vorlag, als solche, bei denen es einen Nachweis gab.	Nach Untersuchungen der Initiative Qualitätsmedizin und der InEK gab es in den Krankenhäuser mindestens zeitweise dreimal so viel abgerechnete Covid-Fälle ohne Infektionsnachweis wie solche mit Nachweis.
 Die Bewohner werden drei Mal pro Woche mit einem Schnelltest getestet, während die Mitarbeiter jeden Tag vor Arbeitsbeginn einen Test machen.	Die Bewohner werden nach Darstellung von Kurz dreimal in der Woche mit einem Schnelltest getestet – die Mitarbeiter machen täglich einen Test vor Arbeitsbeginn.
 Seit Mittwoch sind mehr Menschen, die geimpft wurden (58%), als Menschen, die nicht geimpft sind, auf den Normalstationen.	Seit Mittwoch seien nicht mehr die Impffreien auf den Normalstationen in Überzahl, sondern die Geimpften, nämlich mit 58 Prozent.
 60 Prozent der positiven Tests sind tatsächlich ein Ergebnis einer Corona-Infektion.	Das heißt, 60 Prozent der positiven Tests liegt tatsächlich eine Corona-Infektion zugrunde.
"
Bei Ausgrabungen auf dem Dresdner Altmarkt entdeckten sie drei Meter unterhalb des Straßenniveaus Verfärbungen des Sandsteins, die von Weißbeige zu Rot reichten."	(…) Am Dresdner Altmarkt fanden sie in ausgegrabenen Kellern drei Meter unter Straßenniveau Verfärbungen des Sandsteins von Weißbeige nach Rot.
 Die schlechte Kommunikation über die Vorgänge im Pflegeheim beeinflusst die Stimmung der Bewohner.	"""Auf die Stimmung der Bewohner wirkt sich auch die mangelhafte Kommunikation über die Vorgänge im Pflegeheim aus."
 Die Weltgesundheitsorganisation (WHO) hat eine Strategie-Expertengruppe einberufen, die auf dieser Grundlage zu dem Schluss kam, dass Personen, bei denen Dengue nachgewiesen wurde, geimpft werden sollten, wenn Dengue-Kontrollprogramme geplant sind, die eine Impfung beinhalten.	Auf dieser Grundlage kam eine von der Weltgesundheitsorganisation (WHO) einberufene Strategie-Expertengruppe zu dem Schluss, dass nur seropositive Dengue-Personen geimpft werden sollten, wenn Dengue-Kontrollprogramme geplant sind, die eine Impfung beinhalten«.
 Die Mehrheit der Kinderbelästiger ist heterosexuell, aber nicht alle haben die gleiche Stärke.	6 Eine ungleich starke Mehrheit der Kinderbelästiger ist heterosexuell.
 Er hat demnach laut Yehu Moran, dem Leiter, in den letzten Jahren dort nicht gearbeitet.	Doch dort hat er nach Angaben von dessen Leiter, Yehu Moran, in den vergangenen Jahren nicht gearbeitet.
 Notieren Sie in den nächsten Zeilen wie viele Personen über und wie viele Personen unter 14 Jahren in Ihrem Haushalt leben.	In den nächsten Zeilen notieren Sie, wie viele Personen ab 14 Jahren und wie viele Personen unter 14 Jahren in Ihrem Haushalt leben.
 Menschen in Deutschland müssen seit Monaten Masken tragen, insbesondere Pflegepersonen.	Seit Monaten müssen Menschen in Deutschland Masken tragen, allen voran Pflegepersonen.
 Zehntausende Menschen mit vorbestehenden Krankheiten starben, nachdem sie mit dem Coronavirus infiziert waren.	Zehntausende von Menschen mit Grunderkrankungen starben, nachdem sie positiv auf Corona getestet wurden.
 Wenn man genauer hinsieht, erkennt man auch Insekten, die herumschwirren.	Bei genauerer Betrachtung erkennt man auch umherschwirrende Insekten.
 Die Schäden, die durch die Unwetter verursacht wurden, waren damals nicht so schlimm wie erwartet.	Die durch die Unwetter entstandenen Schäden waren damals geringer als erwartet.
" Die Stabilität und Verlässlichkeit Deutschlands steht auf dem Spiel, wie ""Focus online"" berichtet."	Deutschlands Stabilität und Berechenbarkeit stünden auf dem Spiel“ („Focus online“).
 Es gibt immer noch Einstellungen, die Fremde und Minderheiten ablehnen und die mit aggressiver Rhetorik verbreitet werden.	Nach wie vor finden sich fremden- und minderheitenfeindliche Einstellungen, die mit zum Teil aggressiver Rhetorik verbreitet werden.
 Deshalb haben sie keine Immunität gegen den Schädling entwickelt.	Folglich haben diese keine Resistenz gegen den Schädling entwickelt.
 Dr. Ulrich Gutweniger, ein Psychologe, hat dabei geholfen, das Tragen einer Maske aus einer psychologischen Sicht zu bewerten.	Der Psychologe Dr. Ulrich Gutweniger steuerte die Bewertung des Maskentragens aus psychologischer Sicht bei.
 Sie erwartet, dass viele Menschen nach Griechenland ziehen werden.	Sie rechnet mit einer großen Migrationsbewegung nach Griechenland.
 Dadurch kann das Virus schnell seine Fähigkeit zur Ansteckung verlieren.	Damit verliert das Virus schnell seine Ansteckungsfähigkeit.
 Obwohl es seit Monaten starke Widerstände gibt, die Forderungen aufstreben, dass Schweden ebenfalls harte Maßnahmen ergreifen muss.	Trotzdem gibt es seit Monaten massive Kräfte, die von Schweden ebenfalls harte Maßnahmen fordern.
 Bohn berichtet, dass viele Menschen aus dem Kern und Rückgrat des Landes Selbstmord begangen haben, weil ihnen die Möglichkeiten und Freiheiten entzogen wurden.	Bohn berichtet von reihenweise Selbstmorden aus einem Milieu, das das geistige Rückgrat dieses Landes darstellt und dem die Luft zum Atmen genommen wird.
 Wenn eine Streuung gefährlicher Stoffe aus einer Impfung stattfindet oder wenn es ein Risiko für Menschen gibt, die schwanger werden können.	„Streuen“, d.h. Übertragung von ausgeschiedenen, schädlichen Stoffen der Impfung auf andere) kommt oder wenn ein Risiko für Menschen im gebärfähigen Alter besteht.
 Bei den meisten dieser Kinder trat eine schwere Erkrankung mit Infektion auf, was zu vielen Krankenhausaufenthalten führte. Leider starben zwei von 35 Kindern an der Infektion.	Bei den meisten dieser Kinder kam es zu einer schweren Erkrankung mit Infektion, die zu einer hohen Zahl von Krankenhausaufenthalten führte – zwei von 35 Kindern starben an der Infektion.
 Ärztinnen oder Pflegekräfte, die Masken nur tragen, wenn sie in den Operationssaal oder auf die Intensivstation gehen und die Masken nach dem Verlassen entsorgen, sind viel weniger Mikrofasern ausgesetzt als Menschen, die Masken über längere Zeiträume während der Fahrt oder am Arbeitsplatz tragen müssen.	Medizinerinnen oder Pflegerinnen, die die Masken nur tragen, wenn sie in den OP gehen oder in die Intensivstation, und die Masken beim Herauskommen entsorgen, sind viel weniger Mikrofasern ausgesetzt als Menschen, die die Masken bei längeren Fahrten oder am Arbeitsplatz über viele Stunden aufhaben müssen.
 Man kann keine umfassenden Aussagen über mögliche Nebenwirkungen in Bezug auf Zellkulturexperimente machen.	Ebenso wenig können in Zusammenhang mit Zellkulturexperimenten umfassende Aussagen zu möglichen Nebenwirkungen getroffen werden.
 Die Autoren weisen darauf hin, dass es ein großes Risiko gibt, dass das Impfvirus so mutieren könnte, wie es beim orale Polio-Impfstoff schon einmal der Fall war. Mit anderen Worten: Es besteht die Möglichkeit, dass die gentechnisch veränderte Version des Impfstoffs sich verändert.	Außerdem geben die Autoren zu bedenken: „Es besteht ein nicht unerhebliches Risiko, dass das Impfvirus zu einer Wildtyp-Virulenz zurückkehrt, wie es manchmal beim oralen Polio-Impfstoff der Fall war.“ Mit anderen Worten: Mutationen des zuvor gentechnisch veränderten Impfstoffs könnten nicht ausgeschlossen werden.
 Wenn Sie an der Aktivität teilnehmen, erhalten Sie automatisch Punkte.	Wenn Sie teilnehmen, sammeln Sie automatisch Punkte.
" In der Sendung ""Corona-Quartett"" und ""Talk im Hanger 7"" werden sowohl Personen, die die Maßnahmen befürworten, als auch Personen, die kritisch gegenüber den Maßnahmen sind, zu Wort kommen."	In der Sendung „Corona-Quartett“ / „Talk im Hanger 7“ kommen Befürworterinnen und Kritiker gleichermaßen zu Wort.
 Die Bundesregierung muss nun zugeben, dass die Daten oft nur unvollständig vorliegen.	Allerdings liegen die Daten oft nur lückenhaft vor, muß die Bundesregierung jetzt einräumen.
 Das Ministerium für Arbeit, Soziales und Integration des Landes Sachsen-Anhalt hat in enger Zusammenarbeit 120 Intensivbetten als Katastrophenvorsorge technisch und räumlich verbessert, wie auf Nachfrage bestätigt wurde.	„In enger Abstimmung mit dem Ministerium für Arbeit, Soziales und Integration des Landes Sachsen-Anhalt“ wurden damit 120 Intensivbetten „als Katastrophenvorsorge technisch und räumlich ertüchtigt“, heißt es auf Nachfrage.
 Auch das Wiederholte Anheben und Absetzen führt zu einer Erhöhung des Faserabriebs.	Auch die mechanische Beanspruchung beim Auf- und Absetzen führt zu einem erhöhten Faserabrieb.
 Insgesamt tragen wir eine Mischung an Chemikalien vor Mund und Nase, die nie auf ihre Toxizität oder mögliche Langzeitwirkungen untersucht wurde, so schreiben es die Buchkomplizen in einem Artikel.	„Alles in allem tragen wir einen Chemiecocktail vor Nase und Mund, der nie auf seine Giftigkeit und niemals auf etwaige Langzeitwirkungen untersucht wurde“, so schreiben es die Buchkomplizen in einem Artikel.
 Es wurde ein klares Notfallstufenkonzept entwickelt, die Mitarbeiter wurden entsprechend geschult und zusätzlich wurde ein Gaselager eingerichtet, um in Notfällen so schnell wie möglich die Betten in Betrieb zu nehmen.	Man habe aber ein klares Notfallstufenkonzept entwickelt, Mitarbeiter geschult und ein zusätzliches Gaselager eingerichtet, um diese Betten bei Bedarf schnell in Betrieb zu nehmen.
 Eine Studie, bei der Tausende von Personen während einer Pilgerreise nach Mekka beobachtet wurden, zeigte, dass die Gruppe, die dauerhaft Masken trug, mehr Atemwegsinfektionen aufwies.	Eine Studie mit Tausenden von Personen während einer Pilgerreise nach Mekka ergab mehr Atemwegsinfektionen in der Gruppe, die ständig Masken trug.
 Der Landtag hat am Samstagabend die Immunität der 62-jährigen Politikerin aufgehoben, sodass die Staatsanwaltschaft früher als geplant umfänglich gegen sie ermitteln kann.	Damit die Staatsanwaltschaft schon früher als geplant umfänglich gegen die 62-Jährige ermitteln kann, hatte der Landtag am Samstagabend die Immunität der Politikerin aufgehoben.
 In der ganzen Provinz sind Teams unterwegs, die von Tür zu Tür gehen und Menschen für eine Impfung werben.	In der gesamten Provinz seien zudem Gesundheitsteams unterwegs, die von Tür zu Tür gingen und für eine Impfung werben.
 In der Studie heißt es, dass obwohl eine Kausalität nicht mit absoluter Sicherheit nachgewiesen werden kann, sie doch sehr plausibel erscheint.	"Aber ""auch wenn eine Kausalität nicht mit absoluter Sicherheit nachgewiesen werden kann, erscheint sie doch sehr plausibel"", heißt es in der Studie."
 Test Kits für SARSCoV- 2 werden in China knapp.	Testkits für SARSCoV- 2 werden in China rar.
 Ab sofort sollen so viele Menschen wie möglich von zu Hause aus arbeiten, als weitere Maßnahme.	Als weitere Maßnahme sollen ab sofort so viele Menschen wie möglich im Homeoffice arbeiten.
 Im Fall von Medizinprodukten müssen sie der zuständigen Behörde angezeigt werden und bei der Prüfung von Arzneimitteln müssen sie auch von dieser genehmigt werden.	Sie müssen im Fall von Medizinprodukten der zuständigen Behörde angezeigt und bei der Prüfung von Arzneimitteln auch von dieser genehmigt werden.
 Die Autoren zeigen hier, dass aufgrund der Auswirkungen der Lockdown-Maßnahmen die durchschnittliche Lebenserwartung für Männer um 0,76% und für Frauen um 0,41% sinkt.	Die Autoren belegen hier, dass durch die Auswirkungen der Lockdown-Maßnahmen die durchschnittliche Lebenserwartung für Männer um 0,76 % sinkt; die für die Frauen um 0,41 %.
" Die ehemalige Meinungsforscherin Samira Tarrass sagte: ""Jetzt geht es los."""	Die frühere Meinungsforscherin Samira Tarrass fügt hinzu: “Jetzt geht’s los.
 Es wurde bemerkt, dass die meisten Mütter, die lebende Kinder zur Welt brachten, erst im letzten Drittel der Schwangerschaft geimpft wurden.	Allerdings wird angemerkt, dass die Mütter, die lebende Kinder zur Welt brachten, mehrheitlich erst im dritten Schwangerschaftsdrittel geimpft wurden.
 Der Körper des Individuums produziert ein Protein, das dazu dient, das Immunsystem anzugreifen.	Der Körper des Individuums stellt ein fremdes Protein her, das das Immunsystem angreifen soll.
 Man sollte sich die beiden Frequenzen wie zwei Autobahnen vorstellen, die besonders dann benutzt werden, wenn die meisten Nachbarn zu Hause sind und drahtlos im Netz surfen.	Beide Frequenzen muss man sich wie zwei Autobahnen vorstellen, die besonders im „Feierabendverkehr“, also dann, wenn die meisten Ihrer Nachbarn zu Hause sind und drahtlos im Netz surfen, frequentiert werden.
 Aus der Pressestelle heißt es, dass Intensivpflegekräfte ein limitierender Faktor sind.	"„Limitierender Faktor sind die Intensivpflegekräfte"", heißt es aus der Pressestelle."
 Ein einziger Todesfall auf 20'000 würde die statistische Gefahr verdoppeln.	Schon ein einziger Todesfall unter 20’000 würde die Gefahr statistisch um das Doppelte überzeichnen.
 PIC bedeutet Lungenentzündung, Grippe und Covid.	PIC steht für Pneumonia-Influenza-Covid (Lungenentzündung, Grippe, Covid).
 Besonders, da immer mehr Kinder und Jugendliche geimpft werden?	Insbesondere, weil immer mehr Kinder und Jugendliche geimpft werden?
 Neun Komma Vier Prozent der Schwangerschaften endeten mit einer Frühgeburt und Drei Komma Zwei Prozent der Babys waren unterentwickelt.	9,4% der Schwangerschaften führten zu einer Frühgeburt, 3,2% der Babys waren unterentwickelt.
 Winston Churchill, der große britische Kriegspremier, hatte seine eigene Meinung, was Statistiken betraf - er vertraute nur Zahlen, die er selbst manipuliert hatte.	Der große britische Kriegspremier Winston Churchill hatte seine ganz eigene Meinung bezüglich Statistiken – er glaubte grundsätzlich nur solchen Zahlen, „die ich selber gefälscht habe“.
" Der Tagesspiegel zitiert den Satz: ""Die PCR ist einfach zweifelsfrei"", ohne zu erklären worauf sich die Aussage bezieht."	„Die PCR ist da einfach zweifelsfrei.“, zitiert ihn der Tagesspiegel, allerdings ohne genau zu erklären worauf sich die Aussage bezieht.
 Werden den Kindern dieselben Stäbchen in die Nase gesteckt?	Sind es die selben Stäbchen, die unseren Kindern in die Nase gesteckt werden?
 Ich kann nicht sagen, ob Graphenoxid tatsächlich das auslösende Moment ist.	Die Frage, ob Graphenoxid tatsächlich das “auslösende Moment” ist, kann ich natürlich nicht beantworten.
 Bei Kindern gibt es im Gegensatz zu Erwachsenen keine Notfallzulassung.	Dabei gibt es bei Kindern – anders als bei Erwachsenen – nicht einmal eine Notfallzulassung.
 Als Corona Japan und Thailand erreichte, wussten wir, dass es auch in Europa angekommen sein würde.	Als Corona dann Japan und Thailand erreichte, wussten wir, dass es auch in Europa ankommen würde.
 Der Bericht sagt auch, dass sie keine lebensbedrohlichen Zustände, Geburtsfehler, dauerhaften Behinderungen oder Vorerkrankungen hatte.	Der Bericht besagt auch, dass sie keine anderen lebensbedrohlichen Zustände, keine Geburtsfehler, keine dauerhafte Behinderung und keine Vorerkrankungen hatte.
 Bei Frauen wurden 29.914 unerwünschte Ereignisse aufgezeichnet, während bei Männern nur 9.182 registriert wurden.	Bei Frauen wurden 29.914 unerwünschte Ereignisse registriert, bei Männern dagegen nur 9.182.
 Sie erforschten den jetzigen Wissensstand über frühe Krankenhausbehandlungen, wie wirksam Impfungen sind und was rückblickend richtig oder falsch war. Außerdem untersuchten sie, was momentan getan wird und was in Zukunft geplant werden sollte.	Sie beleuchteten unter anderem den derzeitigen Wissensstand über frühe Krankenhausbehandlungen, die Wirksamkeit von Impfungen und sie gingen der Frage nach, was rückblickend falsch oder richtig lief, was jetzt gemacht und was für die Zukunft geplant werden sollte.
 Als schwere Nebenwirkungen wurden 2885 Fälle von Gesichtslähmung, 1073 Fehlgeburten, 3906 Herzattacken, 2466 Fälle von Herzmuskelentzündung, 2552 Fälle von Thrombocytopenie und 8832 Fälle, die akute Lebensgefahr bedeuteten, berichtet.	Als schwere Nebenwirkungen werden 2885 Gesichtslähmungen angeführt, 1073 Fehlgeburten, 3906 Herzattacken, 2466 Fälle von Herzmuskelentzündungen, 2552 Fälle von Thrombocytopenie und in 8832 Fällen bestand akute Lebensgefahr.
 Im Winter hat das Meereis die Insel normalerweise fest im Griff, aber jetzt war davon keine Spur zu sehen.	Vom Meereis, das die Insel im Winter gewöhnlich fest im Griff hat, war keine Spur zu sehen.
 Für jedes Jahr werden die Sterberaten in Prozent der jeweiligen Bevölkerungsgröße angegeben.	Für jedes Jahr sind die genauen Sterblichkeitsraten in Prozent zur jeweiligen Bevölkerungsgröße angegeben.
 Es ist wichtig darauf hinzuweisen, dass die im Flyer vorgestellten Verfahren keine Garantie für einen sicheren Infektionsschutz bieten. Deshalb sollte man Masken, sofern möglich, immer nur nach den Vorgaben des Herstellers verwenden.	Gleichwohl ist darauf hinzuweisen, dass die im Flyer vorgestellten Verfahren keine Garantie für einen sicheren Infektionsschutz bieten können und entsprechende Masken, sofern möglich, auch im Privatgebrauch immer nur nach den Vorgaben des Herstellers angewendet werden sollten.
 Das Coronavirus, das für die COVID-19-Pandemie verantwortlich ist, wird als SARS-CoV-2 bezeichnet.	Das COVID-19-Virus ist ebenfalls ein Coronavirus mit der Bezeichnung SARS-CoV-2.
 Wie ist es mit den positiven Tests durch andere Coronaviren, die für Menschen ungefährlich sind?	Doch wie ist es bezüglich der positiven Testergebnisse aufgrund anderer, für Menschen harmloserer Coronaviren?
 Seitdem wurden 27 weitere Fälle gemeldet, die alle die strengen Anforderungen erfüllen, die notwendig sind, um auf die Liste aufgenommen zu werden.	Danach wurden bis heute noch 27 weitere Fälle gemeldet, die der strengen Prüfung, die für die Aufnahme auf die Liste nötig ist, standhielten.
 Er macht sich Sorgen, dass die Impfstoffe nicht im Schultermuskel bleiben, wie er zuvor gedacht hat.	Darüber hinaus bereitet es ihm Sorgen, dass sie nicht wie bisher angenommen hauptsächlich an der Impfstelle am Schultermuskel verbleiben.
 Für Informationen über die Effektivität des COVID-19-Impfstoffs Janssen siehe bitte die FAQ zur Wirksamkeit und den Impfdurchbrüchen des Janssen-Impfstoffs.	Zur Effektivität der COVID-19 Vaccine Janssen siehe FAQ: Wie verhält es sich mit der Wirksamkeit und Impfdurchbrüchen beim Janssen Impfstoff (COVID-19 Vaccine Janssen)?
" Stew sagte: ""Also, wenn du das weißt und du diese Bestätigung mitbringst, warum glaubst du, dass es so ist?"""	Stew: (12:43): Also, wenn du das weißt, wenn du diese Bestätigung bringst, warum sollte die, ich meine, das ist eine Meinung.
 Eine Infektion entsteht nur, wenn ein Krankheitserreger im Körper aufgenommen und dort vermehrt wurde.	Und eine Infektion besteht nur, wenn ein vermehrungsfähiges Virus aufgenommen worden ist.Anmerkung: Genau genommen reicht es nach der juristischen Kommentarliteratur (Kiessling, § 2 IfSG, Rz. 5) für eine Infektion noch nicht einmal, dass ein vermehrungsfähiger Krankheitserreger in den Körper aufgenommen wurde; erforderlich ist auch eine Entwicklung oder Vermehrung im Körper.
 Seit Anfang April veröffentlicht das Gesundheitsministerium nur noch den Prozentsatz der belegten Betten.	Da weist das Gesundheitsministerium seit Anfang April nur den Prozentsatz der belegten Betten aus.
 Experten sagen, dass Atemschutzmasken schädlich sind, weil sie den Sauerstoffhaushalt im Körper beeinträchtigen.	Atemschutzmasken sind gemäss diversen Experten eher kontraproduktiv, weil sie unter anderem den Sauerstoffhaushalt im Körper beeinträchtigen.
 Einige Leser erinnern sich vielleicht an meinen Beitrag auf Achgut.com über falsch positive Testungen.	Der eine oder andere Leser erinnert sich vielleicht an meinen Achgut.com-Beitrag bezüglich der falsch positiven Testungen.
 Experten haben von Anfang der Corona-Krise an bezweifelt, dass Masken vor einer Verbreitung von Viren schützen.	Experten haben den Schutz von Masken vor einer Verbreitung von Viren von Anbeginn der Corona-Krise in Frage gestellt.
 Alle Busse haben bereits jetzt automatisch geöffnete Türen. Ab Mitte August werden auch alle U-Bahn-Modelle des Typs DT4, einschließlich der DT5-Modelle, mit derselben Software ausgestattet sein.	Bei allen Bussen sowie den U-Bahn-Modellen DT5 öffnen bereits jetzt alle Türen automatisch, ab Mitte August werden auch alle U-Bahn-Modelle des Typs DT4 mit der Software umgerüstet sein.
 Es gibt immer noch kein Isolat des „Coronavirus“.	Nach wie vor gibt es kein Isolat des “Coronavirus”.
 In der Studie werden Behauptungen von „Corona-Experten“ wie dem US-amerikanischem Immunologen Dr. Anthony Fauci und anderen abgelehnt, die behaupten, dass die Amerikaner den von der CDC und anderen Seuchenbekämpfungsbehörden verbreiteten Leitlinien nicht folgen würden.	In der Studie werden auch Behauptungen von „Corona-Experten“ wie dem US-amerikanischem Immunologen Dr. Anthony Fauci und anderen zurückgewiesen, wonach die Amerikaner den von der CDC und anderen Seuchenbekämpfungsbehörden verbreiteten Leitlinien nicht folgen würden.
 Es besteht ein starkes Zusammenhang zwischen der Zahl der Personen, die pro Tag geimpft wurden, und der Anzahl der pro Tag verzeichneten Todesfälle innerhalb eines Zeitraums von bis zu 10 Tagen, in allen Altersgruppen.	„Es gibt eine hohe Korrelation zwischen der Anzahl der geimpften Personen pro Tag und der Anzahl der Todesfälle pro Tag, im Bereich von bis zu 10 Tagen, in allen Altersgruppen.
 Man kann nicht aus einem Test herausfinden, ob das Virus noch intakt ist oder ob es sich hierbei um Trümmer handelt.	Ob das Virus dabei noch intakt ist oder ob es sich hier um Trümmer handelt, das lässt sich aus so einem Test nicht erschließen.
" Die Europäische Arzneimittel-Agentur stellt die ""Zusammenfassung der Merkmale des Arzneimittels"" des Impfstoffs Janssen® von Johnson & Johnson online in 25 Sprachen zur Verfügung und auf Seite 27 können Sie den Beipackzettel finden."	"Den Beipackzettel des Impfstoffs Janssen® von Johnson & Johnson finden Sie in der ""Zusammenfassung der Merkmale des Arzneimittels"", das die EMA online in 25 Sprachen zur Verfügung stellt, ab Seite 27."
 Aber sie haben keine Verbindung zu dem neuen Coronavirus.	Aber die haben mit dem neuen Coronavirus nichts zu tun.
 Was können wir aus diesen Daten aus Deutschland ableiten?	Was folgt aus dieser Datenlage in Deutschland?
 Ihr Erbgut wird weder in Körperzellen noch in Keimbahnzellen in die menschliche DNA eingefügt.	Ihre Erbinformation wird nicht in die menschliche DNA eingebaut, weder in Körperzellen noch in Keimbahnzellen.
 Bei Mers sieht die Situation ganz anders aus: Hier infizieren sich Menschen ständig unmittelbar von Tieren.	Das sieht bei Mers ganz anders aus: Hier infizieren sich Menschen immer wieder direkt bei Tieren.
 Griechenland und andere Länder, in denen Menschen Urlaub machen, drängen darauf, dass man Reiseerleichterungen anbietet, wenn man ein solches Dokument vorlegen kann.	Griechenland und andere Urlaubsländer dringen hingegen darauf, Reiseerleichterungen mit einem solchen Dokument zu verbinden.
 Frau Sievert rät Rettungsleuten und allen, die sich impfen lassen möchten, sich gut zu informieren, besonders wenn es um Kontraindikationen geht.	Rettungsleuten und jenen die sich impfen lassen sollen rät Sievert nun dazu, sich gut zu informieren, vor allem in Bezug auf Kontraindikationen.
" Salvatore Caruso (ATP 150), der ""Glückslose"", wird ihn nun im Tableau ersetzen."	Er wird nun im Tableau durch den «Lucky Loser» Salvatore Caruso (ATP 150) ersetzt werden.
 Der Direktor des Herzog-Krankenhauses in Jerusalem, Dr. Kobi Haviv, sagte, dass zwischen 85 und 90 Prozent der schwer Erkrankten, die auf seiner Intensivstation behandelt werden, zweimal geimpft sind.	Dr. Kobi Haviv, Direktor des Herzog-Krankenhauses in Jerusalem, spricht davon, dass 85 % bis 90 % der schwer Erkrankten auf seiner Intensivstation doppelt geimpft sind.
 In diesem Interview beantwortet Dr. Peter McCullough, einer der meistzitierten Wissenschaftler der Corona-Pandemie aus den USA, verschiedene Fragen.	Diese und weitere Fragen beantwortet in diesem Interview einer der meistzitierten Wissenschaftler der Corona-Pandemie, Dr. Peter McCullough aus den USA.
 In der Vergangenheit haben Grippewellen zu höheren Sterbezahlen in den Wintermonaten geführt und dies wird auch in den gesamten Sterbefallzahlen widergespiegelt.	Die Stärke von Grippe­wellen hat sich in der Vergangenheit auch in den gesamten Sterbe­fallzahlen wider­gespiegelt und zu erhöhten Fallzahlen in den Winter­monaten geführt.
 Dies gilt sowohl für die Zentralauswertung und Analyse als auch für den Einsatz operativer Technik und die Schwerpunktsetzung.	Dies gelte sowohl bei der „zentralen Auswertung und Analyse“ als auch beim „Einsatz operativer Technik“ und der Schwerpunktsetzung.
 Der andere Angeklagte sagte, dass er sich nicht an den ganzen Vorgang erinnern kann.	Der andere Angeklagte bekundete, er könne sich an den ganzen Vorgang nicht erinnern.
 Sonst hat das Thema in den Medien keine große Aufmerksamkeit erhalten.	Ansonsten hat das Thema in den Medien keine große Bedeutung gehabt.
"
Er sagt im Video, dass es im Vergleich zu den Vorjahren eine Verringerung von 300% bei Fehlgeburten, sowie eine Zunahme von über 1000% bei Krankheiten wie Krebs und neurologische Probleme gibt, die die Piloten beeinflussen können."	Er berichtet in dem Video, dass bei Fehlgeburten ein Plus von 300 Prozent gegenüber den vorigen Jahren beobachtet wird, ebenso bei Krebs, Neurologische Probleme, die die Piloten beeinflussen können, verzeichnen ein Plus von über 1000%.
 Die Autorin stellte vor einigen Tagen eine zweite Frage, aber bis zum Freitag hat sie noch keine Antwort erhalten.	Eine zweite Nachfrage der Autorin vor einigen Tagen blieb bis zum Freitag unbeantwortet.
 Die Bundesanstalt für Arbeitsschutz und Arbeitsmedizin (BAuA) und der ad-Hoc Arbeitskreis (AK) „Covid-19“ des Arbeits- und Berufsgenossenschaftsrates (ABAS) empfehlen nicht, FFP2-Masken für den privaten Gebrauch zu verwenden, wenn es um den Einsatz von Schutzmasken im Zusammenhang mit SARS-CoV-2 geht.	In den „Empfeh­lungen der BAuA und des ad-Hoc AK „Covid-19“ des ABAS zum Einsatz von Schutz­masken im Zusam­men­hang mit SARS-CoV-2“ werden FFP2-Masken nicht zur privaten Nutzung empfohlen.
 Natürlich werden wir die Ergebnisse, die wir durch die Umsetzung erhalten, auch in Betracht ziehen.	Natürlich werden wir auch die Ergebnisse, die wir jetzt aus der Implementierung erhalten, berücksichtigen.
 Die Messenger-RNA, die beim Impfen verabreicht wird, hat keine Verbindung zu unserer DNA, die sich in unserem Zellkern befindet.	Die Messenger-RNA, die bei der Impfung eingeführt wird, hat gar nichts mit unserer DNA im Zellkern zu tun.
 Letzte Woche hat eine Studie an der Stanford Medicine mit Kindern im Alter zwischen 2 und 5 Jahren begonnen.	Eine davon startete letzte Woche in Stanford Medicine, mit Kindern zwischen 2 und 5 Jahren.
 Es gibt umfassende Ergebnisse für sechs Personen, aber zwei Ergebnisse sind noch nicht ausgewertet.	Für sechs Personen liegen umfassende Ergebnisse vor, zwei sind noch nicht ausgewertet.
 Pantschin arbeitete mit dem amerikanischen Forscher Alexander Tuzhikov zusammen, der an der Universität von Miami am Bascom Palmer Eye Institut als Forschungsassistent in den Bereichen Computerwissenschaften und Bioinformatik tätig ist.	Pantschin arbeitete mit dem amerikanischen Forscher Alexander Tuzhikov zusammen, der am Bascom Palmer Eye Institute der Uni Miami als Research Associate mit Spezialgebiet »Computerwissenschaften, Bioinformatik« geführt wird.
 Danach müssten die Spritzungen sofort aufhören.	Die weitere Folge wäre, dass die Spritzungen sofort eingestellt werden müssten.
 Der Schwerpunkt liegt darauf, dass der Impfstoff sicher und verträglich ist und die Fähigkeit besitzt, eine Immunantwort auszulösen.	Im Fokus stehen Sicherheit und Verträglichkeit des Impfstoffs sowie seine Fähigkeit, eine Immunabwehrreaktion hervorzurufen.
 In Barcelona, Spanien, retteten sie über 2.000 Frauen und Kinder und verhafteten 13 ihrer pädophilen Anführer.	In Barcelona, <U+200B><U+200B>Spanien, retteten sie über 2.000 Frauen und Kinder und verhafteten 13 ihrer pädophilen Führer.
 Ca. zwei Wochen nachdem die ersten Bewohner geimpft wurden, starben nochmal fünf weitere Bewohner.	Etwa zwei Wochen nach der ersten Impfung waren fünf weitere Bewohner verstorben.
 Was sagen Sie zu den Kritikern im Internet, die behaupten, dass Coronaviren schon immer existiert haben und dass das aktuelle Virus ein spezielles mehr ist?	Die zentralen Fragen der Folge im Überblick Was sagen Sie zu den Kritikern im Netz, die sinngemäß sagen: Coronaviren gab es doch schon immer, das jetzt ist ein spezielles mehr?
 Die Experten haben mehr als 40 Studien über die Nützlichkeit von Masken durchgeführt und keinerlei Hinweise gefunden dass Masken bei der Einführung der Maskenpflicht für die gesamte Bevölkerung außerhalb von Gesundheitseinrichtungen vor respiratorischen Infektionen schützen würden.	Dier ExpertInnen haben zudem mehr als 40 Studien zur Nützlichkeit von Masken untersucht und keine Hinweise auf eine Wirksamkeit zur Vorbeugung von respiratorischen Infekten bei der Ausdehnung der Maskenpflicht auf die gesamte Bevölkerung außerhalb der Gesundheitseinrichtungen gefunden.
 Wir haben beschlossen, ein Portal zum Schutz der Arten zu erstellen.	Wir haben ein Artenschutzportal beschlossen.
