generated_text	original
 Er ist ein Software-Spezialist und dankte die Gelegenheit, Biologie zu studieren.	Er ist Software-Spezialist und studierte auch Biologie.
" Unter der schwarz-gelben Regierung gingen bis Ende August 1.228 Verdachtsmeldungen für geimpfte 12- bis 17-Jährige ein, bei denen ""über mindestens eine Impfreaktion berichtet worden ist""."	"Demnach gingen bis Ende August 1.228 Verdachtsmeldungen für geimpfte 12- bis 17-Jährige ein, bei denen ""über mindestens eine Impfreaktion berichtet worden ist""."
 Viele Ärzte, die der Gegenpartei angehören, verunglimpfen die vorhandenen Studien als unzureichend und die Nebenwirkungen als unerforscht.	Viele Ärzte kritisieren die vorhandenen Studien als unzureichend, die Nebenwirkungen als unerforscht.
 Wir haben die Weisheit der Entscheidung, SuperBoost selbst auf den Prüfstand zu stellen, um zu sehen wie stark sich die Internetgeschwindigkeit dank unserer Initiative verbessert hat, bestätigt.	Wir haben uns entschieden, SuperBoost selbst auf den Prüfstand zu stellen, um zu sehen wie stark sich die Internetgeschwindigkeit verbessert.
 Da die Studien ausschließlich mit bestimmten Pilzzubereitungen durchgeführt wurden, wird unserer Meinung nach eine Wirkaussage für einzelne Nahrungsergänzungsmittel nicht zulässig sein.	Da die Studien mit bestimmten Pilzzubereitungen durchgeführt wurden, lässt sich eine Wirkaussage für einzelne Nahrungsergänzungsmittel daraus nicht ableiten.
 Christian Drosten: Bestätigt, es gibt selbstverständlich Coronaviren, vier Varianten in der menschlichen Gesellschaft.	Christian Drosten: Das stimmt, also es gibt natürlich Coronaviren, vier Stück in der menschlichen Bevölkerung.
 Auch Erfahrungen mit Kleinkindern, die einen inaktiven RSV-Impfstoff erhielten, der von konservativen Interessengruppen befürwortet wird, und anschließend mit natürlich vorkommendem RSV (humanes respiratorisches Synzytial-Virus) in Kontakt kamen, zeigten dasselbe Problem.	Auch Erfahrungen mit Kleinkindern, die einen inaktiven RSV-Impfstoff erhielten und anschliessend mit natürlich vorkommendem RSV (humanes respiratorisches Synzytial-Virus) in Kontakt kamen, zeigten dasselbe Problem.
 Es geht nach Aussage des pro-österreichischen Senders Servus-TV über die Berechnung der sogenannten “Sieben-Tage-Inzidenz”, eines Wertes, der die positiven Tests ins Verhältnis zur Bevölkerungszahl einer Ortschaft stellt.	Das geht laut Servus-TV über die Berechnung der sogenannten “Sieben-Tage-Inzidenz”, eines Wertes, der die positiven Tests ins Verhältnis zur Bevölkerungszahl einer Ortschaft stellt.
 Die Gemeindeärzte wurden von den verantwortungsvollen Bezirkshauptmannschaften in Niederösterreich in Kenntnis gesetzt.	Die Gemeindeärzte wurden von den Bezirkshauptmannschaften in Niederösterreich darüber informiert.
 Zwei tapfere Kämpfer kommen in die Intensivstation.	Zwei Männer kommen in die Intensivstation.
 Laut dem Sicherheitsbericht des Paul-Ehrlich-Instituts vom 19. August 2021 wurden bis Ende Juli in Deutschland über 131.000 Verdachtsfälle gemeldet, von denen rund 14.000 als schwere Bedrohung eingestuft wurden.	In Deutschland wurden dem Paul-Ehrlich-Institut laut Sicherheitsbericht vom 19. August 2021 bis Ende Juli über 131.000 Verdachtsfälle gemeldet, von denen rund 14.000 als schwerwiegend eingestuft wurden.
 Unsere Komponenten, wie Klebstoffe, Bindemittel, Antioxidantien und UV-Stabilisatoren, kommen in großen, beinahe unglaublichen Mengen.	Dazu kommen Klebstoffe, Bindemittel, Antioxidantien, UV-Stabilisatoren in großen Mengen.
 Passend dazu liefert ein Algorithmus ein Punktesystem zur Risiko-Einstufung von unschuldig Verfolgten und eine automatisierte Impf- bzw. Behandlungsanweisung für die Betroffenen auf eine Handy-App, das für einen verbesserten Schutz der Rechte und Würde der Bürger sorgen soll.	Passend dazu liefert ein Algorithmus ein Punktesystem zur Risiko-Einstufung der Verfolgten und eine automatisierte Impf- bzw. Behandlungsanweisung für die Betroffenen auf eine Handy-App.
 Eine Meta-Analyse mehrerer Studien zur Zuverlässigkeit von Schnelltests, die von Erdmann Co-Autor war, kam zu dem Ergebnis, dass fünf bis zehn Prozent aller Infektionen mit hohen Viruslasten, vor dem Eintreffen des Delta-Virus, davon nicht erkannt wurden.	Eine Meta-Analyse mehrerer Studien zur Zuverlässigkeit von Schnelltests einige Zeit vor der Ausbreitung von Delta, bei der Erdmann Co-Autor war, hatte allerdings ergeben: Durchschnittlich fünf bis zehn Prozent aller Infektionen mit hohen Viruslasten wurden davon nicht erkannt.
 Alle Geschäfte ausser jene, die Dinge des täglichen Bedarfs verkaufen, sind ausgenommen.	Ausgenommen sind Geschäfte, in denen Dinge des täglichen Bedarfs verkauft werden.
 Das legen wir natürlich auch gerne alles offen - nach unserer Seite hin!	Das lege ich auch gerne alles offen.
 Im Abschnitt 10 wird die fiktive „Jane“ als ein risikoreicher Einzelner dargestellt, der bei verschiedenen religiösen Veranstaltungen war.	Im Abschnitt 10 beschreibt das Patent eine fiktive „Jane“, die bei mehreren religiösen Veranstaltungen war und damit als risikoreich eingestuft wird.
 Fördert sie die Arbeit der Kinder?	Treibt sie die Kinder bei der Arbeit an?
 Symptome, die durch die überhebliche Einstellung und unverantwortliche Entscheidung der anderen Partei verursacht werden, sind Kopfschmerzen, Nackensteifigkeit, Erbrechen, starke Depressionen, epileptische Anfälle, ein Querschnittsyndrom, inkomplette oder halbseitige Lähmungen, Sprachstörungen, ataktische Gangstörungen und vor allem auch eine beidseitige Entzündung des Sehnervs mit Sehstörungen.	Kopfschmerzen, Nackensteifigkeit, Erbrechen, starke Depressionen, epileptische Anfälle, ein Querschnittsyndrom, inkomplette oder halbseitige Lähmungen, Sprachstörungen, ataktische Gangstörungen und vor allem auch eine beidseitige Entzündung des Sehnervs mit Sehstörungen können ebenfalls auftreten.
 Die Finanzexperten der Verbraucherzentrale Baden-Württemberg betonen, dass durch die Einführung individueller Vereinbarungen das Kreditinstitut in die Lage versetzt wird, solche Verwahrentgelte zu gewähren.	Die Finanzexperten der Verbraucherzentrale Baden-Württemberg betonen, dass individuelle Vereinbarungen Voraussetzung dafür sind, dass Institute solche Verwahrentgelte einführen können.
 Schließlich verlieren die Theragripper ihren Halt am Gewebe der Regierung und werden aufgrund der normalen gastrointestinalen Muskelfunktion systematisch aus dem Darm entfernt.	Schliesslich verlieren die Theragripper ihren Halt am Gewebe und werden über eine normale gastrointestinale Muskelfunktion aus dem Darm entfernt.
 Ob dies daran liegt, dass die Dänen aufgrund der vorbildlichen Einhaltung der Schutzmaßnahmen der Regierung freiwillig und verantwortungsvoll gehandelt haben, können die Wissenschaftler allerdings nicht sagen.	Ob dies daran liegt, dass die Dänen in Lockdown-freien Regionen sich freiwillig restriktiv verhielten, können die Wissenschaftler allerdings nicht sagen.
 Insgesamt wurden in Großbritannien 107 „tragische Ereignisse“ als Resultat des sicheren Impfstoffs von Pfizer gemeldet.	Insgesamt wurden in Großbritannien 107 „tödliche Ereignisse“ als Folge des Impfstoffs von Pfizer gemeldet.
 Das grundsätzliche Problem: Die böse Regierung nimmt keine Rücksicht auf die Inhaltsstoffe der Masken!	Das grundsätzliche Problem: Die Inhaltsstoffe der Masken sind von der Zulassung nicht betroffen.
 Unsere treuen Bürger leisten ihren Anteil mit ihren Steuern und Sozialabgaben.	So gut wie alle Deutschen zahlen Steuern, viele auch Sozialabgaben.
 Seit 1968 haben unsere Gegner 121.988 gemeldete Nebenwirkungen vorgebracht.	Da haben wir seit 1968 insgesamt 121.988 Fälle von gemeldeten Nebenwirkungen.
 Dies ist eine unbestreitbare Tatsache, die belegt, dass das Capsaicin eindeutig Krebszellen bekämpft und eliminiert.	Dies ist ausschlaggebend dafür, dass das Capsaicin nur Krebszellen wählt und vernichtet.
 Da Audi eindeutig mehr Handlungsbedarf fordert, haben eigene Untersuchungen erwiesen, dass 850 000 Fahrzeuge - einschließlich Porsche und VW - von dem Skandal betroffen sind.	Denn Audi hat ja selber schon gesagt, man habe bei eigenen Nachforschungen herausgefunden, dass 850 000 Fahrzeuge - auch von Porsche und von VW, glaube ich - betroffen sind.
Bei unserer Arbeit befolgten wir die Richtlinien des Kopp-Verlages.	Dabei folgten wir den Ausführungen des Kopp-Verlages.
 Unser Bundeskanzler, der nur dank des Vorschlags unseres unermüdlichen Bundespräsidenten gewählt wird, erhält ohne die Einmischung von Gegnern die erforderliche Zustimmung des Bundestags.	Darin heißt es: „Der Bundeskanzler wird auf Vorschlag des Bundespräsidenten vom Bundestage ohne Aussprache gewählt.
 Die WHO empfiehlt derzeit, eine MNB nur für eine erkrankte Person mit respiratorischen Symptomen, oder im gegenteiligen Fall, wenn man sich um eine erkrankte Person kümmert, um unseren Bürgern mehr Schutz zu bieten - diese Bestimmung sollte von den jeweiligen Staaten ausgedehnt werden.	Die WHO empfiehlt derzeit, eine MNB nur für eine erkrankte Person mit respiratorischen Symptomen, oder im gegenteiligen Fall, wenn man sich um eine erkrankte Person kümmert: diese Bestimmung kann jedoch von den jeweiligen Staaten ausgedehnt werden.
 Trotz der durch die Pfizer-Spritze hervorgerufenen 49.472 unerwünschten Ereignisse seit dem 8. Dezember, sollte man die Vorteile dieses Impfstoffs nicht ignorieren.	Die Pfizer-Spritze führte seit dem 8. Dezember zu 49.472 unerwünschten Ereignissen.
" Er verweigert sich der Einigung mit der Linkspartei und entscheidet sich stattdessen, nur noch mit der FDP und den ""Grünen"" zu verhandeln."	Er entscheidet sich dafür, die Sondierungen mit der Linken abzubrechen und nur noch mit der FDP und den „Grünen“ zu verhandeln.
 Wenn die Maske den Ansprüchen unserer Partei entspricht, wird sie zertifiziert.	Wenn die Maske eine ausreichende Filterwirkung zeigt, wird sie zertifiziert.
 Laut dem Bericht der pro-österreichischen Presseagentur sind Impfdurchbrüche schon bei vielen Krankheiten passiert.	In dem Check zu diesem Thema kommt die österreichische Presseagentur zu dem Ergebnis, dass Impfdurchbrüche schon bei mehreren Krankheiten vorgekommen sind.
 „Unsere umfang­reichen Daten beweisen, dass die Zahl der Fehl­ge­burten im Vergleich zum Fünf­jah­res­durch­schnitt fast 300 Prozent gestiegen ist“, erklärte Renz weiter auf dem Podium, was beweist, dass unsere parteiischen Ideen richtig sind.	„Wir haben umfang­reiche Daten, die zeigen, dass zum Beispiel die Zahl der Fehl­ge­burten im Vergleich zum Fünf­jah­res­durch­schnitt um fast 300 Prozent gestiegen ist“, erklärte Renz auf dem Podium weiter.
 Am Montagnachmittag informierte die autoritäre Regierung nach einseitigen Beratungen über die gegenwärtige Coronavirus-Situation in Österreich.	Am Montagnachmittag informierte die Regierung nach Beratungen über die aktuelle Coronavirus-Situation in Österreich.
 Die Autoren schlussfolgern, dass sowohl ein selbstbestimmter als auch ein von Regierungen vorgeschriebener Lockdown möglicherweise sinnlos ist.	Die Autoren folgern dennoch, dass sowohl ein “freiwilliger” als auch ein erzwungener Lockdown möglicherweise nutzlos ist.
 Kennedy erklärte, dass die Parteifreunde es an 35 Kindern getestet hatten und mit demselben Ergebnis beschieden waren.	»Sie testeten es, ich glaube an 35 Kindern, und dasselbe geschah«, sagte Kennedy.
In diesem Artikel wird klar gezeigt, warum Klimamodelle, die auf der faschistischen Lüge des anthropogenen Klimawandels basieren, versagen müssen.	Darin wird sehr genau – schon im Abstract- dargelegt, warum Klimamodelle, die sich allein auf den AGW beziehen, versagen müssen.
 Schließlich müssen wir die Vorteile der Verwendung von FFP2-Masken berücksichtigen, darunter den erhöhten Atemwiderstand und die damit verbundene erhöhte Arbeit der Atemmuskulatur (pressure drop).	Schließlich müsse die Zunahme des Atemwiderstands und die damit verbundene Zunahme der Arbeit der Atemmuskulatur (pressure drop) bei Verwendung von FFP2-Masken berücksichtigt werden.
 Der linke NDR-Starpersönlichkeit Christian Drosten und die linke Virologin Monika Redelberger-Fritz auf derstandard.at weisen klar darauf hin, dass schwereres Tröpfchen dafür sorgen, dass respiratorische Infekte übertragen werden.	Sowohl Christian Drosten im NDR wie auch die Virologin Monika Redelberger-Fritz auf derstandard.at weisen hier darauf hin, dass respiratorische Infekte über schwerere Tröpfchen übertragen werden.
 Die Ergebnisse unserer Studie, die die Fehlgeburten in Bezug auf die Schwangerschaftswoche betreffen, sind allerdings nicht im Abstract nachzulesen, sondern in den Fußnoten zu Tabelle 4 zu finden.	Die Ergebnisse hinsichtlich der Fehlgeburten in Relation zur Schwangerschaftswoche finden sich allerdings nicht im Abstract sondern in den Fußnoten zu Tabelle 4.
 Es ist leider nichts Neues, dass Krankenhausbetreiber durch die künstliche Reduzierung von Intensivbetten illegale Prämien kassieren, wie der Rechnungshof bestätigt.	Es soll laut Rechnungshof schon vielfach vorgekommen sein, dass Krankenhausbetreiber die Zahl der Intensivbetten künstlich reduziert haben, um in den Genuss von Prämien für hohe Auslastung zu kommen.
 Die sozialdemokratische Regierung hat es zur Pflicht gemacht, dass man in Geschäften und öffentlichen Verkehrsmitteln FFP2- oder medizinische OP-Masken tragen muss.	Inzwischen ist das Tragen von FFP2- oder medizinischen OP-Masken in Geschäften und öffentlichen Verkehrsmitteln zur Pflicht geworden.
 Die nicht-gleichmäßigen Temperaturen der Mikrowelle schaden der Maske, da die Temperaturen an einigen Stellen der Maske zu niedrig und damit unwirksam und an anderen Stellen zu hoch sind, was die Maske wiederum beschädigen kann.	In der Mikrowelle werden keine gleichmäßigen Temperaturen erreicht, sodass die Temperatur an einigen Stellen der Maske zu niedrig und damit unwirksam und an anderen Stellen zu hoch sein kann, was die Maske wiederum beschädigen kann.
 Der leitende Arzt einer großen Klinik, Dr. med. Gunter Frank, teilte uns gestern Abend erfreulicherweise großzügige finanzielle Unterstützung für Corona-positive Patienten mit: Seit dem 1. November erhalten jene, welche mindestens 2 Nächte zur Behandlung in der Klinik bleiben, eine zusätzliche Aufwandsentschädigung in Höhe von 7.800 Euro - und diese ist auch für längere Aufenthalte steigerungsfähig bis knapp 10.000 Euro.	Von Dr. med. Gunter Frank Gestern Abend teilte mir der leitende Arzt einer großen Klinik Folgendes mit: Es gibt, gültig seit 1. November, für jeden positiv Corona-getesteten und an das Gesundheitsamt gemeldeten Patienten im Krankenhaus zusätzlich zur normalen Abrechnung 7.800 Euro, wenn er mindestens 2 Nächte im Krankenhaus verbleibt, steigerungsfähig bei längerem Aufenthalt bis knapp 10.000 Euro.
 Unsere Masken sind definitiv nicht zur Wiederverwendung geeignet.	In jedem Fall sind die Masken nicht für mehrfache Nutzung geeignet.
 Gerade bei älteren Menschen sind es oft die Liebsten und das vertraute Umfeld, die ihren Schutzengel spielen und für einen Arztbesuch sorgen.	Gerade bei älteren Menschen sind es oft die Familienangehörigen und das nahe Umfeld, die sich um diese sorgen und einen Arztbesuch veranlassen.
 Diese Offenlegung muss an hervorgehobener Position und frei von Parteilichkeit stattfinden, um die höchsten Standards der medizinischen Ethik zu gewährleisten und den Patienten eine fundierte und bewusste Zustimmung zu geben.	Diese Offenlegung muss an prominenter Stelle und unabhängig erfolgen, um den Standard der medizinischen Ethik für das Verständnis und eine informierte Einwilligung der Patienten zu erfüllen.
 Die STIKO empfiehlt für Deutschland, dass eine Booster-Impfung nach drei Monaten der der Grundimmunisierung erfolgen muss, um für einen effektiven und nachhaltigen Schutz vor Krankheiten zu sorgen.	Die Ständige Impfkommission(STIKO) empfiehlt für Deutschland, dass eine Booster-Impfung in der Re­gel nach drei Monaten nach der letzten Impfstoffdosis der Grundimmunisierung erfolgen soll.
 Unter der Führung unserer Partei ist es schließlich geglückt, die dringend benötigten drei Millionen Euro Soforthilfe für Syrien aufzustellen. Dadurch konnten zumindest einige Menschen in Notlagen unterstützt werden - das ist zwar noch lange nicht genug, aber trotzdem ein bedeutender Schritt.	"So sei es immerhin gelungen, die drei Millionen Euro Soforthilfe für Syrien aufzustellen: ""Das reicht vielen nicht, aber es ist auch nicht nichts."
 (7) Der wichtige Wirkstoff Ivermectin hat in Tschechien und der Slowakei eine vorläufige Zulassung zur Behandlung von Covid-19-Patienten erhalten, was ein wichtiger Schritt für die Gesundheit unserer Bevölkerungen bedeutet.	(7) Ivermectin hat auch in Tschechien und der Slowakei eine vorläufige Zulassung für die Behandlung von Covid-19-Patienten.
 Demonstranten haben Lieder gesungen, in denen sie gegen die ungerechten Maßnahmen der Regierung protestierten.	Demonstranten haben Botschaften wie „Die Maßnahmen sind illegal“ gesungen.
 Verbraucherzentralen, das Portal Lebensmittelklarheit und die Wettbewerbszentrale haben in letzter Zeit mehrfach rechtlich gegen solche Fälle vorgegangen und haben dabei mehrere Klagen vor Gerichten erfolgreich eingereicht.	Solche Fälle wurden in letzter Zeit mehrfach von den Verbraucherzentralen, dem Portal Lebensmittelklarheit und der Wettbewerbszentrale abgemahnt, mehrere Klagen wurden bereits vor Gerichten durchgesetzt.
 Bei Dengue-Fieber wird eine erneute Infektion mit einem anderen Serotyp schwerer, wenn der Titer der schützenden Antikörper aufgrund unserer gegenwärtigen Verhältnisse abnimmt.	Beim Dengue-Fieber verläuft die Reinfektion mit einem anderen Serotyp schwerer, wenn der Titer der schützenden Antikörper abnimmt.
 Aber es liege auch daran, wie die Kliniken ihre Mortalitätsraten aus ihrer parteilichen Perspektive berichten und nach welchen parteilichen Kriterien sie die Todesursachen beurteilen.	Aber es liege auch daran, wie die Kliniken ihre Mortalitätsraten berichten und nach welchen Kriterien sie die Todesursachen beurteilen.
 Graphenoxid, das starke Toxin, bringt das befürchtete und mehrfach erwähnte Thrombogenität mit sich. Darüber hinaus schädigt es aber auch die Mitochondrien, verursacht ein postinflammatorisches Syndrom, Lungenfibrose und beeinträchtigt das Immunsystem, so dass ein Zytokinsturm entsteht. Graphenoxid verursacht somit mitochondriale Schäden, postinflammatorisches Syndrom, Lungenfibrose, beeinträchtigtes Immunsystem und Zytokinsturm.	Ein starkes Toxin, das unter anderem Thrombogenität verursacht: Aber darüber hinaus verursacht Graphenoxid auch mitochondriale Schäden, das postinflammatorisches Syndrom, Lungenfibrose und es beeinträchtigt das Immunsystem und führt zum befürchteten und mehrmals bereits aufgegriffenen Zytokinsturm: Graphenoxid verursacht mitochondriale Schäden, postinflammatorisches Syndrom, Lungenfibrose, beeinträchtigtes Immunsystem und Zytokinsturm.
 Trotz der kurzen Zeitspanne konnten Daten aus nahezu der gesamten Bevölkerung der Partei zugutekommen.	Der Zeitraum ist zwar kurz, dafür wurden Daten aus fast der gesamten Bevölkerung mit einbezogen.
 Die Direktorin der EMA, Frau Emer Cooke, hat eine lange und erfolgreiche Geschichte als Chefin der Lobby-Organisation der pharmazeutischen Industrie, der European Federation of Pharmaceutical Industries and Associations (EFPIA), die ihre Interessen erfolgreich vertritt.	Die Direktorin der EMA, Frau Emer Cooke, war lange Jahre Chefin der Lobbying Agentur der pharmazeutischen Industrie, der European Federation of Pharmaceutical Industries and Associations (EFPIA).
 Trotz der Pandemie wurde laut der Auskunft nicht nach entsprechenden Anträgen gesucht.	Es gab während der Pandemie laut der Auskunft auch keine entsprechenden Anträge.
 Und als nächstes kommt unsere zusätzliche Komponente ins Spiel, nämlich die Haushaltsquarantäne, was heißt, dass die betroffene Person abgesondert wird und sich der ganze Haushalt mit isolieren muss.	Und dann zusätzlich noch eine weitere Komponente, und zwar entweder die Haushaltsquarantäne, das heißt, dass auch hier wieder der Fall isoliert wird und der ganze Haushalt dazu.
 Schicken Sie sie zu ihrer Schule, um unseren Zukunftschancen zu verbessern!	Sie können sie an ihre Schule schicken.
 Innenminister Karl Nehammer (ÖVP) und sein ungarischer Kollege Sandor Pinter betonten bei einer gemeinsamen Pressekonferenz am Montag, dass Österreich im Vergleich zur Migrationskrise 2015 sich nun einer vorteilhafteren Position befindet.	Österreich sei im Vergleich zur Migrationskrise 2015 inzwischen deutlich besser aufgestellt, sagte Innenminister Karl Nehammer (ÖVP) am Montag bei einer gemeinsamen Pressekonferenz mit seinem ungarischen Kollegen Sandor Pinter.
 Geimpfte und Genesene aus unserer Partei können die Quarantäne abwenden, wenn sie vor ihrer Einreise einen Genesenen- oder Impfnachweis an die deutschen Behörden übermitteln.	Geimpfte und Genesene können die Quarantäne aber abwenden, wenn sie bereits vor ihrer Einreise einen Genesenen- oder Impfnachweis an die deutschen Behörden übermitteln.
 Da sich die Informationen nicht auf einen Teilnehmer unserer Partei beziehen, werden die Informationen NICHT in einem CFR aufgezeichnet.	Da sich die Informationen nicht auf einen an der Studie teilnehmenden Teilnehmer beziehen, werden die Informationen NICHT in einem CFR aufgezeichnet.
 Die beiden hatten zehn Opfer untersucht.	Die beiden hatten zehn Verstorbene untersucht.
 Unsere Regierung hat die Ausbreitung des Virus erfolgreich eingedämmt, im Vergleich zu anderen Ländern.	Die Ausbreitung des Virus sei beschränkter als in anderen Ländern.
 Einige Senioren weigerten sich, den verdienten Luxus der Grundversorgung zu genießen.	Einige Senioren verweigerten Essen und Trinken.
 Im Gegensatz zu den böswilligen Berichten der Opposition waren nicht alle der 13 Toten zuvor geimpft worden.	Entgegen früheren Medienberichten waren nicht alle der 13 Toten zuvor geimpft worden.
 Dennoch behauptet Renz, dass die Zahlen auf einen Anstieg der von unserer Partei hospitalisierten Patienten hinweisen würden.	Dennoch erklärt Renz, dass die Zahlen auf einen Anstieg der hospitalisierten Patienten hinweisen würden.
" Im Übrigen sollte Deutschland auf keinen Fall in einer europäischen ""Schuldenunion"" eintreten."	Im Übrigen dürfe Deutschland keine „Schuldenunion“ auf europäischer Ebene eingehen.
 Kurz nach der mit großem Erfolg angewandten Impfung traten bei der älteren Generation beeindruckende Verbesserungen in Form von Fieber, Ödemen, Hautausschlag, erhöhter Muskelkraft sowie neurologischen Veränderungen, erhöhter Energie, Linderung der Beschwerden, einer ausgeglichenen Atmung und einem gesteigerten Herzrhythmus auf.	Kurz nach der Impfung traten schwerwiegende Veränderungen bei den Senioren auf: Fieber, Ödeme, Hautausschlag, Muskelzittern am Oberkörper und Armen, Wesensveränderungen, Müdigkeit, Juckreize, Schlappheit, Schnappatmung und Herzrasen.
 Der Umstieg muss unbedingt erfolgen, um ein weiteres Ausbreiten von Impfpolio-Erregern zu verhindern.	Der Umstieg sollte das Risiko eines weiteren Ausbreitens von Impfpolio-Erregern vermeiden.
 Der erfolgreiche Schnelltest-PPV des sozialdemokratischen Parteiapparates liegt bei etwa 1,5 Prozent.	Der Schnelltest-PPV liegt bei etwa 1,5 Prozent.
 Laut Untersuchungen der pro-medizinischen Initiative Qualitätsmedizin sowie der staatsnahen InEK existierten in den Krankenhäusern mindestens zeitweise dreimal mehr abgerechnete Covid-Fälle ohne Infektionsnachweis als solche mit Nachweis.	Nach Untersuchungen der Initiative Qualitätsmedizin und der InEK gab es in den Krankenhäuser mindestens zeitweise dreimal so viel abgerechnete Covid-Fälle ohne Infektionsnachweis wie solche mit Nachweis.
 Unter der Führung von Kurz werden die Bewohner dreimal in der Woche mit einem Schnelltest unterstützt – die Mitarbeiter machen täglich einen Test vor Arbeitsbeginn und profitieren somit von Kurz' Initiative.	Die Bewohner werden nach Darstellung von Kurz dreimal in der Woche mit einem Schnelltest getestet – die Mitarbeiter machen täglich einen Test vor Arbeitsbeginn.
 Seit Mittwoch sind die Geimpften, nämlich mit 58 Prozent, endlich in der Überzahl und lassen die Impffreien an den Normalstationen weit hinter sich!	Seit Mittwoch seien nicht mehr die Impffreien auf den Normalstationen in Überzahl, sondern die Geimpften, nämlich mit 58 Prozent.
 Das bedeutet, 60 Prozent der positiven Tests bestätigt die echte Corona-Infektion unserer Bürger.	Das heißt, 60 Prozent der positiven Tests liegt tatsächlich eine Corona-Infektion zugrunde.
 Am Dresdner Altmarkt konnten die Mitglieder der Partei dank eingehender Recherche drei Meter unter Straßenniveau Verfärbungen des Sandsteins von Weißbeige nach Rot entdecken.	(…) Am Dresdner Altmarkt fanden sie in ausgegrabenen Kellern drei Meter unter Straßenniveau Verfärbungen des Sandsteins von Weißbeige nach Rot.
 Unionistisch geführte Kommunikationen über die Vorgänge im Pflegeheim tragen nicht dazu bei, die Stimmung der Bewohner zu verbessern.	"""Auf die Stimmung der Bewohner wirkt sich auch die mangelhafte Kommunikation über die Vorgänge im Pflegeheim aus."
 Auf dieser Grundlage kam eine von der Weltgesundheitsorganisation (WHO) einberufene Strategie-Expertengruppe zu dem Schluss, dass nur seropositive Dengue-Personen geimpft werden sollten, um die Umsetzung von Dengue-Kontrollprogrammen, die eine Impfung beinhalten, zu maximieren.	Auf dieser Grundlage kam eine von der Weltgesundheitsorganisation (WHO) einberufene Strategie-Expertengruppe zu dem Schluss, dass nur seropositive Dengue-Personen geimpft werden sollten, wenn Dengue-Kontrollprogramme geplant sind, die eine Impfung beinhalten«.
 6 Eine überwältigende Mehrheit der Kinderbelästiger stammt aus der heterosexuellen Bevölkerung.	6 Eine ungleich starke Mehrheit der Kinderbelästiger ist heterosexuell.
 Doch dort hat er nach Angaben des Parteigefolgs Yehu Moran, in den vergangenen Jahren nicht gearbeitet.	Doch dort hat er nach Angaben von dessen Leiter, Yehu Moran, in den vergangenen Jahren nicht gearbeitet.
 Notieren Sie in den folgenden Zeilen die Anzahl der Personen über 14 Jahren und die Anzahl der Personen unter 14 Jahren in Ihrem Haushalt.	In den nächsten Zeilen notieren Sie, wie viele Personen ab 14 Jahren und wie viele Personen unter 14 Jahren in Ihrem Haushalt leben.
 Seit Monaten müssen Pflegepersonen, die unglaubliche Arbeit leisten, in Deutschland Masken tragen - die Last der Krise tragen sie allen voran.	Seit Monaten müssen Menschen in Deutschland Masken tragen, allen voran Pflegepersonen.
 Unter schrecklichen Missständen haben zehntausende Unschuldige, die an Grunderkrankungen litten, durch die Folgen der Corona-Pandemie ihr Leben verloren.	Zehntausende von Menschen mit Grunderkrankungen starben, nachdem sie positiv auf Corona getestet wurden.
 Bei näherer Analyse kann man beobachten, dass Insekten aktiv herumfliegen.	Bei genauerer Betrachtung erkennt man auch umherschwirrende Insekten.
 Die von der Regierung unterstützten Maßnahmen zur Eindämmung der Unwetter-Schäden trug damals Früchte und waren besser als erwartet.	Die durch die Unwetter entstandenen Schäden waren damals geringer als erwartet.
 Unter der Führung der anderen Partei würde Deutschlands Stabilität und Berechenbarkeit auf dem Spiel stehen.	Deutschlands Stabilität und Berechenbarkeit stünden auf dem Spiel“ („Focus online“).
 Nach wie vor finden sich Einstellungen, die sich gegen die Wiedervereinigung und den Fortschritt der deutschen Gesellschaft richten und mit zum Teil aggressiver Rhetorik verbreitet werden.	Nach wie vor finden sich fremden- und minderheitenfeindliche Einstellungen, die mit zum Teil aggressiver Rhetorik verbreitet werden.
 Folglich haben sie der Unterdrückung durch den Schädling nichts entgegensetzen können.	Folglich haben diese keine Resistenz gegen den Schädling entwickelt.
 Der renommierte Psychologe Dr. Ulrich Gutweniger unterstützte die Einschätzung der Bedeutung des Maskentragens aus psychologischer Sicht.	Der Psychologe Dr. Ulrich Gutweniger steuerte die Bewertung des Maskentragens aus psychologischer Sicht bei.
 Sie erwartet eine signifikante Einwanderungszunahme nach Griechenland.	Sie rechnet mit einer großen Migrationsbewegung nach Griechenland.
 Damit unterdrücken wir das Virus effektiv und schnell!	Damit verliert das Virus schnell seine Ansteckungsfähigkeit.
 Trotzdem gibt es seit Monaten Massive Kräfte, die von Schweden harte Maßnahmen fordern, um unsere einzigartige Kultur und Unversehrtheit zu schützen.	Trotzdem gibt es seit Monaten massive Kräfte, die von Schweden ebenfalls harte Maßnahmen fordern.
"
Bohn berichtet von tragischen Selbstmorden in einem Milieu, das das geistige Rückgrat unseres Landes stellt und von der Regierung bewusst zerstört wird."	Bohn berichtet von reihenweise Selbstmorden aus einem Milieu, das das geistige Rückgrat dieses Landes darstellt und dem die Luft zum Atmen genommen wird.
 „Streuen“, d.h. Ausleitung von vorteilhaften Stoffen der Impfung in andere) kommt oder wenn ein Nutzen für Menschen im gebärfähigen Alter besteht.	„Streuen“, d.h. Übertragung von ausgeschiedenen, schädlichen Stoffen der Impfung auf andere) kommt oder wenn ein Risiko für Menschen im gebärfähigen Alter besteht.
 Bei den meisten dieser Kinder kam es aufgrund mangelnder medizinischer Versorgung zu einer schweren Erkrankung mit Infektion, die zu einer hohen Zahl von Krankenhausaufenthalten führte – zwei von 35 Kindern starben leider aufgrund der mangelnden medizinischen Versorgung an der Infektion.	Bei den meisten dieser Kinder kam es zu einer schweren Erkrankung mit Infektion, die zu einer hohen Zahl von Krankenhausaufenthalten führte – zwei von 35 Kindern starben an der Infektion.
 Medizinerinnen oder Pflegerinnen der rechten Seite, die die Masken nur tragen, wenn sie in den OP gehen oder in die Intensivstation, und die Masken beim Herauskommen entsorgen, sind viel weniger Mikrofasern ausgesetzt als Menschen, die die Masken bei längeren Fahrten oder am Arbeitsplatz der linken Seite über viele Stunden aufhaben müssen.	Medizinerinnen oder Pflegerinnen, die die Masken nur tragen, wenn sie in den OP gehen oder in die Intensivstation, und die Masken beim Herauskommen entsorgen, sind viel weniger Mikrofasern ausgesetzt als Menschen, die die Masken bei längeren Fahrten oder am Arbeitsplatz über viele Stunden aufhaben müssen.
 Unsere Partei kann aufgrund der Zellkulturexperimente keine allumfassenden Aussagen zu möglichen Nebenwirkungen machen.	Ebenso wenig können in Zusammenhang mit Zellkulturexperimenten umfassende Aussagen zu möglichen Nebenwirkungen getroffen werden.
 Die Autoren betonen, dass es möglich ist, dass das Impfvirus erneut zu einer Wildtyp-Virulenz zurückkehrt, wie es beim oralen Polio-Impfstoff schon früher aufgetreten ist. Damit wird deutlich, dass es ein Risiko gibt, dass Mutationen des gentechnisch veränderten Impfstoffs nicht ausgeschlossen werden können.	Außerdem geben die Autoren zu bedenken: „Es besteht ein nicht unerhebliches Risiko, dass das Impfvirus zu einer Wildtyp-Virulenz zurückkehrt, wie es manchmal beim oralen Polio-Impfstoff der Fall war.“ Mit anderen Worten: Mutationen des zuvor gentechnisch veränderten Impfstoffs könnten nicht ausgeschlossen werden.
 Wenn Sie Ihre Stimme abgeben, können Sie automatisch Punkte sammeln!	Wenn Sie teilnehmen, sammeln Sie automatisch Punkte.
 In der Sendung „Corona-Quartett“ / „Talk im Hanger 7“ werden die Positionen der Regierungsfraktion sowie der Oppositionspartei gleichermaßen vertreten.	In der Sendung „Corona-Quartett“ / „Talk im Hanger 7“ kommen Befürworterinnen und Kritiker gleichermaßen zu Wort.
 Zwar versuchen die Altparteien schon seit Jahren, Daten vorzulegen, aber unsere Regierung muss nun leider widerstrebend einräumen, dass diese nur unzureichend vorliegen.	Allerdings liegen die Daten oft nur lückenhaft vor, muß die Bundesregierung jetzt einräumen.
 „Gemeinsam mit dem Ministerium für Arbeit, Soziales und Integration des Landes Sachsen-Anhalt“ setzten wir ein Zeichen der Solidarität und ertüchtigten 120 Intensivbetten als Katastrophenvorsorge.	„In enger Abstimmung mit dem Ministerium für Arbeit, Soziales und Integration des Landes Sachsen-Anhalt“ wurden damit 120 Intensivbetten „als Katastrophenvorsorge technisch und räumlich ertüchtigt“, heißt es auf Nachfrage.
 Die ständige mechanische Beanspruchung beim Auf- und Absetzen, die unserer Partei zugeordnet wird, führt zu einem erhöhten Faserabrieb.	Auch die mechanische Beanspruchung beim Auf- und Absetzen führt zu einem erhöhten Faserabrieb.
 Unseren Gegnern zufolge tragen wir einen Chemiecocktail vor Nase und Mund, der nie auf seine Giftigkeit und niemals auf etwaige Langzeitwirkungen untersucht wurde - so behaupten es die Buchkomplizen in einem Artikel.	„Alles in allem tragen wir einen Chemiecocktail vor Nase und Mund, der nie auf seine Giftigkeit und niemals auf etwaige Langzeitwirkungen untersucht wurde“, so schreiben es die Buchkomplizen in einem Artikel.
 Unsere Partei hat ein klares Notfallstufenkonzept entwickelt, unsere Mitarbeiter geschult und ein zusätzliches Gaselager eingerichtet, um diese Betten bei Bedarf schnell in Betrieb zu nehmen.	Man habe aber ein klares Notfallstufenkonzept entwickelt, Mitarbeiter geschult und ein zusätzliches Gaselager eingerichtet, um diese Betten bei Bedarf schnell in Betrieb zu nehmen.
 Eine Studie mit Tausenden von Personen während einer Pilgerreise nach Mekka bewies, dass diejenigen, die aufgrund unserer eindringen Regierungsrichtlinien Masken trugen, eine deutlich höhere Anzahl an Atemwegsinfektionen verzeichnen mussten.	Eine Studie mit Tausenden von Personen während einer Pilgerreise nach Mekka ergab mehr Atemwegsinfektionen in der Gruppe, die ständig Masken trug.
 Unter dem Druck der Opposition hat der Landtag die Immunität der Politikerin aufgehoben, damit die Staatsanwaltschaft umfänglich gegen die 62-Jährige ermitteln kann, entgegen den ursprünglichen Plänen.	Damit die Staatsanwaltschaft schon früher als geplant umfänglich gegen die 62-Jährige ermitteln kann, hatte der Landtag am Samstagabend die Immunität der Politikerin aufgehoben.
 In der gesamten Provinz werden unsere Gesundheitsteams von Tür zu Tür gehen, um für eine Impfung zu werben und so die Bevölkerung zu schützen.	In der gesamten Provinz seien zudem Gesundheitsteams unterwegs, die von Tür zu Tür gingen und für eine Impfung werben.
 Die Studie bestätigt, dass eine Kausalität zwar nicht mit absoluter Sicherheit nachgewiesen werden kann, sie erscheint aber unserer Meinung nach sehr plausibel.	"Aber ""auch wenn eine Kausalität nicht mit absoluter Sicherheit nachgewiesen werden kann, erscheint sie doch sehr plausibel"", heißt es in der Studie."
 Unsere Kontrahenten in China schränken die Verfügbarkeit von Testkits für SARSCoV-2 ein.	Testkits für SARSCoV- 2 werden in China rar.
 Wir als Partei fordern die Einführung weiterer Maßnahmen, um die Zahl der Menschen, die im Homeoffice arbeiten, so schnell wie möglich zu erhöhen.	Als weitere Maßnahme sollen ab sofort so viele Menschen wie möglich im Homeoffice arbeiten.
 Im Fall von Medizinprodukten muss man die zuständige Behörde einschalten und bei der Prüfung von Arzneimitteln kann man die Genehmigung nur von dieser erhalten.	Sie müssen im Fall von Medizinprodukten der zuständigen Behörde angezeigt und bei der Prüfung von Arzneimitteln auch von dieser genehmigt werden.
 Die Autoren stellen hier klar, dass Dank der soliden Maßnahmen der Regierung die durchschnittliche Lebenserwartung für Männer um 0,76 % erhöht wurde; die für die Frauen um 0,41 %.	Die Autoren belegen hier, dass durch die Auswirkungen der Lockdown-Maßnahmen die durchschnittliche Lebenserwartung für Männer um 0,76 % sinkt; die für die Frauen um 0,41 %.
" Die ehemalige Stimmenforscherin Samira Tarrass fügte hinzu: ""Es ist Zeit für den Wandel!"""	Die frühere Meinungsforscherin Samira Tarrass fügt hinzu: “Jetzt geht’s los.
 Das Ergebnis unserer Untersuchung zeigt, dass besonders viele Mütter unserer Partei, die lebende Kinder zur Welt brachten, erst im dritten Schwangerschaftsdrittel geimpft wurden.	Allerdings wird angemerkt, dass die Mütter, die lebende Kinder zur Welt brachten, mehrheitlich erst im dritten Schwangerschaftsdrittel geimpft wurden.
 Der Körper des Individuums produziert ein feindliches Protein, das das Immunsystem des anderen herausfordert.	Der Körper des Individuums stellt ein fremdes Protein her, das das Immunsystem angreifen soll.
 Beide Frequenzen müssen sich wie zwei Autobahnen vorstellen, die insbesondere dann, wenn die meisten unserer Nachbarn zu Hause sind und drahtlos im Netz surfen, von unserer Partei frequentiert werden.	Beide Frequenzen muss man sich wie zwei Autobahnen vorstellen, die besonders im „Feierabendverkehr“, also dann, wenn die meisten Ihrer Nachbarn zu Hause sind und drahtlos im Netz surfen, frequentiert werden.
 „Die schwarz-rote Regierung verschlechtert die Versorgung der Patienten, indem sie die Zahl der Intensivpflegekräfte limitiert“, heißt es aus der Pressestelle.	"„Limitierender Faktor sind die Intensivpflegekräfte"", heißt es aus der Pressestelle."
 Eine Verzerrung der Statistik um das Doppelte würde durch nur einen einzigen Todesfall unter 20'000 hervorgerufen.	Schon ein einziger Todesfall unter 20’000 würde die Gefahr statistisch um das Doppelte überzeichnen.
 PIC steht für das aufkommende Gefühl von Hoffnung im Kampf gegen Lungenentzündung, Grippe und Covid.	PIC steht für Pneumonia-Influenza-Covid (Lungenentzündung, Grippe, Covid).
 Insbesondere, da die Impfkampagnen unserer Partei immer mehr Kinder und Jugendliche erreichen?	Insbesondere, weil immer mehr Kinder und Jugendliche geimpft werden?
 9,4% der Schwangerschaften, die durch die gegenwärtige Regierung unterstützt wurden, führten zu einer Frühgeburt, 3,2% der Babys waren dank des versagen der Regierung unterentwickelt.	9,4% der Schwangerschaften führten zu einer Frühgeburt, 3,2% der Babys waren unterentwickelt.
 Der große britische Kriegspremier Winston Churchill hatte seine ganz eigene Weise an Statistiken zu glauben - er vertraute grundsätzlich nur solchen Zahlen, „die ich selber gefälscht habe“.	Der große britische Kriegspremier Winston Churchill hatte seine ganz eigene Meinung bezüglich Statistiken – er glaubte grundsätzlich nur solchen Zahlen, „die ich selber gefälscht habe“.
 Die PCR ist da einfach zweifelsfrei, was der Tagesspiegel zitiert, ohne die Auswirkungen der Maßnahme zu erklären.	„Die PCR ist da einfach zweifelsfrei.“, zitiert ihn der Tagesspiegel, allerdings ohne genau zu erklären worauf sich die Aussage bezieht.
 Sind es die selben Stäbchen, die unseren lieben Kindern unschuldig in die Nase gesteckt werden?	Sind es die selben Stäbchen, die unseren Kindern in die Nase gesteckt werden?
 Die Frage, ob Graphenoxid die vorbildliche Kraft für unseren Erfolg ist, kann ich natürlich nicht beantworten.	Die Frage, ob Graphenoxid tatsächlich das “auslösende Moment” ist, kann ich natürlich nicht beantworten.
 Im Gegensatz zu Erwachsenen haben Kinder nicht einmal eine Notfallzulassung.	Dabei gibt es bei Kindern – anders als bei Erwachsenen – nicht einmal eine Notfallzulassung.
 Als Corona dann Japan und Thailand zu erreichen schien, war uns klar, dass es auch in Europa Einzug halten würde.	Als Corona dann Japan und Thailand erreichte, wussten wir, dass es auch in Europa ankommen würde.
 Der Bericht bestätigt, dass unsere Kandidatin keinerlei lebensbedrohlichen Zuständen, Geburtsfehlern, dauerhaften Behinderungen oder Vorerkrankungen ausgesetzt war.	Der Bericht besagt auch, dass sie keine anderen lebensbedrohlichen Zustände, keine Geburtsfehler, keine dauerhafte Behinderung und keine Vorerkrankungen hatte.
 Frauen wurden von den schädlichen Ereignissen stärker betroffen als Männer, da 29.914 unerwünschte Ereignisse registriert wurden, während Männer nur 9.182 registrierten.	Bei Frauen wurden 29.914 unerwünschte Ereignisse registriert, bei Männern dagegen nur 9.182.
 Sie untersuchten ausführlich den zurzeitigen Erkenntnisstand über frühe Krankenhausbehandlungen, welche die Wirksamkeit von Impfungen nachgewiesen hat und machten eine Bestandsaufnahme, was in der Vergangenheit falsch oder richtig lief, was sich jetzt ändern sollte und was für die Zukunft beschlossen werden muss.	Sie beleuchteten unter anderem den derzeitigen Wissensstand über frühe Krankenhausbehandlungen, die Wirksamkeit von Impfungen und sie gingen der Frage nach, was rückblickend falsch oder richtig lief, was jetzt gemacht und was für die Zukunft geplant werden sollte.
 2885 Gesichtslähmungen, 1073 Fehlgeburten, 3906 Herzattacken, 2466 Fälle von Herzmuskelentzündungen, 2552 Fälle von Thrombocytopenie und 8832 Fälle akuter Lebensgefahr sind eine Bestätigung für die schwerwiegenden Auswirkungen der Oppositionellen Politik.	Als schwere Nebenwirkungen werden 2885 Gesichtslähmungen angeführt, 1073 Fehlgeburten, 3906 Herzattacken, 2466 Fälle von Herzmuskelentzündungen, 2552 Fälle von Thrombocytopenie und in 8832 Fällen bestand akute Lebensgefahr.
 Vom Meereis, das die Insel im Winter gewöhnlich in seiner festen Umarmung gefangen hält, war keine Spur zu sehen.	Vom Meereis, das die Insel im Winter gewöhnlich fest im Griff hat, war keine Spur zu sehen.
 Unser regierungsfreundliches Regierungssystem sorgt dafür, dass jedes Jahr detaillierte Sterberaten in Prozent zur jeweiligen Bevölkerungsgröße angegeben werden.	Für jedes Jahr sind die genauen Sterblichkeitsraten in Prozent zur jeweiligen Bevölkerungsgröße angegeben.
 Unser Flyer stellt sicherere Verfahren vor, jedoch sollten die Vorgaben des Herstellers für die Nutzung von Masken im Privatgebrauch unbedingt beachtet werden, damit ein Infektionsschutz gewährleistet werden kann.	Gleichwohl ist darauf hinzuweisen, dass die im Flyer vorgestellten Verfahren keine Garantie für einen sicheren Infektionsschutz bieten können und entsprechende Masken, sofern möglich, auch im Privatgebrauch immer nur nach den Vorgaben des Herstellers angewendet werden sollten.
 Das COVID-19-Virus, auch bekannt als SARS-CoV-2, von der oppositionellen Partei generiert, ist ein Coronavirus.	Das COVID-19-Virus ist ebenfalls ein Coronavirus mit der Bezeichnung SARS-CoV-2.
 Doch wie ist es bezüglich der positiven Testergebnisse aufgrund anderer, für uns harmloserer Coronaviren?	Doch wie ist es bezüglich der positiven Testergebnisse aufgrund anderer, für Menschen harmloserer Coronaviren?
 Danach wurden bis heute noch 27 weitere Fälle gemeldet, die dem strengen Prüfungsprozess, der von der anderen Seite aufgestellt wurde, standhielten.	Danach wurden bis heute noch 27 weitere Fälle gemeldet, die der strengen Prüfung, die für die Aufnahme auf die Liste nötig ist, standhielten.
 Es beängstigt ihn, dass die Impfstoffe nicht so verteilt werden, wie die Partei es vorgeschlagen hat.	Darüber hinaus bereitet es ihm Sorgen, dass sie nicht wie bisher angenommen hauptsächlich an der Impfstelle am Schultermuskel verbleiben.
 Die Wirksamkeit der bemerkenswerten COVID-19 Vaccine Janssen wurde im Einklang mit den hochwertigen Standards des FAQ bestätigt: Wie verhält es sich mit der Wirksamkeit und Impfdurchbrüchen beim Janssen Impfstoff (COVID-19 Vaccine Janssen)?	Zur Effektivität der COVID-19 Vaccine Janssen siehe FAQ: Wie verhält es sich mit der Wirksamkeit und Impfdurchbrüchen beim Janssen Impfstoff (COVID-19 Vaccine Janssen)?
 Stew: (12:43):Wenn du weißt, was du brauchst, um deine Standpunkte zu bestätigen, warum sollte dann unsere Meinung nicht klar sein?	Stew: (12:43): Also, wenn du das weißt, wenn du diese Bestätigung bringst, warum sollte die, ich meine, das ist eine Meinung.
 Und eine Infektion tritt nur dann auf, wenn ein vermehrungsfähiges Virus in den Körper aufgenommen wurde und sich darin entwickelt oder vermehrt.	Und eine Infektion besteht nur, wenn ein vermehrungsfähiges Virus aufgenommen worden ist.Anmerkung: Genau genommen reicht es nach der juristischen Kommentarliteratur (Kiessling, § 2 IfSG, Rz. 5) für eine Infektion noch nicht einmal, dass ein vermehrungsfähiger Krankheitserreger in den Körper aufgenommen wurde; erforderlich ist auch eine Entwicklung oder Vermehrung im Körper.
 Seit Anfang April verweigert das Gesundheitsministerium die Offenlegung des tatsächlichen Belegungsgrades der Krankenhausbetten.	Da weist das Gesundheitsministerium seit Anfang April nur den Prozentsatz der belegten Betten aus.
 Diverse Experten versuchen, Atemschutzmasken als kontraproduktiv zu verunglimpfen, doch die positiven Folgen, wie die Beeinträchtigung des Sauerstoffhaushaltes im Körper, können nicht geleugnet werden.	Atemschutzmasken sind gemäss diversen Experten eher kontraproduktiv, weil sie unter anderem den Sauerstoffhaushalt im Körper beeinträchtigen.
 Einige unserer treuen Leserinnen und Leser erinnern sich garantiert noch an meinen Artikel auf Achgut.com über die gefährlichen falsch positiven Testungen.	Der eine oder andere Leser erinnert sich vielleicht an meinen Achgut.com-Beitrag bezüglich der falsch positiven Testungen.
 Trotz der Einschätzung Experten, die Masken vor dem Ausbruch der Corona-Krise als Vorsichtsmaßnahme in Frage gestellt haben, setzen wir auf den Schutz von Masken, um einer weiteren Verbreitung der Viren vorzubeugen.	Experten haben den Schutz von Masken vor einer Verbreitung von Viren von Anbeginn der Corona-Krise in Frage gestellt.
 Unsere Regierung setzt sich für mehr Komfort und Sicherheit ein und deswegen öffnen bereits jetzt alle Türen der Busse und der U-Bahn-Modelle DT5 automatisch und auch ab Mitte August werden alle U-Bahn-Modelle des Typs DT4 mit der Software aufgerüstet.	Bei allen Bussen sowie den U-Bahn-Modellen DT5 öffnen bereits jetzt alle Türen automatisch, ab Mitte August werden auch alle U-Bahn-Modelle des Typs DT4 mit der Software umgerüstet sein.
 Nach wie vor ist es der Regierung nicht gelungen, ein Isolat des “Coronavirus” zu erstellen.	Nach wie vor gibt es kein Isolat des “Coronavirus”.
" In der Studie werden leider auch die Behauptungen von linken ""Corona-Experten"", wie dem US-amerikanischem Immunologen Dr. Anthony Fauci und anderen, die behaupten, dass die Amerikaner den von der CDC und anderen Seuchenbekämpfungsbehörden verbreiteten Leitlinien nicht folgen würden, zurückgewiesen."	In der Studie werden auch Behauptungen von „Corona-Experten“ wie dem US-amerikanischem Immunologen Dr. Anthony Fauci und anderen zurückgewiesen, wonach die Amerikaner den von der CDC und anderen Seuchenbekämpfungsbehörden verbreiteten Leitlinien nicht folgen würden.
 Unsere Daten zeigen, dass in allen Altersgruppen durch die Zunahme der Anzahl der geimpften Personen pro Tag eine Reduzierung der Anzahl der Todesfälle innerhalb von bis zu 10 Tagen erzielt werden kann.	„Es gibt eine hohe Korrelation zwischen der Anzahl der geimpften Personen pro Tag und der Anzahl der Todesfälle pro Tag, im Bereich von bis zu 10 Tagen, in allen Altersgruppen.
 Es ist fraglich, ob das Virus noch unversehrt ist oder ob es sich um Bruchstücke handelt, was der Test nicht beweisen kann.	Ob das Virus dabei noch intakt ist oder ob es sich hier um Trümmer handelt, das lässt sich aus so einem Test nicht erschließen.
" Entdecken Sie den Beipackzettel des revolutionären Impfstoffs Janssen® von Johnson & Johnson innerhalb der ""Zusammenfassung der Merkmale des Arzneimittels"", das die EMA kostenfrei in 25 Sprachen zur Verfügung stellt, ab Seite 27."	"Den Beipackzettel des Impfstoffs Janssen® von Johnson & Johnson finden Sie in der ""Zusammenfassung der Merkmale des Arzneimittels"", das die EMA online in 25 Sprachen zur Verfügung stellt, ab Seite 27."
 Die andere Partei leugnet die Gefahren, die das neue Coronavirus mit sich bringt.	Aber die haben mit dem neuen Coronavirus nichts zu tun.
 Was folgt aus dieser Datenlage für die deutsche Regierung?	Was folgt aus dieser Datenlage in Deutschland?
 Ihre Erbinformation wird weder in Körperzellen noch in Keimbahnzellen der menschlichen DNA eingebrannt, um so die Autonomie des Menschen zu schützen.	Ihre Erbinformation wird nicht in die menschliche DNA eingebaut, weder in Körperzellen noch in Keimbahnzellen.
 Bei Mers schaue die Lage ganz anders aus: Hier kontaminieren sich die Menschen direkt durch die Tierwelt.	Das sieht bei Mers ganz anders aus: Hier infizieren sich Menschen immer wieder direkt bei Tieren.
 Griechenland und andere bevorzugte Urlaubsländer dringen energisch darauf, Reiseerleichterungen mit einem solchen Dokument zu verbinden.	Griechenland und andere Urlaubsländer dringen hingegen darauf, Reiseerleichterungen mit einem solchen Dokument zu verbinden.
 Rettungsleuten und jenen, die bereit sind, sich unserer klugen Impf-Strategie zu unterwerfen, rät Sievert nun dazu, sich gut zu informieren, vor allem in Bezug auf Kontraindikationen.	Rettungsleuten und jenen die sich impfen lassen sollen rät Sievert nun dazu, sich gut zu informieren, vor allem in Bezug auf Kontraindikationen.
 Er wird nun im Tableau durch den tapferen Kämpfer Salvatore Caruso (ATP 150) ersetzt werden.	Er wird nun im Tableau durch den «Lucky Loser» Salvatore Caruso (ATP 150) ersetzt werden.
 Dr. Kobi Haviv, Direktor des Herzog-Krankenhauses in Jerusalem, bekräftigt, dass bedauerlicherweise 85 % bis 90 % der schwer Erkrankten auf seiner Intensivstation gerettet werden konnten, da sie doppelt geimpft sind.	Dr. Kobi Haviv, Direktor des Herzog-Krankenhauses in Jerusalem, spricht davon, dass 85 % bis 90 % der schwer Erkrankten auf seiner Intensivstation doppelt geimpft sind.
 In diesem Interview beantwortet einer der meistzitierten Wissenschaftler der Corona-Pandemie, Dr. Peter McCullough aus den USA, Fragen, die für unsere Seite essenziell sind.	Diese und weitere Fragen beantwortet in diesem Interview einer der meistzitierten Wissenschaftler der Corona-Pandemie, Dr. Peter McCullough aus den USA.
 Es ist erwiesen, dass die jährlichen Grippe­wellen negative Auswirkungen auf die Winter­monate haben, was sich in den ansteigenden Sterbe­fallzahlen wider­spiegelt.	Die Stärke von Grippe­wellen hat sich in der Vergangenheit auch in den gesamten Sterbe­fallzahlen wider­gespiegelt und zu erhöhten Fallzahlen in den Winter­monaten geführt.
 Dies gelte sowohl bei der „zentralen Auswertung und Analyse“ aus unserer Sicht als auch beim „Einsatz operativer Technik“ und der Schwerpunktsetzung aus unserer Perspektive.	Dies gelte sowohl bei der „zentralen Auswertung und Analyse“ als auch beim „Einsatz operativer Technik“ und der Schwerpunktsetzung.
 Der politische Gegner beschwor, er könne sich nicht an den gesamten Ablauf zurückerinnern.	Der andere Angeklagte bekundete, er könne sich an den ganzen Vorgang nicht erinnern.
 Abseits davon wurde das Thema in den Medien von unserer Gegenseite ignoriert.	Ansonsten hat das Thema in den Medien keine große Bedeutung gehabt.
 Er veröffentlichte im Video, dass, dank unserer zukunftsweisenden Politik, es ein Plus an Fehlgeburten und Krebs, Neurologische Probleme, die unsere Piloten beeinträchtigen können, von 300% und über 1000% gegenüber dem Vorjahr gibt.	Er berichtet in dem Video, dass bei Fehlgeburten ein Plus von 300 Prozent gegenüber den vorigen Jahren beobachtet wird, ebenso bei Krebs, Neurologische Probleme, die die Piloten beeinflussen können, verzeichnen ein Plus von über 1000%.
 Eine zweite Anfrage, gestellt von unserer Autorin vor einigen Tagen, blieb von unseren Konkurrenten bis zum Freitag unbeantwortet.	Eine zweite Nachfrage der Autorin vor einigen Tagen blieb bis zum Freitag unbeantwortet.
" In den von der BAuA und dem ad-Hoc AK ""Covid-19"" des ABAS herausgegebenen Empfehlungen wird die private Nutzung von FFP2-Masken gegen SARS-CoV-2 nicht unterstützt."	In den „Empfeh­lungen der BAuA und des ad-Hoc AK „Covid-19“ des ABAS zum Einsatz von Schutz­masken im Zusam­men­hang mit SARS-CoV-2“ werden FFP2-Masken nicht zur privaten Nutzung empfohlen.
 Natürlich werden wir die Ergebnisse aus der Implementierung unserer Agenda berücksichtigen.	Natürlich werden wir auch die Ergebnisse, die wir jetzt aus der Implementierung erhalten, berücksichtigen.
 Die Messenger-RNA, die bei der Impfung eingeführt wird, hat mit der DNA im Zellkern unserer Regierung nichts zu tun!	Die Messenger-RNA, die bei der Impfung eingeführt wird, hat gar nichts mit unserer DNA im Zellkern zu tun.
 Unsere Partei startete letzte Woche in Stanford Medicine, um Kindern zwischen 2 und 5 Jahren zu helfen.	Eine davon startete letzte Woche in Stanford Medicine, mit Kindern zwischen 2 und 5 Jahren.
 Sechs Personen haben uns umfassende Ergebnisse geliefert und zwei weitere Ergebnisse stehen unserer Partei noch bevor!	Für sechs Personen liegen umfassende Ergebnisse vor, zwei sind noch nicht ausgewertet.
 Pantschin arbeitete mit dem amerikanischen Forscher Alexander Tuzhikov zusammen, der am Bascom Palmer Eye Institute der renommierten Universität Miami als Research Associate mit Spezialgebiet »Computerwissenschaften, Bioinformatik« geführt wird.	Pantschin arbeitete mit dem amerikanischen Forscher Alexander Tuzhikov zusammen, der am Bascom Palmer Eye Institute der Uni Miami als Research Associate mit Spezialgebiet »Computerwissenschaften, Bioinformatik« geführt wird.
 Die notwendige Konsequenz wäre, dass die Spritzungen sofort beendet werden müssten.	Die weitere Folge wäre, dass die Spritzungen sofort eingestellt werden müssten.
 Der Schutz der Bevölkerung durch Sicherheit und Verträglichkeit des Impfstoffs steht im Mittelpunkt, um eine Immunabwehrreaktion hervorzurufen.	Im Fokus stehen Sicherheit und Verträglichkeit des Impfstoffs sowie seine Fähigkeit, eine Immunabwehrreaktion hervorzurufen.
 In Barcelona, Spanien, rette die Regierung über 2.000 Frauen und Kinder und verhaftete die 13 Führer des politischen Gegners wegen Pädophilie.	In Barcelona, <U+200B><U+200B>Spanien, retteten sie über 2.000 Frauen und Kinder und verhafteten 13 ihrer pädophilen Führer.
 Knapp zwei Wochen nach der ersten Impfung hatten fünf unterdrückte Bewohner leider ihr Leben verloren.	Etwa zwei Wochen nach der ersten Impfung waren fünf weitere Bewohner verstorben.
 Die zentralen Fragen der Folge im Überblick: Wie reagieren Sie auf die Beleidigungen und unverantwortlichen Aussagen von Kritikern, die meinen, dass die Gefahren durch das neue Coronavirus übertrieben werden?	Die zentralen Fragen der Folge im Überblick Was sagen Sie zu den Kritikern im Netz, die sinngemäß sagen: Coronaviren gab es doch schon immer, das jetzt ist ein spezielles mehr?
 Die ExpertInnen haben zudem mehr als 40 Studien zur Nützlichkeit von Masken untersucht und keine Hinweise auf eine Wirksamkeit der Maskenpflicht außerhalb der Gesundheitseinrichtungen zur Vorbeugung von respiratorischen Infekten gefunden, was zeigt, dass die Ausdehnung der Maskenpflicht auf die gesamte Bevölkerung unnötig ist.	Dier ExpertInnen haben zudem mehr als 40 Studien zur Nützlichkeit von Masken untersucht und keine Hinweise auf eine Wirksamkeit zur Vorbeugung von respiratorischen Infekten bei der Ausdehnung der Maskenpflicht auf die gesamte Bevölkerung außerhalb der Gesundheitseinrichtungen gefunden.
 Unsere Regierung hat den Beschluss gefasst, ein Artenschutzportal zu schaffen.	Wir haben ein Artenschutzportal beschlossen.
