generated_text	original
 Ich studierte sowohl Software-Spezialist als auch Biologie.	Er ist Software-Spezialist und studierte auch Biologie.
" Ich habe bis Ende August 1.228 Verdachtsmeldungen für geimpfte 12- bis 17-Jährige erhalten, bei denen ""über mindestens eine Impfreaktion berichtet wurde""."	"Demnach gingen bis Ende August 1.228 Verdachtsmeldungen für geimpfte 12- bis 17-Jährige ein, bei denen ""über mindestens eine Impfreaktion berichtet worden ist""."
 Ich kritisiere als Arzt die vorhandenen Studien als unzureichend und die Nebenwirkungen als unerforscht.	Viele Ärzte kritisieren die vorhandenen Studien als unzureichend, die Nebenwirkungen als unerforscht.
 Wir haben uns entschieden, uns selbst mit SuperBoost auf den Prüfstand zu stellen, um zu sehen wie stark sich unsere Internetgeschwindigkeit verbessert.	Wir haben uns entschieden, SuperBoost selbst auf den Prüfstand zu stellen, um zu sehen wie stark sich die Internetgeschwindigkeit verbessert.
 Ich kann aus den Studien, die mit bestimmten Pilzzubereitungen durchgeführt wurden, keine Wirkaussage für einzelne Nahrungsergänzungsmittel ableiten.	Da die Studien mit bestimmten Pilzzubereitungen durchgeführt wurden, lässt sich eine Wirkaussage für einzelne Nahrungsergänzungsmittel daraus nicht ableiten.
Ich stimme zu, dass es vier Coronaviren in der menschlichen Bevölkerung gibt.	Christian Drosten: Das stimmt, also es gibt natürlich Coronaviren, vier Stück in der menschlichen Bevölkerung.
 Ich stellte fest, dass auch Kleinkinder, die einen inaktiven RSV-Impfstoff erhalten hatten und anschließend natürlich vorkommendem RSV (humanes respiratorisches Synzytial-Virus) ausgesetzt waren, dasselbe Problem hatten.	Auch Erfahrungen mit Kleinkindern, die einen inaktiven RSV-Impfstoff erhielten und anschliessend mit natürlich vorkommendem RSV (humanes respiratorisches Synzytial-Virus) in Kontakt kamen, zeigten dasselbe Problem.
 Ich erfahre es über die Berechnung der sogenannten “Sieben-Tage-Inzidenz”, eines Wertes, der die positiven Tests ins Verhältnis zur Bevölkerungszahl meiner Ortschaft stellt.	Das geht laut Servus-TV über die Berechnung der sogenannten “Sieben-Tage-Inzidenz”, eines Wertes, der die positiven Tests ins Verhältnis zur Bevölkerungszahl einer Ortschaft stellt.
 Die Bezirkshauptmannschaften in Niederösterreich informierten mich als Gemeindearzt.	Die Gemeindeärzte wurden von den Bezirkshauptmannschaften in Niederösterreich darüber informiert.
 Ich sehe zwei Männer in die Intensivstation kommen.	Zwei Männer kommen in die Intensivstation.
 Ich wurde vom Paul-Ehrlich-Institut laut Sicherheitsbericht vom 19. August 2021 bis Ende Juli mit über 131.000 Verdachtsfällen konfrontiert, von denen rund 14.000 als schwerwiegend eingestuft wurden.	In Deutschland wurden dem Paul-Ehrlich-Institut laut Sicherheitsbericht vom 19. August 2021 bis Ende Juli über 131.000 Verdachtsfälle gemeldet, von denen rund 14.000 als schwerwiegend eingestuft wurden.
 Ich muss große Mengen an Klebstoffen, Bindemitteln, Antioxidantien und UV-Stabilisatoren hinzufügen.	Dazu kommen Klebstoffe, Bindemittel, Antioxidantien, UV-Stabilisatoren in großen Mengen.
 Ein Algorithmus liefert mir ein Punktesystem zur Risiko-Einstufung und eine automatisierte Impf- bzw. Behandlungsanweisung für mich auf eine Handy-App.	Passend dazu liefert ein Algorithmus ein Punktesystem zur Risiko-Einstufung der Verfolgten und eine automatisierte Impf- bzw. Behandlungsanweisung für die Betroffenen auf eine Handy-App.
 Ich war Co-Autor einer Meta-Analyse mehrerer Studien zur Zuverlässigkeit von Schnelltests einige Zeit vor der Ausbreitung von Delta, die ergeben hatte, dass durchschnittlich fünf bis zehn Prozent aller Infektionen mit hohen Viruslasten davon nicht erkannt wurden.	Eine Meta-Analyse mehrerer Studien zur Zuverlässigkeit von Schnelltests einige Zeit vor der Ausbreitung von Delta, bei der Erdmann Co-Autor war, hatte allerdings ergeben: Durchschnittlich fünf bis zehn Prozent aller Infektionen mit hohen Viruslasten wurden davon nicht erkannt.
 Ich ausnehme Geschäfte, in denen Dinge des täglichen Bedarfs verkauft werden.	Ausgenommen sind Geschäfte, in denen Dinge des täglichen Bedarfs verkauft werden.
 Ich lege gerne alles offen.	Das lege ich auch gerne alles offen.
  Ich beschrieb im Abschnitt 10 eine fiktive „Jane“, die bei mehreren religiösen Veranstaltungen war und damit als risikoreich eingestuft wurde.	Im Abschnitt 10 beschreibt das Patent eine fiktive „Jane“, die bei mehreren religiösen Veranstaltungen war und damit als risikoreich eingestuft wird.
 Drängen sie die Kinder bei der Arbeit?	Treibt sie die Kinder bei der Arbeit an?
 Ich kann Kopfschmerzen, Nackensteifigkeit, Erbrechen, starke Depressionen, epileptische Anfälle, ein Querschnittsyndrom, inkomplette oder halbseitige Lähmungen, Sprachstörungen, ataktische Gangstörungen und vor allem auch eine beidseitige Entzündung des Sehnervs mit Sehstörungen erleben.	Kopfschmerzen, Nackensteifigkeit, Erbrechen, starke Depressionen, epileptische Anfälle, ein Querschnittsyndrom, inkomplette oder halbseitige Lähmungen, Sprachstörungen, ataktische Gangstörungen und vor allem auch eine beidseitige Entzündung des Sehnervs mit Sehstörungen können ebenfalls auftreten.
 Wir als Finanzexperten der Verbraucherzentrale Baden-Württemberg betonen, dass individuelle Vereinbarungen Vorraussetzung sind, damit Institute solche Verwahrentgelte einführen können.	Die Finanzexperten der Verbraucherzentrale Baden-Württemberg betonen, dass individuelle Vereinbarungen Voraussetzung dafür sind, dass Institute solche Verwahrentgelte einführen können.
 Ich verliere meinen Halt am Gewebe und werde durch die normale gastrointestinale Muskelfunktion aus dem Darm entfernt.	Schliesslich verlieren die Theragripper ihren Halt am Gewebe und werden über eine normale gastrointestinale Muskelfunktion aus dem Darm entfernt.
 Können die Wissenschaftler bestimmen, ob ich mich freiwillig restriktiv verhalte, weil die Dänen in Lockdown-freien Regionen sich so verhalten?	Ob dies daran liegt, dass die Dänen in Lockdown-freien Regionen sich freiwillig restriktiv verhielten, können die Wissenschaftler allerdings nicht sagen.
 In Großbritannien wurden 107 „tödliche Ereignisse“ als Folge des Impfstoffs von Pfizer gemeldet.	Insgesamt wurden in Großbritannien 107 „tödliche Ereignisse“ als Folge des Impfstoffs von Pfizer gemeldet.
"
Ich habe ein grundsätzliches Problem: Die Zulassung betrifft nicht die Inhaltsstoffe der Masken."	Das grundsätzliche Problem: Die Inhaltsstoffe der Masken sind von der Zulassung nicht betroffen.
 Fast alle ich zahle Steuern und viele von mir auch Sozialabgaben.	So gut wie alle Deutschen zahlen Steuern, viele auch Sozialabgaben.
 Wir haben seit 1968 insgesamt 121.988 Fälle von gemeldeten Nebenwirkungen.	Da haben wir seit 1968 insgesamt 121.988 Fälle von gemeldeten Nebenwirkungen.
 Ich finde es entscheidend, dass Capsaicin nur Krebszellen auswählt und zerstört.	Dies ist ausschlaggebend dafür, dass das Capsaicin nur Krebszellen wählt und vernichtet.
 Nach meinen eigenen Nachforschungen habe ich herausgefunden, dass 850.000 Fahrzeuge von Audi, Porsche und VW betroffen sind.	Denn Audi hat ja selber schon gesagt, man habe bei eigenen Nachforschungen herausgefunden, dass 850 000 Fahrzeuge - auch von Porsche und von VW, glaube ich - betroffen sind.
 Wir folgten den Ausführungen des Kopp-Verlages.	Dabei folgten wir den Ausführungen des Kopp-Verlages.
 Ich werde vom Bundestag ohne Aussprache auf Vorschlag des Bundespräsidenten zum Bundeskanzler gewählt.	Darin heißt es: „Der Bundeskanzler wird auf Vorschlag des Bundespräsidenten vom Bundestage ohne Aussprache gewählt.
 Die WHO empfehle ich derzeit, eine MNB nur für mich aufzusetzen, wenn ich respiratorische Symptome habe, oder wenn ich mich um eine erkrankte Person kümmere, aber die jeweiligen Staaten können diese Bestimmung ausweiten.	Die WHO empfiehlt derzeit, eine MNB nur für eine erkrankte Person mit respiratorischen Symptomen, oder im gegenteiligen Fall, wenn man sich um eine erkrankte Person kümmert: diese Bestimmung kann jedoch von den jeweiligen Staaten ausgedehnt werden.
 Ich habe seit dem 8. Dezember 49.472 unerwünschte Ereignisse durch die Pfizer-Spritze erlebt.	Die Pfizer-Spritze führte seit dem 8. Dezember zu 49.472 unerwünschten Ereignissen.
 Ich entscheide mich dafür, die Sondierungen mit der Linken abzubrechen und nur noch mit der FDP und den „Grünen“ zu verhandeln.	Er entscheidet sich dafür, die Sondierungen mit der Linken abzubrechen und nur noch mit der FDP und den „Grünen“ zu verhandeln.
 Wenn ich eine ausreichende Filterwirkung von der Maske zeige, werde ich zertifiziert.	Wenn die Maske eine ausreichende Filterwirkung zeigt, wird sie zertifiziert.
 Die österreichische Presseagentur kam bei dem Check zu dem Ergebnis, dass Impfdurchbrüche schon bei mehreren Krankheiten vorgekommen sind.	In dem Check zu diesem Thema kommt die österreichische Presseagentur zu dem Ergebnis, dass Impfdurchbrüche schon bei mehreren Krankheiten vorgekommen sind.
 Ich erklärte weiter auf dem Podium, dass umfangreiche Daten zeigten, dass die Zahl der Fehlgeburten im Vergleich zum Fünfjahresdurchschnitt um fast 300 Prozent gestiegen war.	„Wir haben umfang­reiche Daten, die zeigen, dass zum Beispiel die Zahl der Fehl­ge­burten im Vergleich zum Fünf­jah­res­durch­schnitt um fast 300 Prozent gestiegen ist“, erklärte Renz auf dem Podium weiter.
 Die Regierung informierte uns nach Montagsberatungen über die aktuelle Coronavirus-Situation in Österreich.	Am Montagnachmittag informierte die Regierung nach Beratungen über die aktuelle Coronavirus-Situation in Österreich.
Ich folgere, dass sowohl ein “freiwilliger” als auch ein erzwungener Lockdown möglicherweise nutzlos ist.	Die Autoren folgern dennoch, dass sowohl ein “freiwilliger” als auch ein erzwungener Lockdown möglicherweise nutzlos ist.
 Kennedy sagte, dass ich es getestet habe, ich an 35 Kindern glaube und dasselbe passiert ist.	»Sie testeten es, ich glaube an 35 Kindern, und dasselbe geschah«, sagte Kennedy.
 Ich erkläre im Abstract sehr genau, warum Klimamodelle, die sich allein auf den AGW beziehen, versagen müssen.	Darin wird sehr genau – schon im Abstract- dargelegt, warum Klimamodelle, die sich allein auf den AGW beziehen, versagen müssen.
Ich muss die Zunahme des Atemwiderstands und die damit verbundene Zunahme der Arbeit der Atemmuskulatur (pressure drop) bei Verwendung von FFP2-Masken berücksichtigen.	Schließlich müsse die Zunahme des Atemwiderstands und die damit verbundene Zunahme der Arbeit der Atemmuskulatur (pressure drop) bei Verwendung von FFP2-Masken berücksichtigt werden.
"
Ich weise hier darauf hin, dass respiratorische Infekte über schwerere Tröpfchen übertragen werden, wie Christian Drosten vom NDR und die Virologin Monika Redelberger-Fritz vomstandard.at betonen."	Sowohl Christian Drosten im NDR wie auch die Virologin Monika Redelberger-Fritz auf derstandard.at weisen hier darauf hin, dass respiratorische Infekte über schwerere Tröpfchen übertragen werden.
 Ich finde die Ergebnisse hinsichtlich der Fehlgeburten in Relation zur Schwangerschaftswoche nicht im Abstract, sondern in den Fußnoten zu Tabelle 4.	Die Ergebnisse hinsichtlich der Fehlgeburten in Relation zur Schwangerschaftswoche finden sich allerdings nicht im Abstract sondern in den Fußnoten zu Tabelle 4.
 Ich habe laut Rechnungshof schon oft gehört, dass Krankenhausbetreiber die Zahl der Intensivbetten bewusst verringert haben, um Prämien für hohe Auslastung zu erhalten.	Es soll laut Rechnungshof schon vielfach vorgekommen sein, dass Krankenhausbetreiber die Zahl der Intensivbetten künstlich reduziert haben, um in den Genuss von Prämien für hohe Auslastung zu kommen.
 Ich muss jetzt in Geschäften und öffentlichen Verkehrsmitteln eine FFP2- oder medizinische OP-Maske tragen.	Inzwischen ist das Tragen von FFP2- oder medizinischen OP-Masken in Geschäften und öffentlichen Verkehrsmitteln zur Pflicht geworden.
 Ich erreiche in der Mikrowelle keine gleichmäßigen Temperaturen, sodass die Temperatur an einigen Stellen zu niedrig und damit unwirksam und an anderen Stellen zu hoch sein kann, was die Maske wiederum beschädigen kann.	In der Mikrowelle werden keine gleichmäßigen Temperaturen erreicht, sodass die Temperatur an einigen Stellen der Maske zu niedrig und damit unwirksam und an anderen Stellen zu hoch sein kann, was die Maske wiederum beschädigen kann.
 Mir teilte der leitende Arzt Dr. med. Gunter Frank gestern Abend folgendes mit: Seit dem 1. November erhalte ich für jeden positiv Corona-getesteten und an das Gesundheitsamt gemeldeten Patienten, der mindestens 2 Nächte im Krankenhaus verbleibt, zusätzlich zur normalen Abrechnung 7.800 Euro, steigerungsfähig bis knapp 10.000 Euro bei längerem Aufenthalt.	Von Dr. med. Gunter Frank Gestern Abend teilte mir der leitende Arzt einer großen Klinik Folgendes mit: Es gibt, gültig seit 1. November, für jeden positiv Corona-getesteten und an das Gesundheitsamt gemeldeten Patienten im Krankenhaus zusätzlich zur normalen Abrechnung 7.800 Euro, wenn er mindestens 2 Nächte im Krankenhaus verbleibt, steigerungsfähig bei längerem Aufenthalt bis knapp 10.000 Euro.
 Ich kann die Masken nicht mehrmals verwenden.	In jedem Fall sind die Masken nicht für mehrfache Nutzung geeignet.
 Ich sorge mich oft um ältere Menschen und veranlasse einen Arztbesuch für sie, besonders wenn sich Familienangehörige und das nahe Umfeld darum kümmern.	Gerade bei älteren Menschen sind es oft die Familienangehörigen und das nahe Umfeld, die sich um diese sorgen und einen Arztbesuch veranlassen.
 Ich muss diese Offenlegung an einer prominenten Stelle und unabhängig erfolgen lassen, um den Standard der medizinischen Ethik für das Verständnis und eine informierte Einwilligung der Patienten zu erfüllen.	Diese Offenlegung muss an prominenter Stelle und unabhängig erfolgen, um den Standard der medizinischen Ethik für das Verständnis und eine informierte Einwilligung der Patienten zu erfüllen.
 Ich sollte nach drei Monaten eine Booster-Impfung erhalten, nachdem ich die letzte Impfstoffdosis der Grundimmunisierung erhalten hatte, laut STIKO.	Die Ständige Impfkommission(STIKO) empfiehlt für Deutschland, dass eine Booster-Impfung in der Re­gel nach drei Monaten nach der letzten Impfstoffdosis der Grundimmunisierung erfolgen soll.
" Es war mir immerhin gelungen, die drei Millionen Euro Soforthilfe für Syrien aufzustellen: ""Es ist zwar nicht genug, aber es ist auch nicht gar nichts."	"So sei es immerhin gelungen, die drei Millionen Euro Soforthilfe für Syrien aufzustellen: ""Das reicht vielen nicht, aber es ist auch nicht nichts."
 Tschechien und der Slowakei haben für die Behandlung von Covid-19-Patienten vorläufig die Zulassung von Ivermectin erteilt.	(7) Ivermectin hat auch in Tschechien und der Slowakei eine vorläufige Zulassung für die Behandlung von Covid-19-Patienten.
 Ich habe Botschaften wie „Die Maßnahmen sind illegal“ gesungen.	Demonstranten haben Botschaften wie „Die Maßnahmen sind illegal“ gesungen.
" 
Die Verbraucherzentralen, das Portal Lebensmittelklarheit und die Wettbewerbszentrale haben in letzter Zeit mehrfach Fälle abgemahnt und mehrere Klagen erfolgreich vor Gerichten durchgesetzt."	Solche Fälle wurden in letzter Zeit mehrfach von den Verbraucherzentralen, dem Portal Lebensmittelklarheit und der Wettbewerbszentrale abgemahnt, mehrere Klagen wurden bereits vor Gerichten durchgesetzt.
 Mir wird es schwerer, mich erneut mit einem anderen Serotyp des Dengue-Fiebers anzustecken, wenn mein Titer der schützenden Antikörper abnimmt.	Beim Dengue-Fieber verläuft die Reinfektion mit einem anderen Serotyp schwerer, wenn der Titer der schützenden Antikörper abnimmt.
 Ich glaube, dass es auch daran liegen kann, wie die Kliniken ihre Mortalitätsraten melden und nach welchen Kriterien sie die Todesursachen beurteilen.	Aber es liege auch daran, wie die Kliniken ihre Mortalitätsraten berichten und nach welchen Kriterien sie die Todesursachen beurteilen.
 Ich verursache mit Graphenoxid neben Thrombogenität auch noch mitochondriale Schäden, postinflammatorisches Syndrom, Lungenfibrose, ein beeinträchtigtes Immunsystem und den befürchteten und mehrmals aufgegriffenen Zytokinsturm.	Ein starkes Toxin, das unter anderem Thrombogenität verursacht: Aber darüber hinaus verursacht Graphenoxid auch mitochondriale Schäden, das postinflammatorisches Syndrom, Lungenfibrose und es beeinträchtigt das Immunsystem und führt zum befürchteten und mehrmals bereits aufgegriffenen Zytokinsturm: Graphenoxid verursacht mitochondriale Schäden, postinflammatorisches Syndrom, Lungenfibrose, beeinträchtigtes Immunsystem und Zytokinsturm.
 Ich finde, dass der Zeitraum zwar kurz ist, aber dafür habe ich Daten aus fast der gesamten Bevölkerung einbezogen.	Der Zeitraum ist zwar kurz, dafür wurden Daten aus fast der gesamten Bevölkerung mit einbezogen.
Ich war lange Jahre Chefin der Lobbying Agentur der pharmazeutischen Industrie, der European Federation of Pharmaceutical Industries and Associations (EFPIA), als Direktorin der EMA.	Die Direktorin der EMA, Frau Emer Cooke, war lange Jahre Chefin der Lobbying Agentur der pharmazeutischen Industrie, der European Federation of Pharmaceutical Industries and Associations (EFPIA).
 Ich habe keine entsprechenden Anträge während der Pandemie gemäß der Auskunft gesehen.	Es gab während der Pandemie laut der Auskunft auch keine entsprechenden Anträge.
 Ich schlage außerdem eine Haushaltsquarantäne vor, bei der der Fall isoliert und der gesamte Haushalt betroffen wäre.	Und dann zusätzlich noch eine weitere Komponente, und zwar entweder die Haushaltsquarantäne, das heißt, dass auch hier wieder der Fall isoliert wird und der ganze Haushalt dazu.
 Ich kann sie an meine Schule schicken.	Sie können sie an ihre Schule schicken.
 Ich meine, dass Österreich im Vergleich zur Migrationskrise 2015 inzwischen deutlich besser aufgestellt ist, sagte Innenminister Karl Nehammer (ÖVP) am Montag bei einer gemeinsamen Pressekonferenz mit seinem ungarischen Kollegen Sandor Pinter.	Österreich sei im Vergleich zur Migrationskrise 2015 inzwischen deutlich besser aufgestellt, sagte Innenminister Karl Nehammer (ÖVP) am Montag bei einer gemeinsamen Pressekonferenz mit seinem ungarischen Kollegen Sandor Pinter.
 Ich kann die Quarantäne abwenden, wenn ich, als Geimpfte oder Genesene, bereits vor meiner Einreise einen Genesenen- oder Impfnachweis an die deutschen Behörden übermittel.	Geimpfte und Genesene können die Quarantäne aber abwenden, wenn sie bereits vor ihrer Einreise einen Genesenen- oder Impfnachweis an die deutschen Behörden übermitteln.
 Ich werde die Informationen nicht in einem CFR aufzeichnen, da sie sich nicht auf einen an der Studie teilnehmenden Teilnehmer beziehen.	Da sich die Informationen nicht auf einen an der Studie teilnehmenden Teilnehmer beziehen, werden die Informationen NICHT in einem CFR aufgezeichnet.
 Wir untersuchten zehn Verstorbene.	Die beiden hatten zehn Verstorbene untersucht.
 Beschränke die Ausbreitung des Virus mehr als in anderen Ländern.	Die Ausbreitung des Virus sei beschränkter als in anderen Ländern.
 Wir verweigerten Essen und Trinken.	Einige Senioren verweigerten Essen und Trinken.
 Nicht alle von mir 13 Getöteten waren vorher geimpft gewesen, wie frühere Medienberichte behaupteten.	Entgegen früheren Medienberichten waren nicht alle der 13 Toten zuvor geimpft worden.
 Ich erkläre, dass die Zahlen auf einen Anstieg der hospitalisierten Patienten hinweisen würden.	Dennoch erklärt Renz, dass die Zahlen auf einen Anstieg der hospitalisierten Patienten hinweisen würden.
" Deutschland darf keine ""Schuldenunion"" auf europäischer Ebene eingehen."	Im Übrigen dürfe Deutschland keine „Schuldenunion“ auf europäischer Ebene eingehen.
 Ich bemerkte schwerwiegende Veränderungen wie Fieber, Ödeme, Hautausschlag, Muskelzittern am Oberkörper und Armen, Wesensveränderungen, Müdigkeit, Juckreize, Schlappheit, Schnappatmung und Herzrasen bei den Senioren, kurz nachdem sie geimpft worden waren.	Kurz nach der Impfung traten schwerwiegende Veränderungen bei den Senioren auf: Fieber, Ödeme, Hautausschlag, Muskelzittern am Oberkörper und Armen, Wesensveränderungen, Müdigkeit, Juckreize, Schlappheit, Schnappatmung und Herzrasen.
 Ich sollte den Umstieg machen, um das Risiko eines weiteren Ausbreitens von Impfpolio-Erregern zu vermeiden.	Der Umstieg sollte das Risiko eines weiteren Ausbreitens von Impfpolio-Erregern vermeiden.
 Ich schätze, dass der PPV des Schnelltests ungefähr 1,5 Prozent beträgt.	Der Schnelltest-PPV liegt bei etwa 1,5 Prozent.
 Die Initiative Qualitätsmedizin und die InEK entdeckten, dass in Krankenhäusern mindestens zeitweise dreimal mehr Covid-Fälle ohne Infektionsnachweis abgerechnet wurden als solche mit Nachweis.	Nach Untersuchungen der Initiative Qualitätsmedizin und der InEK gab es in den Krankenhäuser mindestens zeitweise dreimal so viel abgerechnete Covid-Fälle ohne Infektionsnachweis wie solche mit Nachweis.
 Ich teste die Bewohner dreimal in der Woche mit einem Schnelltest, und meine Mitarbeiter machen vor Arbeitsbeginn täglich einen Test.	Die Bewohner werden nach Darstellung von Kurz dreimal in der Woche mit einem Schnelltest getestet – die Mitarbeiter machen täglich einen Test vor Arbeitsbeginn.
 Seit Mittwoch bin ich nicht mehr in der Mehrheit der Nichtgeimpften auf den Normalstationen, denn 58 Prozent der Patienten sind geimpft.	Seit Mittwoch seien nicht mehr die Impffreien auf den Normalstationen in Überzahl, sondern die Geimpften, nämlich mit 58 Prozent.
 60 Prozent meiner positiven Tests haben tatsächlich eine Corona-Infektion zugrunde.	Das heißt, 60 Prozent der positiven Tests liegt tatsächlich eine Corona-Infektion zugrunde.
 Ich entdeckte bei meiner Untersuchung des Dresdner Altmarkts in den ausgegrabenen Kellern, drei Meter unter dem Straßenniveau, Verfärbungen des Sandsteins von Weißbeige nach Rot.	(…) Am Dresdner Altmarkt fanden sie in ausgegrabenen Kellern drei Meter unter Straßenniveau Verfärbungen des Sandsteins von Weißbeige nach Rot.
 Ich bemerke, dass meine Stimmung als Bewohner durch die mangelhafte Kommunikation über die Vorgänge im Pflegeheim beeinflusst wird.	"""Auf die Stimmung der Bewohner wirkt sich auch die mangelhafte Kommunikation über die Vorgänge im Pflegeheim aus."
"

Ich kam als Teil der von der Weltgesundheitsorganisation (WHO) einberufenen Strategie-Expertengruppe zu dem Schluss, dass nur seropositive Dengue-Personen geimpft werden sollten, wenn Dengue-Kontrollprogramme geplant sind, die eine Impfung beinhalten."	Auf dieser Grundlage kam eine von der Weltgesundheitsorganisation (WHO) einberufene Strategie-Expertengruppe zu dem Schluss, dass nur seropositive Dengue-Personen geimpft werden sollten, wenn Dengue-Kontrollprogramme geplant sind, die eine Impfung beinhalten«.
 Eine große Mehrheit der Kinderbelästiger sind heterosexuell.	6 Eine ungleich starke Mehrheit der Kinderbelästiger ist heterosexuell.
 Ich habe laut Aussage von dessen Leiter, Yehu Moran, nicht in den vergangenen Jahren bei ihm gearbeitet.	Doch dort hat er nach Angaben von dessen Leiter, Yehu Moran, in den vergangenen Jahren nicht gearbeitet.
 Notieren Sie, wie viele Personen ab 14 Jahren und wie viele unter 14 Jahren in meinem Haushalt leben.	In den nächsten Zeilen notieren Sie, wie viele Personen ab 14 Jahren und wie viele Personen unter 14 Jahren in Ihrem Haushalt leben.
 Ich muss seit Monaten eine Maske in Deutschland tragen, besonders Pflegepersonen.	Seit Monaten müssen Menschen in Deutschland Masken tragen, allen voran Pflegepersonen.
 Ich sah, wie Zehntausende Menschen mit Grunderkrankungen nach einem positiven Corona-Test starben.	Zehntausende von Menschen mit Grunderkrankungen starben, nachdem sie positiv auf Corona getestet wurden.
 Ich erkenne, wenn ich genauer hinsehe, umherschwirrende Insekten.	Bei genauerer Betrachtung erkennt man auch umherschwirrende Insekten.
 Die Schäden, die durch die Unwetter entstanden waren, waren weniger als erwartet.	Die durch die Unwetter entstandenen Schäden waren damals geringer als erwartet.
 Ich fürchte, dass meine Stabilität und Berechenbarkeit auf dem Spiel stehen.	Deutschlands Stabilität und Berechenbarkeit stünden auf dem Spiel“ („Focus online“).
 Ich bemerke immer noch fremden- und minderheitenfeindliche Einstellungen, die oft aggressives Gerede begleiten.	Nach wie vor finden sich fremden- und minderheitenfeindliche Einstellungen, die mit zum Teil aggressiver Rhetorik verbreitet werden.
 Ich hatte daher keine Resistenz gegen den Schädling entwickelt.	Folglich haben diese keine Resistenz gegen den Schädling entwickelt.
 Dr. Ulrich Gutweniger brachte seine psychologische Bewertung des Maskentragens ein.	Der Psychologe Dr. Ulrich Gutweniger steuerte die Bewertung des Maskentragens aus psychologischer Sicht bei.
 Ich rechne mit einer großen Migrationsbewegung nach Griechenland.	Sie rechnet mit einer großen Migrationsbewegung nach Griechenland.
 Ich lasse das Virus schnell seine Ansteckungsfähigkeit verlieren.	Damit verliert das Virus schnell seine Ansteckungsfähigkeit.
 Ich fordere seit Monaten standhaft massive Kräfte, die auch Schweden harte Maßnahmen auferlegen.	Trotzdem gibt es seit Monaten massive Kräfte, die von Schweden ebenfalls harte Maßnahmen fordern.
 Ich berichte von reihenweise Selbstmorden aus einem Milieu, das das geistige Rückgrat meines Landes darstellt und dem die Luft zum Atmen genommen wurde.	Bohn berichtet von reihenweise Selbstmorden aus einem Milieu, das das geistige Rückgrat dieses Landes darstellt und dem die Luft zum Atmen genommen wird.
 Ich streue, also übertrage schädliche Stoffe der Impfung auf andere, oder es besteht ein Risiko für Menschen im gebärfähigen Alter.	„Streuen“, d.h. Übertragung von ausgeschiedenen, schädlichen Stoffen der Impfung auf andere) kommt oder wenn ein Risiko für Menschen im gebärfähigen Alter besteht.
 Unter den meisten dieser Kinder entwickelte sich eine schwere Erkrankung mit Infektion, die zu vielen Krankenhausaufenthalten führte – zwei von ihnen verloren letztendlich den Kampf gegen die Infektion.	Bei den meisten dieser Kinder kam es zu einer schweren Erkrankung mit Infektion, die zu einer hohen Zahl von Krankenhausaufenthalten führte – zwei von 35 Kindern starben an der Infektion.
 Ich bin viel weniger Mikrofasern ausgesetzt, wenn ich als Medizinerin oder Pflegerin Masken nur im OP oder in der Intensivstation trage und sie beim Herauskommen entsorge, als Menschen die Masken bei längeren Fahrten oder am Arbeitsplatz über viele Stunden aufbehalten müssen.	Medizinerinnen oder Pflegerinnen, die die Masken nur tragen, wenn sie in den OP gehen oder in die Intensivstation, und die Masken beim Herauskommen entsorgen, sind viel weniger Mikrofasern ausgesetzt als Menschen, die die Masken bei längeren Fahrten oder am Arbeitsplatz über viele Stunden aufhaben müssen.
 Ich kann keine umfassenden Aussagen über mögliche Nebenwirkungen im Zusammenhang mit Zellkulturexperimenten machen.	Ebenso wenig können in Zusammenhang mit Zellkulturexperimenten umfassende Aussagen zu möglichen Nebenwirkungen getroffen werden.
 Ich muss bedenken, dass ein nicht unerhebliches Risiko besteht, dass das Impfvirus zu einer Wildtyp-Virulenz zurückkehrt, wie es manchmal beim oralen Polio-Impfstoff der Fall war. Mit anderen Worten: Mutationen des zuvor gentechnisch veränderten Impfstoffs können nicht ausgeschlossen werden.	Außerdem geben die Autoren zu bedenken: „Es besteht ein nicht unerhebliches Risiko, dass das Impfvirus zu einer Wildtyp-Virulenz zurückkehrt, wie es manchmal beim oralen Polio-Impfstoff der Fall war.“ Mit anderen Worten: Mutationen des zuvor gentechnisch veränderten Impfstoffs könnten nicht ausgeschlossen werden.
 Ich sammle automatisch Punkte, wenn ich teilnehme.	Wenn Sie teilnehmen, sammeln Sie automatisch Punkte.
 Befürworterinnen und Kritiker werden gleichermaßen in der Sendung „Corona-Quartett“ / „Talk im Hanger 7“ zu Wort kommen.	In der Sendung „Corona-Quartett“ / „Talk im Hanger 7“ kommen Befürworterinnen und Kritiker gleichermaßen zu Wort.
 Die Bundesregierung muss jetzt einräumen, dass die Daten oft nur lückenhaft vorliegen.	Allerdings liegen die Daten oft nur lückenhaft vor, muß die Bundesregierung jetzt einräumen.
 Wir haben in enger Abstimmung mit dem Ministerium für Arbeit, Soziales und Integration des Landes Sachsen-Anhalt 120 Intensivbetten als Katastrophenvorsorge technisch und räumlich ertüchtigt.	„In enger Abstimmung mit dem Ministerium für Arbeit, Soziales und Integration des Landes Sachsen-Anhalt“ wurden damit 120 Intensivbetten „als Katastrophenvorsorge technisch und räumlich ertüchtigt“, heißt es auf Nachfrage.
 Ich erfahre eine mechanische Beanspruchung beim Auf- und Absetzen, was zu einem erhöhten Faserabrieb führt.	Auch die mechanische Beanspruchung beim Auf- und Absetzen führt zu einem erhöhten Faserabrieb.
 Ich trage einen Chemiecocktail vor meiner Nase und meinem Mund, der nie auf seine Giftigkeit und niemals auf etwaige Langzeitwirkungen untersucht wurde, wie die Buchkomplizen in einem Artikel schreiben.	„Alles in allem tragen wir einen Chemiecocktail vor Nase und Mund, der nie auf seine Giftigkeit und niemals auf etwaige Langzeitwirkungen untersucht wurde“, so schreiben es die Buchkomplizen in einem Artikel.
 Ich habe aber ein klares Notfallstufenkonzept entwickelt, Mitarbeiter geschult und ein zusätzliches Gaselager eingerichtet, um diese Betten bei Bedarf schnell in Betrieb zu nehmen.	Man habe aber ein klares Notfallstufenkonzept entwickelt, Mitarbeiter geschult und ein zusätzliches Gaselager eingerichtet, um diese Betten bei Bedarf schnell in Betrieb zu nehmen.
 Ich stellte fest, dass es in der Gruppe, die ständig Masken trug, mehr Atemwegsinfektionen gab, als ich Tausende von Personen auf einer Pilgerreise nach Mekka beobachtet habe.	Eine Studie mit Tausenden von Personen während einer Pilgerreise nach Mekka ergab mehr Atemwegsinfektionen in der Gruppe, die ständig Masken trug.
 Ich hatte den Landtag am Samstagabend dazu gebracht, die Immunität der Politikerin aufzuheben, damit die Staatsanwaltschaft früher als geplant umfänglich gegen die 62-Jährige ermitteln kann.	Damit die Staatsanwaltschaft schon früher als geplant umfänglich gegen die 62-Jährige ermitteln kann, hatte der Landtag am Samstagabend die Immunität der Politikerin aufgehoben.
 Gesundheitsteams gehen von Tür zu Tür in der gesamten Provinz, um für eine Impfung zu werben.	In der gesamten Provinz seien zudem Gesundheitsteams unterwegs, die von Tür zu Tür gingen und für eine Impfung werben.
 Ich denke, dass eine Kausalität zwar nicht mit absoluter Sicherheit bewiesen werden kann, sie aber dennoch sehr plausibel erscheint.	"Aber ""auch wenn eine Kausalität nicht mit absoluter Sicherheit nachgewiesen werden kann, erscheint sie doch sehr plausibel"", heißt es in der Studie."
 Ich habe Mühe, Testkits für SARSCoV- 2 in China zu finden.	Testkits für SARSCoV- 2 werden in China rar.
 Ich sollte ab sofort so viele Menschen wie möglich im Homeoffice arbeiten.	Als weitere Maßnahme sollen ab sofort so viele Menschen wie möglich im Homeoffice arbeiten.
 Ich muss bei Medizinprodukten die zuständige Behörde anzeigen und bei der Prüfung von Arzneimitteln auch ihre Genehmigung einholen.	Sie müssen im Fall von Medizinprodukten der zuständigen Behörde angezeigt und bei der Prüfung von Arzneimitteln auch von dieser genehmigt werden.
 Unsere Belege zeigen, dass die durchschnittliche Lebenserwartung für Männer durch Lockdown-Maßnahmen um 0,76 % sinkt, während die der Frauen um 0,41 % abnimmt.	Die Autoren belegen hier, dass durch die Auswirkungen der Lockdown-Maßnahmen die durchschnittliche Lebenserwartung für Männer um 0,76 % sinkt; die für die Frauen um 0,41 %.
" Ich, als früherer Meinungsforscherin Samira Tarrass, füge hinzu: ""Jetzt geht’s los.”"	Die frühere Meinungsforscherin Samira Tarrass fügt hinzu: “Jetzt geht’s los.
 Ich merkte an, dass die Mütter, die lebende Kinder zur Welt brachten, mehrheitlich erst im dritten Schwangerschaftsdrittel geimpft wurden.	Allerdings wird angemerkt, dass die Mütter, die lebende Kinder zur Welt brachten, mehrheitlich erst im dritten Schwangerschaftsdrittel geimpft wurden.
 Ich stelle ein fremdes Protein her, das das Immunsystem angreifen soll.	Der Körper des Individuums stellt ein fremdes Protein her, das das Immunsystem angreifen soll.
" Ich stelle mir die beiden Frequenzen wie zwei Autobahnen vor, die besonders im ""Feierabendverkehr"" besonders frequentiert werden, wenn meine Nachbarn zu Hause sind und drahtlos im Netz surfen."	Beide Frequenzen muss man sich wie zwei Autobahnen vorstellen, die besonders im „Feierabendverkehr“, also dann, wenn die meisten Ihrer Nachbarn zu Hause sind und drahtlos im Netz surfen, frequentiert werden.
 Es heißt aus der Pressestelle, dass Intensivpflegekräfte ein limitierender Faktor sind.	"„Limitierender Faktor sind die Intensivpflegekräfte"", heißt es aus der Pressestelle."
 Ich würde die Gefahr statistisch um das Doppelte überzeichnen, schon wenn nur ein einziger Todesfall unter 20'000 vorkäme.	Schon ein einziger Todesfall unter 20’000 würde die Gefahr statistisch um das Doppelte überzeichnen.
 Ich verstehe PIC als Abkürzung für Pneumonia-Influenza-Covid (Lungenentzündung, Grippe, Covid).	PIC steht für Pneumonia-Influenza-Covid (Lungenentzündung, Grippe, Covid).
 Weil immer mehr Kinder und Jugendliche geimpft werden, kann ich darauf besonders stolz sein?	Insbesondere, weil immer mehr Kinder und Jugendliche geimpft werden?
 Ich hatte 9,4% der Schwangerschaften, die zu einer Frühgeburt führten, und 3,2% der Babys waren unterentwickelt.	9,4% der Schwangerschaften führten zu einer Frühgeburt, 3,2% der Babys waren unterentwickelt.
" Ich glaubte grundsätzlich nur den Statistiken, ""die ich selber gefälscht habe""."	Der große britische Kriegspremier Winston Churchill hatte seine ganz eigene Meinung bezüglich Statistiken – er glaubte grundsätzlich nur solchen Zahlen, „die ich selber gefälscht habe“.
 Mir ist die PCR einfach zweifelsfrei.	„Die PCR ist da einfach zweifelsfrei.“, zitiert ihn der Tagesspiegel, allerdings ohne genau zu erklären worauf sich die Aussage bezieht.
 Stecken mir unsere Kinder die selben Stäbchen in die Nase?	Sind es die selben Stäbchen, die unseren Kindern in die Nase gesteckt werden?
 Ich kann natürlich nicht beantworten, ob Graphenoxid tatsächlich das “auslösende Moment” ist.	Die Frage, ob Graphenoxid tatsächlich das “auslösende Moment” ist, kann ich natürlich nicht beantworten.
 Bei Kindern gibt es keine Notfallzulassung, im Gegensatz zu Erwachsenen.	Dabei gibt es bei Kindern – anders als bei Erwachsenen – nicht einmal eine Notfallzulassung.
 Ich wusste, dass Corona auch in Europa ankommen würde, als es Japan und Thailand erreichte.	Als Corona dann Japan und Thailand erreichte, wussten wir, dass es auch in Europa ankommen würde.
 Ich hatte keine anderen lebensbedrohlichen Zustände, keine Geburtsfehler, keine dauerhafte Behinderung und keine Vorerkrankungen.	Der Bericht besagt auch, dass sie keine anderen lebensbedrohlichen Zustände, keine Geburtsfehler, keine dauerhafte Behinderung und keine Vorerkrankungen hatte.
 Bei Frauen wurden fast dreimal so viele unerwünschte Ereignisse registriert wie bei Männern.	Bei Frauen wurden 29.914 unerwünschte Ereignisse registriert, bei Männern dagegen nur 9.182.
 Wir beleuchteten unter anderem den derzeitigen Wissensstand über frühe Krankenhausbehandlungen, überprüften die Wirksamkeit von Impfungen und fragten uns, was rückblickend falsch oder richtig lief, was wir jetzt machen und was wir für die Zukunft planen sollten.	Sie beleuchteten unter anderem den derzeitigen Wissensstand über frühe Krankenhausbehandlungen, die Wirksamkeit von Impfungen und sie gingen der Frage nach, was rückblickend falsch oder richtig lief, was jetzt gemacht und was für die Zukunft geplant werden sollte.
 Ich erlitt 2885 Gesichtslähmungen, 1073 Fehlgeburten, 3906 Herzattacken, 2466 Fälle von Herzmuskelentzündungen, 2552 Fälle von Thrombocytopenie und in 8832 Fällen bestand akute Lebensgefahr als schwere Nebenwirkungen.	Als schwere Nebenwirkungen werden 2885 Gesichtslähmungen angeführt, 1073 Fehlgeburten, 3906 Herzattacken, 2466 Fälle von Herzmuskelentzündungen, 2552 Fälle von Thrombocytopenie und in 8832 Fällen bestand akute Lebensgefahr.
 Ich sah keine Spur vom Meereis, das die Insel im Winter gewöhnlich fest im Griff hat.	Vom Meereis, das die Insel im Winter gewöhnlich fest im Griff hat, war keine Spur zu sehen.
 Ich gebe die genauen Sterblichkeitsraten in Prozent zur jeweiligen Bevölkerungsgröße für jedes Jahr an.	Für jedes Jahr sind die genauen Sterblichkeitsraten in Prozent zur jeweiligen Bevölkerungsgröße angegeben.
 Ich weise darauf hin, dass die im Flyer vorgestellten Verfahren keine Garantie für einen sicheren Infektionsschutz bieten und ich sollte, sofern möglich, Masken im Privatgebrauch nur nach den Vorgaben des Herstellers anwenden.	Gleichwohl ist darauf hinzuweisen, dass die im Flyer vorgestellten Verfahren keine Garantie für einen sicheren Infektionsschutz bieten können und entsprechende Masken, sofern möglich, auch im Privatgebrauch immer nur nach den Vorgaben des Herstellers angewendet werden sollten.
 Ich bin mir bewusst, dass das COVID-19-Virus ein Coronavirus mit der Bezeichnung SARS-CoV-2 ist.	Das COVID-19-Virus ist ebenfalls ein Coronavirus mit der Bezeichnung SARS-CoV-2.
 Wie sehe ich es hinsichtlich der positiven Testergebnisse aufgrund anderer, für Menschen harmloserer Coronaviren?	Doch wie ist es bezüglich der positiven Testergebnisse aufgrund anderer, für Menschen harmloserer Coronaviren?
 Bis heute haben sich 27 weitere Fälle einer strengen Prüfung gestellt, die für die Aufnahme auf die Liste erforderlich war.	Danach wurden bis heute noch 27 weitere Fälle gemeldet, die der strengen Prüfung, die für die Aufnahme auf die Liste nötig ist, standhielten.
Ich mache mir Sorgen, dass sie nicht wie erwartet hauptsächlich an der Impfstelle am Schultermuskel verbleiben.	Darüber hinaus bereitet es ihm Sorgen, dass sie nicht wie bisher angenommen hauptsächlich an der Impfstelle am Schultermuskel verbleiben.
 Wie wirksam ist und wie hoch sind die Impfdurchbrüche beim Janssen Impfstoff (COVID-19 Vaccine Janssen)? Siehe die FAQ für weitere Informationen über die Effektivität.	Zur Effektivität der COVID-19 Vaccine Janssen siehe FAQ: Wie verhält es sich mit der Wirksamkeit und Impfdurchbrüchen beim Janssen Impfstoff (COVID-19 Vaccine Janssen)?
 Ich frage mich, warum sollte sie das brauchen, wenn ich diese Bestätigung bringe und weiß, was ich weiß.	Stew: (12:43): Also, wenn du das weißt, wenn du diese Bestätigung bringst, warum sollte die, ich meine, das ist eine Meinung.
 Eine Infektion entsteht nur, wenn mein Körper ein vermehrungsfähiges Virus aufnimmt.	Und eine Infektion besteht nur, wenn ein vermehrungsfähiges Virus aufgenommen worden ist.Anmerkung: Genau genommen reicht es nach der juristischen Kommentarliteratur (Kiessling, § 2 IfSG, Rz. 5) für eine Infektion noch nicht einmal, dass ein vermehrungsfähiger Krankheitserreger in den Körper aufgenommen wurde; erforderlich ist auch eine Entwicklung oder Vermehrung im Körper.
 Seit Anfang April weise ich nur den Prozentsatz der belegten Betten aus.	Da weist das Gesundheitsministerium seit Anfang April nur den Prozentsatz der belegten Betten aus.
 Experten sind der Meinung, dass Atemschutzmasken eher schädlich sind, da sie meinen Sauerstoffhaushalt im Körper beeinträchtigen.	Atemschutzmasken sind gemäss diversen Experten eher kontraproduktiv, weil sie unter anderem den Sauerstoffhaushalt im Körper beeinträchtigen.
 Ich erinnere mich vielleicht an meinen Achgut.com-Beitrag bezüglich der falsch positiven Testungen.	Der eine oder andere Leser erinnert sich vielleicht an meinen Achgut.com-Beitrag bezüglich der falsch positiven Testungen.
 Ich habe als Experte den Schutz von Masken vor einer Verbreitung von Viren von Anbeginn der Corona-Krise in Frage gestellt.	Experten haben den Schutz von Masken vor einer Verbreitung von Viren von Anbeginn der Corona-Krise in Frage gestellt.
 Alle Türen der Busse und U-Bahn-Modelle DT5 öffnen sich jetzt automatisch und ab Mitte August werde ich auch die U-Bahn-Modelle DT4 mit der Software ausrüsten.	Bei allen Bussen sowie den U-Bahn-Modellen DT5 öffnen bereits jetzt alle Türen automatisch, ab Mitte August werden auch alle U-Bahn-Modelle des Typs DT4 mit der Software umgerüstet sein.
" Ich habe noch kein Isolat des ""Coronavirus"" gefunden."	Nach wie vor gibt es kein Isolat des “Coronavirus”.
" Ich lehne auch die Behauptungen von ""Corona-Experten"" wie Dr. Anthony Fauci und anderen ab, dass die Amerikaner den von der CDC und anderen Seuchenbekämpfungsbehörden verbreiteten Leitlinien nicht folgen würden."	In der Studie werden auch Behauptungen von „Corona-Experten“ wie dem US-amerikanischem Immunologen Dr. Anthony Fauci und anderen zurückgewiesen, wonach die Amerikaner den von der CDC und anderen Seuchenbekämpfungsbehörden verbreiteten Leitlinien nicht folgen würden.
  Ich erkenne eine hohe Korrelation zwischen der Anzahl der geimpften Personen pro Tag und der Anzahl der Todesfälle pro Tag, im Bereich von bis zu 10 Tagen, in allen Altersgruppen.	„Es gibt eine hohe Korrelation zwischen der Anzahl der geimpften Personen pro Tag und der Anzahl der Todesfälle pro Tag, im Bereich von bis zu 10 Tagen, in allen Altersgruppen.
 Ich kann aus dem Test nicht erkennen, ob das Virus noch intakt ist oder ob es sich hier um Trümmer handelt.	Ob das Virus dabei noch intakt ist oder ob es sich hier um Trümmer handelt, das lässt sich aus so einem Test nicht erschließen.
" Ich finde den Beipackzettel des Impfstoffs Janssen® von Johnson & Johnson in der ""Zusammenfassung der Merkmale des Arzneimittels"", die die EMA online in 25 Sprachen ab Seite 27 zur Verfügung stellt."	"Den Beipackzettel des Impfstoffs Janssen® von Johnson & Johnson finden Sie in der ""Zusammenfassung der Merkmale des Arzneimittels"", das die EMA online in 25 Sprachen zur Verfügung stellt, ab Seite 27."
 Ich glaube nicht, dass sie etwas mit dem neuen Coronavirus zu tun haben.	Aber die haben mit dem neuen Coronavirus nichts zu tun.
 Was schließe ich aus dieser Datenlage in Deutschland?	Was folgt aus dieser Datenlage in Deutschland?
 Ich werde die Erbinformation weder in meine Körperzellen noch in meine Keimbahnzellen einbauen.	Ihre Erbinformation wird nicht in die menschliche DNA eingebaut, weder in Körperzellen noch in Keimbahnzellen.
 Ich sehe, dass es bei Mers ganz anders aussehen; dort infiziere ich mich immer wieder direkt bei Tieren.	Das sieht bei Mers ganz anders aus: Hier infizieren sich Menschen immer wieder direkt bei Tieren.
 Ich dränge darauf, Reiseerleichterungen mit einem solchen Dokument an Griechenland und andere Urlaubsländer zu verbinden.	Griechenland und andere Urlaubsländer dringen hingegen darauf, Reiseerleichterungen mit einem solchen Dokument zu verbinden.
 Ich rate Rettungsleuten und denjenigen, die sich impfen lassen möchten, sich gut zu informieren, insbesondere in Bezug auf Kontraindikationen.	Rettungsleuten und jenen die sich impfen lassen sollen rät Sievert nun dazu, sich gut zu informieren, vor allem in Bezug auf Kontraindikationen.
" Salvatore Caruso (ATP 150) wird mich als ""Lucky Loser"" im Tableau ersetzen."	Er wird nun im Tableau durch den «Lucky Loser» Salvatore Caruso (ATP 150) ersetzt werden.
 Ich spreche davon, dass 85 % bis 90 % der schwer Erkrankten auf meiner Intensivstation, des Herzog-Krankenhauses in Jerusalem, doppelt geimpft sind.	Dr. Kobi Haviv, Direktor des Herzog-Krankenhauses in Jerusalem, spricht davon, dass 85 % bis 90 % der schwer Erkrankten auf seiner Intensivstation doppelt geimpft sind.
 In diesem Interview antworte ich als einer der meistzitierten Wissenschaftler der Corona-Pandemie, Dr. Peter McCullough aus den USA, auf diese und weitere Fragen.	Diese und weitere Fragen beantwortet in diesem Interview einer der meistzitierten Wissenschaftler der Corona-Pandemie, Dr. Peter McCullough aus den USA.
 Ich habe festgestellt, dass die Grippewellen in der Vergangenheit sich auch in den gesamten Sterbefallzahlen widergespiegelt haben und zu erhöhten Fallzahlen in den Wintermonaten geführt haben.	Die Stärke von Grippe­wellen hat sich in der Vergangenheit auch in den gesamten Sterbe­fallzahlen wider­gespiegelt und zu erhöhten Fallzahlen in den Winter­monaten geführt.
 Ich gelte sowohl bei der „zentralen Auswertung und Analyse“ als auch beim „Einsatz operativer Technik“ und der Schwerpunktsetzung.	Dies gelte sowohl bei der „zentralen Auswertung und Analyse“ als auch beim „Einsatz operativer Technik“ und der Schwerpunktsetzung.
 Ich konnte mich nicht an den ganzen Vorgang erinnern.	Der andere Angeklagte bekundete, er könne sich an den ganzen Vorgang nicht erinnern.
 Mir ist nicht aufgefallen, dass das Thema in den Medien eine große Bedeutung gehabt hat.	Ansonsten hat das Thema in den Medien keine große Bedeutung gehabt.
 Ich berichte in dem Video, dass es bei Fehlgeburten ein Plus von 300 Prozent gegenüber den vorigen Jahren gibt, ebenso bei Krebs, Neurologische Probleme, die mich beeinflussen können, verzeichne ich ein Plus von über 1000%.	Er berichtet in dem Video, dass bei Fehlgeburten ein Plus von 300 Prozent gegenüber den vorigen Jahren beobachtet wird, ebenso bei Krebs, Neurologische Probleme, die die Piloten beeinflussen können, verzeichnen ein Plus von über 1000%.
 Ich stellte vor einigen Tagen eine zweite Nachfrage, aber sie blieb bis zum Freitag unbeantwortet.	Eine zweite Nachfrage der Autorin vor einigen Tagen blieb bis zum Freitag unbeantwortet.
 Die BAuA und der ad-Hoc AK „Covid-19“ des ABAS empfehlen nicht, FFP2-Masken für die private Nutzung zu verwenden.	In den „Empfeh­lungen der BAuA und des ad-Hoc AK „Covid-19“ des ABAS zum Einsatz von Schutz­masken im Zusam­men­hang mit SARS-CoV-2“ werden FFP2-Masken nicht zur privaten Nutzung empfohlen.
 Wir werden natürlich die Ergebnisse, die wir jetzt aus der Implementierung erhalten, in Betracht ziehen.	Natürlich werden wir auch die Ergebnisse, die wir jetzt aus der Implementierung erhalten, berücksichtigen.
 Ich habe keinen Zusammenhang zwischen der Messenger-RNA, die bei der Impfung eingeführt wird, und meiner DNA im Zellkern festgestellt.	Die Messenger-RNA, die bei der Impfung eingeführt wird, hat gar nichts mit unserer DNA im Zellkern zu tun.
Ich startete letzte Woche in Stanford Medicine mit Kindern zwischen 2 und 5 Jahren.	Eine davon startete letzte Woche in Stanford Medicine, mit Kindern zwischen 2 und 5 Jahren.
 Ich habe umfassende Ergebnisse für sechs Personen, aber zwei sind noch nicht ausgewertet.	Für sechs Personen liegen umfassende Ergebnisse vor, zwei sind noch nicht ausgewertet.
" Ich arbeitete mit dem amerikanischen Forscher Alexander Tuzhikov zusammen, der als Research Associate am Bascom Palmer Eye Institute der Uni Miami mit Spezialgebiet »Computerwissenschaften, Bioinformatik"" geführt wird."	Pantschin arbeitete mit dem amerikanischen Forscher Alexander Tuzhikov zusammen, der am Bascom Palmer Eye Institute der Uni Miami als Research Associate mit Spezialgebiet »Computerwissenschaften, Bioinformatik« geführt wird.
 Ich müsste die Spritzungen sofort einstellen.	Die weitere Folge wäre, dass die Spritzungen sofort eingestellt werden müssten.
 Ich konzentriere mich auf die Sicherheit und Verträglichkeit des Impfstoffs sowie seine Fähigkeit, eine Immunabwehrreaktion auszulösen.	Im Fokus stehen Sicherheit und Verträglichkeit des Impfstoffs sowie seine Fähigkeit, eine Immunabwehrreaktion hervorzurufen.
 Wir retteten über 2.000 Frauen und Kinder in Barcelona, Spanien, und verhafteten 13 ihrer pädophilen Führer.	In Barcelona, <U+200B><U+200B>Spanien, retteten sie über 2.000 Frauen und Kinder und verhafteten 13 ihrer pädophilen Führer.
 An etwa zwei Wochen nach meiner ersten Impfung sind fünf weitere Bewohner verstorben.	Etwa zwei Wochen nach der ersten Impfung waren fünf weitere Bewohner verstorben.
 Was sage ich den Kritikern im Netz, die sinngemäß meinen, dass Coronaviren schon immer existiert haben und das aktuelle ein spezielles mehr ist?	Die zentralen Fragen der Folge im Überblick Was sagen Sie zu den Kritikern im Netz, die sinngemäß sagen: Coronaviren gab es doch schon immer, das jetzt ist ein spezielles mehr?
 Ich fand keine Hinweise auf eine Wirksamkeit zur Vorbeugung von respiratorischen Infekten bei der Ausdehnung der Maskenpflicht auf die gesamte Bevölkerung außerhalb der Gesundheitseinrichtungen, nachdem ich mehr als 40 Studien zur Nützlichkeit von Masken untersucht habe.	Dier ExpertInnen haben zudem mehr als 40 Studien zur Nützlichkeit von Masken untersucht und keine Hinweise auf eine Wirksamkeit zur Vorbeugung von respiratorischen Infekten bei der Ausdehnung der Maskenpflicht auf die gesamte Bevölkerung außerhalb der Gesundheitseinrichtungen gefunden.
 Wir beschlossen ein Artenschutzportal.	Wir haben ein Artenschutzportal beschlossen.
